antal	ae n . t a l
simmons	s i . m eo n . s eu
neil	n i l
svensson	s eu . b e n . s o n
novi	n o . b i
apia	a . p i . a
menem	m e . n e m
moscow	m o . s eu . k eu . b a
heuss	h o . i . s eu
danilo	d a . n i l . l o
cuthbert	k eo . s eu . b eo . t eu
joyce	j o . i . s eu
kaschnitz	k a . s yu . n i . ch eu
collier	k o l . l i . eo
beza	b e . j a
lanning	l ae . n i ng
svend	s eu . b e n
india	i n . d i . a
ion	i . o n
reggie	l e . j i
philippa	p i l . l i . p a
strassmann	s yu . t eu . l a . s eu . m a n
gottlob	g o . t eu l . l o . p eu
linz	l i n . ch eu
watkins	wa s . k i n . s eu
pigou	p i . g u
andreas	a n . d eu . l e . a . s eu
posner	p o . j eu . n eo
camargo	k a . m a . l eu . g o
chamson	s ya ng . s o ng
duke	d yu . k eu
albuquerque	ae l . b eo . k eo . k i
jefferson	j e . p eo . s eu n
cairnes	k e . eo n . s eu
capri	k a . p eu . l i
debreu	d eu . b eu . l oe
ancona	a n . k o . n a
vivian	b i . b i . eo n
shipley	s i . p eu l . l i
kinnock	k i . n o g
attar	ae . t a
pollock	p o l . l o g
boll	b o l
mogens	m o . g e n . s eu
wellington	we l . l i ng . t eo n
massa	m a . s a
rein	l e . i n
hellman	h e l . m eo n
fiennes	p a . i n . j eu
galli	g a l . l i
yannick	ya . n i g
pere	p e . l eu
eads	i . j eu
stevin	s eu . t e . b i n
carlo	k a . l eu l . l o
vega	b e . g a
sampson	s ae m . s eu n
bass	b ae . s eu
deepak	d i . p ae g
worcester	u . s eu . t eo
buddy	b eo . d i
asso	a . s o
fromm	p eu . l o m
millay	m i l . l e . i
weismann	b a . i . s eu . m a n
disraeli	d i . j eu . l e . i l . l i
gambier	g ae m . b i . eo
kasper	k a . s eu . p eo
edmonton	e . d eu . m eo n . t eo n
wick	wi g
barnes	b a . n e . j eu
novoa	n o . b o . a
salvini	s a l . b i . n i
dundee	d eo n . d i
candolle	k a ng . d o l
ellesmere	e l . j eu . m i . eo
fo	p o
wyatt	wa . i . eo s
napoleon	n a . p o l . l e . o ng
binswanger	b i n . s eu . b a ng . g eo
curzon	k eo . j eu n
millar	m i l . l eo
passow	p a . s yo . p eu
meade	m i . d eu
dekker	d e . k eo
hamilton	h ae . m i l . t eo n
markov	m a . l eu . k o . p eu
moreno	m o . l e . n o
enoch	e . n o g
hassel	h a . s e l
columbus	k o l . l eo m . b eo . s eu
habakkuk	h a . b a g . g u g
darlington	d a l . l i ng . t eo n
kelley	k e l . l i
birkhoff	b eo . k o . p eu
bonnie	b o . n i
barton	b a . t eo n
gurley	g eo l . l i
harper	h a . p eo
qatar	k a . t a . l eu
salih	ss a l . l i . h eu
groethuysen	g eu . l e . t wi . j ae ng
eckardt	e . k a . l eu . t eu
seattle	s i . ae . t eu l
berkley	b eo . k eu l . l i
walther	b a l . t eo
abidjan	a . b i . j a ng
fenton	p e n . t eu n
heaviside	h e . b i . s a . i . d eu
brandenburg	b eu . l a n . d e n . b u . l eu . k eu
sarney	s a . l eu . n e . i
junge	yu ng . g e
abegg	a . b e . g eu
alberta	a l . b a . t a
harvey	h a . b i
winchester	wi n . ch e . s eu . t eo
aretino	a . l e . t i . n o
flagstad	p eu l . l a . g eu . s eu . t a
brecht	b eu . l e . h i . t eu
medawar	m e . d eo . wo
ling	l i ng
griffiths	g eu . l i . p i . s eu
beatrix	b e . a . t eu . l i g . s eu
leonid	l e . o . n i . t eu
lois	l u . i . s eu
judith	yu . d i . s eu
tunisia	t wi . n i . j i
senghor	s a ng . g o . l eu
boer	b o . eo
angelika	a ng . g e l . l i . k a
cartwright	k a . t eu . l a . i . t eu
stockton	s eu . t o g . t eo n
fleet	p eu l . l i . t eu
gago	g a . g o
garland	g a l . l eo n . d eu
simone	s i . m o . n e
edelman	e . d eo l . m eo n
baumeister	b a . u . m a . i . s eu . t eo
neher	n e . eo
salman	s a l . m a n
abilene	ae . b i l . l i n
esther	e . s eu . d eo
danton	d a ng . t o ng
kendrew	k e n . d eu . l u
voroshilov	b o . l o . s i l . l o . p eu
maya	m a . ya
alexandra	a l . l e g . s a n . d eu . l a
doris	d o . l i . s eu
godwin	g o . d eu . wi n
mia	m i . a
rohrer	l o . l eo
pisanello	p i . s a . n e l . l o
copernicus	k o . p e . l eu . n i . k u . s eu
chausson	s yo . s o ng
stilwell	s eu . t i l . we l
merce	m eo . s eu
marc	m a . l eu . k eu
shane	s we . i n
bundy	b eo n . d i
crean	k eu . l i n
novak	n o . b a g
bertie	b eo . t i
jeff	j e . p eu
bush	b u . s i
montessori	m o n . t e . s o . l i
fiedler	p i . d eu l . l eo
jill	j i l
sakharov	s a . h a . l o . p eu
ripley	l i . p eu l . l i
aubert	o . b e . l eu
dam	d a m
bernardo	b e . l eu . n a . l eu . d o
edmund	e . d eu . m eo n . d eu
angola	a ng . g o l . l a
jacobs	j e . i . k o b . s eu
slim	s eu l . l i m
gates	g e . i . ch eu
welhaven	b e l . h a . b e n
babbage	b ae . b i . j i
staudinger	s yu . t a . u . d i ng . g eo
fogel	p o . g e l
jamaica	j a . m e . i . k a
briscoe	b eu . l i . s eu . k o
juneau	j u . n o
ridel	l i . d e l
bertil	b e . l eu . t i l
christian	k eu . l i . s eu . ch eo n
grant	g eu . l ae n . t eu
vientiane	b i . e n . t i . a n
tanguy	t a ng . g i
derzhavin	d e . l eu . j a . b i n
hatch	h ae . ch i
garris	g a . l e . s eu
scholes	s yo l . s eu
nadia	n a . d i . a
kachalov	k a . ch a l . l o . p eu
chavez	ch a . b e . s eu
dumont	d wi . m o ng
padua	p a . d u . a
arbuzov	a . l eu . b u . j o . p eu
carney	k a . n i
gandhi	g a n . d i
kerekou	k e . l e . k u
jascha	ya . s ya
dempsey	d e m . s i
spener	s yu . p e . n eo
carducci	k a . l eu . d u . ch i
gaspar	g a . s eu . p a
seamus	s ye . i . m eo . s eu
millais	m i l . l e . i
regina	l i . j a . i . n a
marcello	m a . l eu . ch e l . l o
gertsen	g e . l eu . ch e n
stern	s yu . t e . l eu n
bertrand	b e . l eu . t eu . l a ng
hyatt	h a . i . eo s
schnitzler	s yu . n i . ch eu l . l eo
menderes	m e n . d e . l e . s eu
timoshenko	t i . m o . s we n . k o
stoyanov	s eu . t o . ya . n o . p eu
dampier	d ae m . p i . eo
kazakhstan	k a . j a . h eu . s eu . t a n
ariosto	a . l i . o . s eu . t o
orville	o . b i l
obi	o . b i
vaduz	p a . d u . ch eu
hitch	h i . ch i
holley	h o l . l i
sherman	s yeo . m eo n
capone	k a . p o . n e
narciso	n a . l eu . s i . s o
prim	p eu . l i m
rombach	l o m . b a . h eu
winfried	wi n . p eu . l e . d eu
knowles	n o l . j eu
priestley	p eu . l i . s eu . t eu l . l i
lacy	l e . i . s i
inez	a . i . n e . j eu
maillol	m a . yo l
arizona	ae . l i . j o . n a
alberto	a l . b e . l eu . t o
shirley	s yeo l . l i
orwell	o . we l
murillo	m u . l i . yo
indiana	i n . d e . e . n a
meyerbeer	m a . i . eo . b e . eo
shoup	s yu . p eu
roosevelt	l u . s eu . b e l . t eu
lissajous	l i . s a . j u
pax	p a g . s eu
tony	t o . n i
philipe	p i l . l i . p eu
irwin	eo . wi n
desnos	d e . s eu . n o . s eu
jane	j e . i n
terry	t e . l i
ney	n e
sikorski	s i . k o . l eu . s eu . k i
rawlings	l o l . l i ng . s eu
ferrara	p e . l a . l a
erastus	e . l a . s eu . t u . s eu
tran	t eu . l a n
synge	s i ng
ella	e l . l a
durban	d eo . b a n
yehudi	ye . h u . d i
maor	m a . o
schaeffer	s we . p eo
wisconsin	wi . s eu . k o n . s i n
giauque	j i . o . k eu
hines	h a . i n . j eu
winthrop	wi n . s eu . l eo b
oldham	o l . d eu . h ae m
deirdre	d e . eo . d eu . l eu
dortmund	d o . l eu . t eu . m u n . t eu
kinck	k i ng . k eu
babe	b e . i . b eu
silone	s i l . l o . n e
brussels	b eu . l wi . s e l
barmen	b a . l eu . m e n
behrman	b e . eo . m eo n
hannover	h a . n o . b eo
wharton	wa . t eu n
kennedy	k e . n e . d i
fonda	p o n . d a
blackpool	b eu l . l ae g . p u l
curtis	k eo . t i . s eu
cardinal	k a . d i . n a l
mozart	m o . ch a . l eu . t eu
zeeland	j e l . l a n . d eu
giacometti	j a . k o . m e . t i
haydn	h a . i . d eu n
pullman	p u l . m eo n
gogh	g o . h eu
marie	m a . l i
maia	m a . i . a
ethan	i . s eo n
perl	p eo l
meunier	m oe . n i . e
wallace	wo l . l a . s eu
bodo	b o . d o
maximilian	m a g . s i . m i l . l i . a n
newman	n yu . m eo n
albert	ae l . b eo . t eu
burke	b eo . k eu
hartle	h a . t eu l
wallach	b a l . l a . h eu
mayhew	m e . i . h yu
francesca	p eu . l a n . ch e . s eu . k a
hidalgo	i . d a l . g o
schutz	s yu . ch eu
duncan	d eo n . k eo n
rahal	l a . h o . l eu
dylan	d i l . l eo n
santos	s a n . t u . s eu
fidel	p i . d e l
ethiopia	e . t i . o . p i . a
alessio	a l . l e . s i . o
parly	p a . l eu l . l i
wheatstone	h wi . t eu . s eu . t o n
alex	a l . l e g . s eu
heinrich	h a . i n . l i . h i
rodenbach	l o . d e n . b a . h eu
gyula	j u l . l eo
rod	l o . d eu
keri	k e . l i
braine	b eu . l e . i n
jon	yo n
shamir	s ya . m i . l eu
wheelock	h wi l . l a g
hancock	h ae n . k o g
borg	b o . g eu
ovechkin	o . b e . ch i . k i n
adil	a . d i l
miles	m a . i l . s eu
novgorod	n o . b eu . g o . l o . t eu
wolfowitz	u l . p o . wi . ch eu
roman	l o . m a n
gennady	g e n . n a . d i
duvalier	d wi . b a l . l i . e
agassi	ae . g eo . s i
holstein	h o l . s eu . t a . i n
brooks	b eu . l u g . s eu
vazov	b a . j o . p eu
claxton	k eu l . l e g . s eu . t eo n
stephane	s eu . t e . p a n
bethesda	b e . d e . s eu . d a
choiseul	s yo . a . j u l
salmon	s a l . m o ng
emery	e . m eo . l i
ravel	l a . b e l
ulises	yu l . l i . s i . s eu
ellen	e l . l e n
ericsson	e . l i g . s eu n
kitchener	k i . ch i . n eo
allen	ae l . l eo n
tricia	t eu . l i . s i . a
windaus	b i n . d a . u . s eu
baldwin	b o l . d eu . wi n
dordrecht	d o . l eu . t eu . l e . h i . t eu
altamira	a l . t a . m i . l a
driesch	d eu . l i . s yu
jamal	j a . m a l
mingdao	m i ng . d a . o
croatia	k eu . l o . a . t i . a
wyoming	wa . i . o . m i ng
magendie	m a . j a ng . d i
kautsky	k a . u . ch eu . k i
cesare	ch e . s a . l e
eager	i . g eo
branting	b eu . l a n . t i ng
pfitzner	p i . ch eu . n eo
rosario	l o . s a . l i . o
arab	a . l a b
laura	l a . u . l a
baum	b a . u m
kasavubu	k a . s a . b u . b u
vecellio	b e . ch e l . l i . o
chandra	ch a n . d eu . l a
karina	k a . l i . n a
weizmann	b a . i . ch eu . m a n
scipio	s eu . k i . p i . o
templeton	t e m . p eu l . t eo n
gloucester	g eu l . l o . s eu . t eo
silveira	s i l . b e . i . l a
light	l a . i . t eu
jana	j a . n a
reed	l i . d eu
pauline	p o l . l i n
jobim	j o . b i m
piraeus	p i . l e . u . s eu
dembinski	d e m . b i n . s eu . k i
symons	s i . m eo n . s eu
harlow	h a l . l o
perm	p e . l eu m
daudet	d o . d e
holbein	h o l . b a . i n
touraine	t u . l e n
borough	b o . l o
bara	b a . l a
burns	b eo n . s eu
cabral	k a . b eu . l a l
antonin	a n . t o . n i n
pyongyang	p yeo ng . ya ng
lowry	l o . l i
jones	j o n . s eu
edward	e . d eu . b a . l eu . t eu
marquis	m a . l eu . k i . s eu
bautista	b a . t i . s eu . t a
teague	t i . g eu
milt	m i l . t eu
maas	m a . s eu
rademacher	l a . d e . m a . h eo
almqvist	a l . l eu m . k eu . b i . s eu . t eu
thoma	t o . m a
weinheber	b a . i n . h e . b eo
smeaton	s eu . m i . t eo n
bremer	b eu . l e . m e . l eu
cruyff	k eu . l u . i . p eu
madeline	m ae . d eu l . l i n
bajer	b a . ye . l eu
cartagena	k a . l eu . t a . h e . n a
scott	s eu . k o . t eu
hernandez	h e . l eu . n a n . d e . s eu
yao	ya . o
soros	s o . l o . s eu
zannini	j ae . n i . n i
betty	b e . t i
delhi	d e l . l i
sperry	s eu . p e . l i
burger	b eo . g eo
bessarabia	b e . s a . l a . b i . a
lombroso	l o m . b eu . l o . s o
nouvel	n u . b e l
marit	m a . l i . t eu
furtado	p eo l . t a . d o
rene	l eu . n e
canning	k ae . n i ng
ingraham	i ng . g eu . l eo . h ae m
edmundo	e . d eu . m o n . d eu
campanella	k a m . p a . n e l . l a
rau	l a . u
cremer	k eu . l i . m eo
spitsbergen	s eu . k i . ch eu . b e . l eu . g e n
eggleston	e . g eu l . s eu . t eo n
marta	m a . l eu . t a
marlowe	m a l . l o
minsk	m i n . s eu . k eu
schwitters	s yu . b i . t eo . s eu
hal	h ae l
marett	m ae . l eo s
himmler	h i m . l eo
bolkiah	b o l . k i . a
pankhurst	p ae ng . k eu . h eo . s eu . t eu
veen	b i n
arie	a . l i . e
worthington	wo . s i ng . t eo n
vauban	b o . b a ng
felice	p e l . l i . s eu
hofmeister	h o . p eu . m a . i . s eu . t eo
wade	wa . d e
mendoza	m e n . d o . j a
zimmer	ch i . m eo
davy	d e . i . b i
beatrice	b e . a . t eu . l i . s eu
marcus	m a . l eu . k u . s eu
godin	g o . d i n
leo	l e . o
suess	j wi . s eu
wimbledon	wi m . b eu l . d eo n
knuth	k eu . n u . s eu
babs	b a b . s eu
agarwal	a . g a . l eu . wa l
jagger	j ae . g eo
rainy	l e . i . n i
hawthorne	h o . s o n
toivo	t o . i . b o
harvard	h a . b eo . d eu
zadornov	j a . d o . l eu . n o . p eu
paxton	p ae g . s eu . t eo n
willis	wi l . l i . s eu
sewell	s yu . eo l
dupont	d yu . p o ng
ira	a . i . l a
rumsfeld	l eo m . j eu . p e l . d eu
enver	e n . b e . l eu
langdon	l ae ng . d eo n
seychelles	s e . i . s ye l
morton	m o . t eo n
brandon	b eu . l ae n . d eo n
bamako	b a . m a . k o
lepsius	l e b . s i . u . s eu
cheyenne	s ya . i . e n
murat	m u . l a . t eu
daley	d e . i l . l i
heintze	h a . i . t eu . ch e
versailles	b e . l eu . s a . yu
count	k a . u n . t eu
bucharest	b u . k a . l e . s eu . t eu
heather	h e . d eo
casadesus	k a . j a . d eu . j wi
lauder	l o . d eo
lubbers	l wi . b e . l eu . s eu
cramer	k eu . l ae . m eo
greely	g eu . l i l . l i
lille	l i l
dumas	d wi . m a
sheppard	s ye . p eo . d eu
goldstein	g o l . d eu . s eu . t a . i n
gilles	j i l . s eu
euclid	yu . k eu l . l i . d eu
lothian	l o . d i . eo n
graham	g eu . l e . i . eo m
guadalupe	g wa . d a l . l u . p e
garner	g a . n eo
cantor	k a n . t o . eo
sinai	s i . n a . i
fein	p e . i n
wittig	b i . t i . h i
natta	n a . t a
noske	n o . s eu . k e
carpenter	k a . p e n . t eo
ryle	l a . i l
lech	l e . h eu
amin	a . m i n
rainwater	l e . i n . wo . t eo
vigo	b i . g o
kingsley	k i ng . j eu l . l i
hawke	h o . k eu
lithuania	l i . t u . a . n i . a
buck	p eo l
dawes	d o . s eu
dunn	d eo n
filmer	p i l . m eo
slovakia	s eu l . l o . b a . k i . a
olbrich	o l . b eu . l i . h i
kellogg	k e l . l o . g eu
sommerfield	s eo m . m eo . p i l . d eu
nilson	n i l . s o n
batman	b ae . t eu . m ae n
tate	t e . i . t eu
onsager	o n . s a . g eo
klemperer	k eu l . l e m . p e . l eo
porter	p o . t eo
rawlinson	l o l . l i n . s eu n
bert	b e . l eu . t eu
aasen	o . s e n
danforth	d ae n . p o . s eu
nolte	n o l . t e
tiepolo	t i . e . p o l . l o
schreker	s yu . l e . k eo
coker	k o . k eo
stoddard	s eu . t o . d a . d eu
undset	u n . s e . t eu
perlman	p eo l . m a n
mal	m a l
luciano	l u . ch i . a . n o
behn	b e n
solo	s o l . l o
jukes	j yu . k eu . s eu
lorraine	l o . l e n
suriname	s u . l i . n a m
hansen	h a n . s e n
tennessee	t e . n e . s i
sumatra	s u . m a . t eu . l a
torres	t o . l e . s eu
chandrasekhar	ch a n . d eu . l a . s e . k a . l eu
medhurst	m e . d eu . h eo . s eu . t eu
porta	p o . l eu . t a
solvay	s o l . b e . i
winifred	wi n . p eu . l e . d eu
rostand	l o . s eu . t a ng
katie	k e . i . t i
dave	d e . i . b eu
manchester	m ae n . ch e . s eu . t eo
avellaneda	a . b e . ya . n e . d a
nika	n i . k a
mike	m a . i . k eu
cressent	k eu . l e . s a ng
begin	b e . g i n
haworth	h a . s eu
belgium	b e l . g i . e
alina	a l . l i . n a
walsh	wa l . s i
coignet	k o . wa . n i . e
paavo	p a . b o
malpighi	m a l . p i . g i
james	j e . i m . s eu
pole	p o l
jaques	j a . k eu
penny	p e . n i
royce	l o . i . s eu
hanover	h a . n o . b eo
kiel	k i l
dreiser	d eu . l a . i . j eo
rude	l wi . d eu
edwards	e . d eu . wo . j eu
belarus	b e l . l o . l u . s i
samir	s a . m i . l eu
bertel	b e . l eu . t e l
hasler	h a . s eu l . l eo
pasternak	p a . s eu . t e . l eu . n a . k eu
ribera	l i . b e . l a
poisson	p u . a . s o ng
cara	k a . l a
block	b eu l . l o g
lobe	l o . b e
butenandt	b u . t e . n a n . t eu
pontoppidan	p o n . t o . p i . d a n
hindustan	h i n . d u . s eu . t a n
donnay	d o . n e
hedge	h e . j i
shu	s u
mai	m a . i
hamann	h a . m a n
buisson	b wi . s o ng
flynn	p eu l . l i n
tartini	t a . l eu . t i . n i
hains	e ng . s eu
kirby	k eo . b i
mate	m e . i . t eu
rembrandt	l e m . b eu . l a n . t eu
afanasiev	a . p a . n a . s i . ye . p eu
darius	d a . l i . u . s eu
mach	m a . h a
eliana	e l . l i . a . n a
dingler	d i ng . g eu l . l eo
asher	a . s e l
natalie	n a . t a l . l i
keith	k i . s eu
tikhonov	t i . h o . n o . p eu
newlands	n yu . l ae n . j eu
kanpur	k a n . p u . l eu
francois	p eu . l a ng . s u . a
viola	b i . o l . l a
bruckner	b eu . l u . k eu . n eo
noronha	n o . l o . n ya
hessen	h e . s e n
gapon	g a . p o n
southampton	s a . u . s ae m . p eu . t eo n
williams	wi l . l i . eo m . s eu
rashid	l a . s i . d eu
mauritius	m o . l i . s yeo . s eu
ziegler	ch i . g eu l . l eo
crispi	k eu . l i . s eu . p i
galton	g o l . t eo n
davies	d e . i . b i . s eu
latham	l e . i . d a m
bjorklund	b i . yo . l eu . k eu . l u n . t eu
svevo	s eu . b e . b o
sassoon	s eo . s u n
alfa	a l . p a
bessel	b e . s e l
lilongwe	l i l . l o ng . g we
maputo	m a . p u . t o
hall	h o l
roche	l o . ch e
vic	b i g
dopsch	d o . p eu . s yu
irena	i . l e . n a
roach	l o . ch i
kirkland	k eo . k eu l . l eo n . d eu
hauptmann	h a . u b . t eu . m a n
hunt	h eo n . t eu
pettit	p e . t i . t eu
rita	l i . t a
reichstein	l a . i . h i . s yu . t a . i n
tripoli	t eu . l i . p o l . l i
musset	m wi . s e
heidegger	h a . i . d e . g eo
stokowski	s eu . t o . k o . p eu . s eu . k i
denis	d e . n i . s eu
landau	l a n . d a . u
wend	we n . d eu
rosemary	l o . j eu . m e . l i
burg	b u . l eu . g eu
hotchkiss	h o . ch i . k i . s eu
gorky	g o . k i
quackenbush	k we g . k e n . b u . s i
harding	h a . d i ng
tasman	t a . s eu . m eo n
haller	h a l . l eo
melville	m e l . b i l
vavilov	b a . b i l . l o . p eu
charlotte	s ya l . l eo s
charles	ch a l . s eu
herbst	h eo . b eu . s eu . t eu
carnegie	k a . n e . g i
hahnemann	h a . n e . m a n
salvador	s a l . b a . d o . l eu
johannesburg	yo . h a . n e . s eu . b eo . g eu
estrada	e . s eu . t eu . l a . d a
ouagadougou	wa . g a . d u . g u
kok	k o . k eu
constantine	k o ng . s eu . t a ng . t i n
yale	ye . i l
shapley	s yae . p eu l . l i
prasad	p eu . l a . s a . d eu
seles	s e l . l e . s eu
liszt	l i . s eu . t eu
southey	s a . u . d i
sweelinck	s eu . b e l . l i ng . k eu
alton	a l . t o n
bourke	b o . k eu
bouton	b u . t o ng
bronte	b eu . l o n . t e
holloway	h o l . l eo . we . i
molly	m o l . l i
asimov	a . s i . m o . p eu
grein	g eu . l a . i n
kilauea	k i . l a . we . a
spiegel	s eu . p i . g e l
tang	d a ng
oursler	a . wo . s eu l . l eo
hartley	h a . t eu l . l i
banks	b ae ng . k eu . s eu
steele	s eu . t i l
bryullov	b eu . l yu l . l o . p eu
cates	k e . i . ch eu
haines	h e . i n . j eu
bloemfontein	b eu l . l u m . p o n . t e . i n
hurst	h eo . s eu . t eu
juma	j u . m a
kanin	k a . n i n
carolina	k ae . l o l . l a . i . n a
bishop	b i . s yo b
nagy	n eo . j i
suqi	ss u . ch i
bland	b eu l . l ae n . d eu
ricci	l i . ch i
joost	yo . s eu . t eu
florey	p eu l . l o . l i
foley	p o l . l i
deissmann	d a . i . s eu . m a n
wayland	we . i l . l ae n . d eu
faraday	p ae . l eo . d i
jena	ye . n a
veronica	b e . l o . n i . k a
schopenhauer	s yo . p e n . h a . wo
popov	p o . p o . p eu
windelband	b i n . d e l . b a n . t eu
rosetta	l o . j e . t a
ismailia	i . s eu . m a . i l . l i . a
renault	l eu . n o
buhari	b u . h a . l i
dirk	d eo . k eu
baldus	b a l . d u . s eu
black	b eu l . l ae g
abdullah	a b . d u l . l a
bui	b u . i
gunnar	g u n . n a . l eu
victorien	b i g . t o . l i . ae ng
hirsch	h eo . s wi
ingrid	i ng . g eu . l i . d eu
winnie	wi . n i
moers	m o . eo . s eu
wolfe	u l . p eu
jarry	j a . l i
riley	l a . i l . l i
sophie	s o . p i
varenius	b a . l e . n i . u . s eu
kuznets	k u . j eu . n e . ch eu
perreau	p e . l o
lindberg	l i n . d eu . b eo . g eu
powell	p a . wo l
zinzendorf	ch i n . ch e n . d o . l eu . p eu
gneist	g eu . n a . i . s eu . t eu
uno	u . n o
dirichlet	d i . l i . k eu l . l e
harden	h a . d eu n
tiffany	t i . p a . n i
mott	m o . t eu
java	j a . b a
essex	e . s i g . s eu
giuliani	j u l . l i . a . n i
montenegro	m o n . t e . n e . g eu . l o
weingartner	b a . i n . g a . l eu . t eu . n eo
merriam	m e . l i . eo m
gianni	j a n . n i
bobby	b o . b i
sammy	s ae . m i
emmanuel	e . m a . n wi . e l
ness	n e . s eu
cash	k ae . s i
gutierrez	g u . t i . e . l e . s eu
blackburn	b eu l . l ae g . b eo n
darko	d a . l eu . k o
julie	j u l . l i
orlando	o l . l ae n . d o
mansart	m a ng . s a . l eu
cannon	k ae . n eo n
castries	k ae . s eu . t eu . l i . s eu
azhari	a . j a . l i
dubrovnik	d u . b eu . l o . b eu . n i . k eu
gini	j i . n i
neville	n e . b i l
milhaud	m i . yo
bangalore	b a ng . g a l . l o . l eu
blanc	b eu l . l a ng
reischauer	l a . i . s ya . wo
klondike	k eu l . l o n . d a . i . k eu
guyau	g wi . yo
hermes	h e . l eu . m e . s eu
strasser	s eu . t eu . l a . j eo
bruce	b eu . l u . s eu
gonzales	g o n . s a l . l e . s eu
alfred	a l . p eu . l e . d eu
grotewohl	g eu . l o . t e . b o l
dias	d i . eo . s eu
basseterre	b a . s eu . t e . l eu
helgeland	h e l . g eo l . l eo n . d eu
dannemann	d a . n e . m a n
octavia	o g . t a . b i . a
roxanne	l o g . s a n . n eu
vieta	b i . e . t a
guayaquil	g wa . ya . k i l
charlotte	s ya l . l o . t eu
flesch	p eu l . l e . s wi
salgado	s a l . g a . d o
sutton	s eo . t eo n
proctor	p eu . l o g . t eo
gustav	g u . s eu . t a . b eu
arndt	a . l eu n . t eu
monaco	m o . n a . k o
cochet	k o . s we
patrice	p a . t eu . l i . s eu
modigliani	m o . d i l . l i . a . n i
irons	a . i . eo n . s eu
rios	l i . o . s eu
roald	l o . a l
thebes	t e . b e
kalman	k a l . m a n
aragon	a . l a . g o n
siegel	s i . g e l
bonds	b o n . j eu
milosevic	m i l . l o . s ye . b i . ch i
vico	b i . k o
maeterlinck	m e . i . t eo . l i ng . k eu
engelbert	e ng . g e l . b eo . t eu
holbrooke	h o l . b eu . l u g
michelson	m a . i . k eo l . s eu n
chahine	s ya . h i n
stahl	s yu . t a l
barrie	b ae . l i
moreau	m o . l o
coen	k o . e n
antonescu	a n . t o . n e . s eu . k u
stanislav	s eu . t a . n i . s eu l . l a . p eu
nafis	n a . p i . s eu
blok	b eu l . l o . k eu
gaillard	g a . i . ya . l eu
vinay	b i . n a . i
maurer	m a . u . l eo
klopstock	k eu l . l o b . s yu . t o . k eu
devi	d e . b i
vinogradoff	b i . n o . g eu . l a . d o . p eu
carlin	k a l . l i n
wilfred	wi l . p eu . l e . d eu
espy	e . s eu . p i
gabriel	g a . b eu . l i . e l
cranach	k eu . l a . n a . h eu
ungaretti	u ng . g a . l e . t i
nolde	n o l . d e
bernheim	b e . l eu n . h a . i m
heitor	h e . i . t o . l eu
staudt	s yu . t a . u . t eu
vidal	b i . d a l
eva	e . b a
benvenuto	b e n . b e . n u . t o
heyerdahl	h e . wi . e . l eu . d a l
castiglione	k a . s eu . t i l . l i . o . n e
straub	s eu . t eu . l a . u . b eu
goldberg	g o l . d eu . b eo . g eu
simms	s i m . s eu
reinhardt	l a . i n . h a . l eu . t eu
berne	b e . l eu n
heseltine	h e . s eu l . t a . i n
shaftesbury	s yae . p eu . ch eu . b e . l i
naples	n a . p o l . l i
ferrari	p e . l a . l i
alfons	a l . p o n . s eu
brady	b eu . l ae . d i
chanel	s ya . n e l
quisling	k eu . b i . s eu l . l i ng
bayreuth	b a . i . l o . i . t eu
sinan	s i . n a n
palau	p a l . l a . u
sapir	s a . p i . eo
norma	n o . m a
neve	n e . b eu
jayne	j e . i n
eurasia	yu . l a . s i . a
thaddeus	d a . d ae . o
ezra	e . s eu . l a
petri	p e . t eu . l i
sharpe	s ya . p eu
barcelona	b a . l eu . s e l . l o . n a
marty	m a . l eu . t i
francesco	p eu . l a n . ch e . s eu . k o
bonnard	b o . n a . l eu
arad	a . l a . d eu
sneider	s eu . n a . i . d eo
hoxha	h o . j a
mary	m e . l i
pearl	p eo l
nadine	n e . i . d i n
alessandro	a l . l e . s a n . d eu . l o
jansky	j ae n . s eu . k i
galway	g o l . we . i
laird	l e . eo . d eu
baird	b e . eo . d eu
khan	k a n
moshe	m o . s ye
cagliari	k a l . l i . a . l i
herford	h e . eo . p o . t eu
platen	p eu l . l a . t e n
pasto	p a . s eu . t o
amado	a . m a . d o
constantin	k o n . s eu . t a n . t i n
whitney	h wi . t eu . n i
munich	m wi n . h e n
ecuador	e . k wa . d o . l eu
lubbock	l eo . b eo g
moser	m o . j eo
lander	l ae n . d eo
santoro	s a n . t o . l o
freya	p eu . l o . i . ya
dryden	d eu . l a . i . d eu n
mendelssohn	m e n . d e l . s eu . j o n
gill	g i l
richter	l i . h i . t eo
erhard	e . l eu . h a . l eu . t eu
crome	k eu . l o m
lebedev	l e . b e . d e . p eu
hulse	h eo l . s eu
magnus	m a . g eu . n u . s eu
warwickshire	wo . l i g . s yeo
argentina	a . l eu . h e n . t i . n a
colonna	k o l . l o n . n a
elaine	i l . l e . i n
reger	l e . g eo
bowring	b o . u . l i ng
labaki	l a . b a . k i
eigen	a . i . g e n
riverside	l i . b eo . s a . i . d eu
waage	b o . g e
lum	l eo m
garr	g a
bly	b eu l . l a . i
paul	p o l
cohan	k o . h ae n
barker	b a . k eo
edelstein	e . d e l . s eu . t e . i n
szell	s e l
standen	s eu . t ae n . d eu n
allison	ae l . l i . s eu n
despiau	d e . s eu . p i . o
mordecai	m o . l eu . d eu . g ae
brad	b eu . l ae . d eu
frey	p eu . l o . i
irma	i . l eu . m a
holger	h o l . g e . l eu
zak	j ae g
serra	s e . l a
beyer	b a . i . eo
guinea	g i . n i
galsworthy	g o l . j eu . wo . d i
paul	b a . u l
tosti	t o . s eu . t i
roger	l o . j eo
rebecca	l e . b e . k a
martino	m a . l eu . t i . n o
escobar	e . s eu . k o . b a
speth	s eu . p e . s eu
stiglitz	s eu . t i . g eu l . l i . ch eu
carver	k a . b eo
italo	i . t a l . l o
kantor	k ae n . t eo
pandora	p a n . d o . l a
praga	p eu . l a . g a
andes	a n . d e . s eu
arp	a . l eu . p eu
mclaren	m ae g . l a . l e n
hasan	h a . s a n
ponchielli	p o n . k i . e l . l i
pelegrin	p e l . l e . g eu . l i n
dan	d a n
calypso	k a l . l i b . s o
barkley	b a . k eu l . l i
licht	l i . h i . t eu
horace	h o . l a . t i . u . s eu
riemenschneider	l i . m e n . s yu . n a . i . d eo
brindley	b eu . l i n . d eu l . l i
bossuet	b o . s wi . e
bristol	b eu . l i . s eu . t eu l
hyderabad	h a . i . d e . l a . b a . d eu
paloma	p a l . l o . m a
orange	o . l a ng . ye
kiefer	k i . p eo
pelle	p e l . l e
ulf	u l . p eu
arcos	a . l eu . k o . s eu
lahti	l a . t i
assad	a . s a . d eu
bow	b o . u
longo	l o ng . g o
brunat	b eu . l wi . n a
deacon	d i . k o n
condorcet	k o ng . d o . l eu . s e
yemen	ye . m e n
jost	yo . s eu . t eu
capuana	k a . p u . a . n a
naumann	n a . u . m a n
radcliffe	l ae . d eu . k eu l . l i . p eu
pea	p e . n ya
janet	j a . n e
gayle	g e . i l
sally	s ae l . l i
born	b o . l eu n
litvinov	l i . t eu . b i . n o . p eu
flory	p eu l . l o . l i
schmiedeberg	s yu . m i . d e . b e . l eu . k eu
pablo	p a . b eu l . l o
smithson	s eu . m i . s eu . s eu n
sweet	s eu . wi . t eu
nina	n i . n a
ashley	ae . s yu l . l i
lanson	l a ng . s o ng
zanetti	s a . n e . t i
lombardo	l o m . b a . l eu . d o
marais	m a . l e
jan	ya n
sheraton	s ye . l eo . t eo n
khachaturyan	h a . ch a . t u . l i . a n
senefelder	j e . n e . p e l . d eo
rocco	l o . k o
oken	o . k e n
auken	a . u . k e n
ouedraogo	u . e . d eu . l a . o . g o
moneta	m o . n e . t a
casey	k e . i . s i
grasse	g eu . l ae . s eu
strand	s eu . t eu . l ae n . d eu
waterloo	wo . t eo l . l u
gantt	g ae n . t eu
ugarte	u . g a . l eu . t e
zamora	s a . m o . l a
hendricks	h ae n . d eu . l i g . s eu
clapeyron	k eu l . l a . p e . l o ng
jade	j e . i . d eu
warwick	wo . l i g
fourier	p u . l i . e
guarino	g wa . l i . n o
mello	m e l . l o
marvin	m a . b i n
woodworth	u . d eu . wo . s eu
berchem	b eo . ch e m
bangui	b a ng . g i
roux	l u
amazon	a . m a . j o n
hay	h e . i
millard	m i l . l eo . d eu
derek	d e . l i g
champollion	s ya ng . p o l . l i . o ng
rossi	l o . s i
brattain	b eu . l ae . t eu n
indra	i n . d eu . l a
poiseuille	p o . a . j eu . i . yu
turkmenistan	t u . l eu . k eu . m e . n i . s eu . t a n
mosca	m o . s eu . k a
jepsen	j e . p eu . s eu n
maud	m o . d eu
munro	m eo n . l o
probst	p eu . l o . b eu . s eu . t eu
burdin	b eo . d i n
portland	p o . t eu l . l ae n . d eu
salten	j a l . t e n
carmel	k a . l eu . m e l
symington	s a . i . m i ng . t eo n
capote	k eo . p o . t i
hoffman	h o . p eu . m a n
carry	k e . eo . l i
gosse	g o . s eu
hedin	h e . d i n
epstein	e b . s eu . t a . i n
hearn	h o n
karelia	k a . l e l . l i . a
ilyushin	i l . l yu . s i n
leoni	l e . o . n i
uccello	u . ch e l . l o
peary	p i . eo . l i
israel	i . s eu . l a . e l
spontini	s eu . p o n . t i . n i
dayan	d a . ya n
nagel	n a . g e l
elion	e l . l i . eo n
egorov	ye . g o . l o . p eu
hench	h e n . ch i
metzler	m e . ch eu . l eo
angara	a n . g a . l a
sanz	s a n . s eu
leipzig	l a . i . p eu . ch i . h i
fritsch	p eu . l i . ch i
bouchard	b u . s ya . l eu
dali	d a l . l i
roque	l o . k e
dora	d o . l a
raffles	l ae . p eu l . s eu
ferdinand	p e . l eu . d i . n a n . d eu
stevie	s eu . t i . b i
ashton	ae . s yu . t eo n
wickham	wi . k eo m
marcuse	m a . l eu . k u . j e
szymanowski	s i . m a . n o . p eu . s eu . k i
eystein	e . s eu . t a . i n
blache	b eu l . l a . s yu
gramme	g eu . l a m
petipa	p e . t i . p a
laurie	l o . l i
bernd	b e . l eu n . t eu
greco	g eu . l e . k o
york	yo . k eu
uzbekistan	u . j eu . b e . k i . s eu . t a n
seligman	s e l . l i . g eu . m eo n
cavour	k a . b o . u . l eu
kahn	k a n
gilels	g i l . l e l . s eu
ems	e m . s eu
cardano	k a . l eu . d a . n o
prado	p eu . l a . d o
heyden	h e . i . d e n
lisbon	l i . s eu . b o n
haneke	h a . n e . k e
pepe	p e . p e
benson	b e n . s eu n
monteiro	m o n . t e . i . l u
westinghouse	we . s eu . t i ng . h a . u . s eu
rajiv	l a . j i . b eu
fajans	p a . ya n . s eu
buffalo	b eo . p eo l . l o
kenny	k e . n i
gaza	g a . j a
bode	b o . d e
usher	eo . s yeo
villanueva	b i l . l a . n u . e . b a
mohamad	m o . h a . m a . d eu
jidda	j i . d a
negev	n e . g e . b eu
attwood	ae . t u . d eu
washington	wo . s i ng . t eo n
langland	l ae ng . g eu l . l eo n . d eu
hanzi	h a n . jj eu
bakan	b a . k a n
lacaille	l a . k a . yu
sumner	s eo m . n eo
kalamazoo	k a l . l a . m a . j u
araujo	a . l a . u . j o
egypt	i . j i b . t eu
machado	m a . ch a . d o
wieniawski	b i . e . n i . a . p eu . s eu . k i
jerome	j e . l o m
huberman	h yu . b eo . m eo n
woods	u . j eu
farren	p ae . l eo n
caird	k e . eo . d eu
mondriaan	m o n . d eu . l i . a n
haifa	h a . i . p a
torre	t o . l e
barnard	b a . n eo . d eu
pitman	p i . t eu . m eo n
sturm	s eu . t eo m
hekmatyar	h e . k eu . m a . t i . a . l eu
sorel	s o . l e l
liebmann	l i . p eu . m a n
schroeder	s yu . l o . d eo
bette	b e . t i
ball	b o l
nodier	n o . d i . e
nath	n a . s eu
dyke	d a . i . k eu
fiske	p i . s eu . k eu
greenspan	g eu . l i n . s eu . p eo n
alexandria	a l . l e g . s a n . d eu . l i . a
heidelberg	h a . i . d e l . b e . l eu . k eu
gaye	g e . i
trenton	t eu . l e n . t eo n
zimbabwe	j i m . b a . b eu . we
cajori	k a . j o . l i
carolyn	k ae . l eo l . l i n
rudd	l eo . d eu
kossel	k o . s e l
gryphius	g eu . l i . p i . u . s eu
moira	m o . i . l a
quigley	k wi . g eu l . l i
mildred	m i l . d eu . l e . d eu
theobald	s i . eo . b eo l . d eu
quesnay	k e . n e
devon	d e . b eo n
pirandello	p i . l a n . d e l . l o
charlie	ch a l . l i
trevor	t eu . l e . b eo
goujon	g u . j o ng
asia	a . s i . a
calderwood	k a l . d eo . u . d eu
wilkins	wi l . k i n . s eu
ashkhabad	a . s yu . h a . b a . t eu
edith	e . d i . t eu
bradbury	b eu . l ae . d eu . b eo . l i
gene	j i n
kummer	k u . m eo
blumberg	b eu l . l eo m . b eo . g eu
redford	l e . d eu . p eo . d eu
shakespeare	s ye . i g . s eu . p i . eo
hansson	h a n . s o n
abir	a . b i . l eu
scalia	s eu . k ae l . l i . a
kann	k a n
joaquin	h o . a . k i n
cromer	k eu . l o . m eo
gioberti	j o . b e . l eu . t i
jantzen	j a n . ch e n
cindy	s i n . d i
bion	b i . o n
appia	a . p i . a
yvonne	i . b o n . n eu
baumann	b a . u . m a n
held	h e l . d eu
kenneth	k e . n i . s eu
bassett	b a . s e s
pfeiffer	p a . i . p eo
meyerhof	m a . i . eo . h o . p eu
andersson	a n . d e . l eu . s o n
rahman	l a . m a n
lima	l i . m a
lehmbruck	l e m . b eu . l u . k eu
bizet	b i . j e
waltari	b a l . t a . l i
delia	d e l . l i . a
katz	k a . ch eu
louis	l u . i . s eu
krauss	k eu . l a . u . s eu
nipkow	n i b . k o
leverrier	l eu . b e . l i . e
raya	l a . ya
uruguay	u . l u . g wa . i
prior	p eu . l a . i . eo
baden	b a . d e n
mecklenburg	m e . k eu l . l e n . b u . l eu . k eu
camillo	k a . m i l . l o
piotrowski	p i . o . t eu . l o . p eu . s eu . k i
masa	m a . s a
mutter	m u . t eo
bernauer	b e . l eu . n a . wo
cauchy	k o . s i
agostino	a . g o . s eu . t i . n o
tinbergen	t i n . b eo . g e n
fielding	p i l . d i ng
bernier	b e . l eu . n i . e
prince	p eu . l i n . s eu
espejo	e . s eu . p e . h o
kram	k eu . l ae m
bolzano	b o l . ch a . n o
benedetti	b e . n e . d e . t i
perez	p e . l e . j eu
spence	s eu . p e n . s eu
perec	p e . l e g
petrarca	p e . t eu . l a . l eu . k a
beauchamp	b o . s ya ng
steffen	s eu . t e . p eu n
vernon	b eo . n o n
sharp	s ya . p eu
milestone	m a . i l . s eu . t o n
hereford	h e . l i . p eo . d eu
nils	n i l . s eu
nachtigal	n a . h eu . t i . g a l
ogden	o . g eu . d eo n
tyler	t a . i l . l eo
horatio	h eo . l e . i . s yo
ganges	g ae n . j i . s eu
connor	k o . n eo
dushanbe	d u . s ya n . b e
jung	yu ng
howe	h a . u
jamsa	j a m . s a
lilli	l i l . l i
brno	b eu . l eu . n o
abadan	a . b a . d a n
rusk	l eo . s eu . k eu
pasolini	p a . s o l . l i . n i
drexler	d eu . l e g . s eu l . l eo
adam	a . d a m
marion	m ae . l i . eo n
franco	p eu . l a ng . k o
gottsched	g o . t eu . s ye . t eu
shoemaker	s yu . m e . i . k eo
lancashire	l ae ng . k eo . s yeo
messerer	m e . s e . l e . l eu
therese	t e . l e . j eu
blass	b eu . l e . s eu
anthony	a n . s o . n i
unsworth	eo n . s eu . wo . s eu
pretoria	p eu . l i . t o . l i . a
talcott	t ae l . k eo s
londonderry	l eo n . d eo n . d e . l i
schwabe	s yu . b a . b e
boult	b o . u l . t eu
madison	m ae . d i . s eu n
haig	h e . i . g eu
barrow	b a . l o . u
verner	b e . l eu . n eo
gama	g a . m a
tagore	t a . g o . l eu
ioffe	yo . p e
mead	m i . d eu
ferreira	p e . l e . i . l a
laski	l ae . s eu . k i
maistre	m e . s eu . t eu . l eu
giusti	j u . s eu . t i
bloch	b eu l . l o . k eu
bury	b eo . l i
goethe	g oe . t e
mahoney	m a . h o . n i
gregor	g eu . l e . g o . l eu
pickering	p i . k eo . l i ng
lion	l i . o n
ingvar	i ng . b a . l eu
twining	t eu . wa . i . n i ng
sparks	s eu . p a g . s eu
lyon	l i . o ng
helen	h e l . l e n
tana	t a . n a
szilard	j i l . l a . d eu
milano	m i l . l a . n o
merle	m eo l
sangallo	s a ng . g a l . l o
theodore	s i . eo . d o . eo
morrison	m o . l i . s eu n
goodwin	g u s . wi n
blanqui	b eu l . l a ng . k i
humphery	h eo m . p eu . l i
frans	p eu . l a n . s eu
evan	e . b eo n
travolta	t eu . l a . b o l . t a
kokoschka	k o . k o . s yu . k a
tracy	t eu . l e . i . s i
lowie	l o . wi
albrecht	a l . b eu . l e . h i . t eu
jules	j u l . s eu
seurat	s oe . l a
parker	p a . k eo
elisa	e l . l i . s a
alma	a l . m a
east	d o ng . b a ng
duvall	d yu . b a l
venturi	b e n . t u . l i
prokhorov	p eu . l o . h o . l o . p eu
south	s a . u . s eu
boswell	b o . j eu . we l
moritz	m o . l i . ch eu
cordelia	k o . d e l . l i . a
goldwyn	g o l . d eu . wi n
ernestine	eo . n i . s eu . t i n
ernesto	e . l eu . n e . s eu . t o
nader	n e . i . d eo
lolita	l o . l i . t a
duval	d yu . b a l
waugh	wo
skopje	s eu . k o . p e
panama	p a . n a . m a
spencer	s eu . p e n . s eo
kallas	k a l . l a . s eu
massachusetts	m ae . s a . ch u . s e . ch eu
peper	p e . p e . l eu
denmark	d e n . m a . k eu
rubens	l u . b e n . s eu
nujoma	n u . j o . m a
pertini	p e . l eu . t i . n i
roebuck	l o . b eo g
ecevit	e . j e . b i . t eu
brink	b eu . l i ng . k eu
del	d e l
europe	yu . l eo b
bouillon	b u . i . yo ng
grenville	g eu . l e n . b i l
schliemann	s yu l . l i . m a n
pilcher	p i . ch eo
chiesa	k i . e . s a
dev	d e . b eu
brighton	b eu . l a . i . t eu n
karamzin	k a . l a m . j i n
belgrade	b e l . g eu . l a . d eu
lill	l i l
wayne	we . i n
syse	s wi . s e
armenia	a . l eu . m e . n i . a
atal	a . t a l
kohn	k o n
banting	b ae n . t i ng
meg	m ae g
huntington	h eo n . t i ng . t eo n
angelou	ae n . j e l . l u
defoe	d i . p o
amundsen	a . m u n . j e n
ross	l o . s eu
juliet	j u l . l i . e s
latimer	l e . i . t i . m eo
clarendon	k eu l . l ae . l eo n . d eo n
myers	m a . i . eo . s eu
house	h a . u . s eu
holmes	h o m . s eu
bayard	b a . ya . l eu
maxine	m ae g . s i n
morin	m o . l ae ng
michie	m i . ch i . e
catalonia	k a . t a l . l o . n i . a
discovery	d i . s eu . k eo . b eo . l i
glenn	g eu l . l e n
chamberlain	ch e . i m . b eo l . l i n
pagano	p a . g a . n o
macdonald	m ae g . d o . n eo l . d eu
mirabeau	m i . l a . b o
douglas	d eo . g eu l . l eo . s eu
kuhnau	k u . n a . u
diderot	d i . d eu . l o
das	d a . s eu
geijer	ye . i . ye . l eu
courtney	k o . t eu . n i
lagerkvist	l a . g e . l eu . k eu . b i . s eu . t eu
decker	d e . k eo
lamarr	l a . m a
jacobsen	ya . k o b . s e n
jacksonville	j ae g . s eu n . b i l
helm	h e l . l eu m
arnhem	a . l eu n . h e m
mandeville	m ae n . d eo . b i l
voltaire	b o l . t e . l eu
steiner	s yu . t a . i . n eo
taft	t ae . p eu . t eu
toland	t o l . l eo n . d eu
willy	b i l . l i
kenneth	k e . n e . s eu
yul	yu l
hellsing	h e l . s i ng
speyer	s yu . p a . i . eo
paris	p a . l i
laforgue	l a . p o . l eu . g eu
lanier	l eo . n i . eo
philipp	p i l . l i . p eu
theodore	t e . o . d o . l eu
rumford	l eo m . p eo . d eu
sor	s o . l eu
montaigne	m o ng . t e . n yu
hummel	h u m . m e l
amyot	a . m i . yo
gotthelf	g o . t eu . h e l . p eu
kieran	k i . l eo n
ronge	l o ng . i
minaux	m i . n o
clint	k eu l . l i n . t eu
tuvalu	t u . b a l . l u
ricken	l i . k e n
dovzhenko	d o . p eu . j e n . k o
janis	j e . n i . s eu
isaacs	i . s a g . s eu
trimble	t eu . l i m . b eu l
fort	p o . l eu
goldsworthy	g o l . j eu . wo . d i
harlem	h a l . l e m
cendrars	s a ng . d eu . l a . l eu
malipiero	m a l . l i . p i . e . l o
stieglitz	s eu . t i . g eu l . l i . ch eu
herbart	h e . l eu . b a . l eu . t eu
bean	b i n
algiers	a l . j e
kathmandu	k a . t eu . m a n . d u
damon	d e . i . m eo n
rufus	l u . p eo . s eu
grillo	g eu . l i l . l o
kielland	s ye l . l a n
imre	i m . l e
cousin	k u . j ae ng
maria	m a . l i . a
labrador	l ae . b eu . l a . d o
kilkenny	k i l . k e . n i
megan	m e . g a n
murphy	m eo . p i
bourne	b o n
castello	k a . s eu . t e l . l o
freitas	p eu . l e . i . t a . s eu
escher	e . s yeo
fernand	p e . l eu . n a ng
parkes	p a g . s eu
alec	ae l . l i g
pio	p i . o
christophe	k eu . l i . s eu . t o . p eu
tad	t ae . d eu
hilbert	h i l . b e . l eu . t eu
lodge	l o . j i
waterford	wo . t eo . p eo . d eu
fournier	p u . l eu . n i . e
cossa	k o . s a
goldsmith	g o l . d eu . s eu . m i . s eu
keyserling	k a . i . j eo l . l i ng
bandello	b a n . d e l . l o
diefenbaker	d i . p e n . b e . i . k eo
gable	g e . i . b eu l
trevelyan	t eu . l i . b e l . l i . eo n
werner	b e . l eu . n eo
kauffmann	k a . u . p eu . m a n
antony	a n . t o . n i
kalimantan	k a l . l i . m a n . t a n
cox	k o g . s eu
kuprin	k u . p eu . l i n
goodman	g u s . m ae n
enesco	e . n e . s eu . k o
piccinni	p i . ch i n . n i
gosset	g o . s e s
luigi	l u . i . j i
semenov	s e . m yo . n o . p eu
borodin	b o . l o . d i n
shackleton	s yae . k eu l . t eo n
fontana	p o n . t a . n a
kaiser	k a . i . j eo
lynne	l i n
nemanja	n e . m a . n ya
faith	p e . i . s eu
perugino	p e . l u . j i . n o
baker	b e . i . k eo
sigmund	s i . g eu . m eo n . d eu
fern	p eo n
badger	b ae . j eo
cornwell	k o n . wo l
linden	l i n . d eu n
taglioni	t a l . l i . o . n i
gracchus	g eu . l a . k u . s eu
blumenbach	b eu l . l u . m e n . b a . h eu
barbados	b a . b e . i . d o . s eu
vader	b e . i . d eo
zapata	s a . p a . t a
tora	t o . l a
mang	m a ng
ontario	o n . t a . l i . o
hicks	h i g . s eu
vos	b o . s eu
haber	h a . b eo
alf	a l . p eu
durand	d yu . l a n . d eu
renn	l e n
rey	l e . i
debussy	d eu . b wi . s i
wallis	wi l . l i . s eu
michel	m i . s ye l
galbraith	k ae l . b eu . l e . i . s eu
dario	d a . l i . o
veblen	b e . b eu l . l eo n
antoinette	a ng . t u . a . n e . t eu
gil	g i l
espronceda	e . s eu . p eu . l o n . s e . d a
elsheimer	e l . s eu . h a . i . m eo
kohlrausch	k o l . l a . u . s yu
magnitogorsk	m a . g eu . n i . t o . g o . l eu . s eu . k eu
renee	l eu . n e
humason	h yu . m e . i . s eu n
waltham	wo l . s eo m
kingstown	k i ng . s eu . t a . u n
schlegel	s yu l . l e . g e l
wolcott	wo l . k o . t eu
gattuso	g a . t u . s o
missouri	m i . j u . l i
spranger	s yu . p eu . l a ng . g eo
lasso	l a . s o
gurwitsch	g eo . b i . ch i
jacobo	h a . k o . b o
ely	i l . l i
gironde	j i . l o ng . d eu
pessoa	p e . s o . a
lean	l i n
johnstone	j o n . s eu . t o n
mauboussin	m o . b eu . s a ng
hooke	h u g
markowitz	m a . k o . wi . ch eu
nurmi	n u . l eu . m i
meri	m e . l i
point	p o . i n . t eu
itzik	i . ch i . k eu
varro	b a . l o
basil	b ae . j eo l
berenson	b e . l eo n . s eu n
mikhail	m i . h a . i l
bilbao	b i l . b a . o
noyce	n o . i . s eu
lombardy	l o m . b a . l eu . d i . a
vasconcelos	b a . s eu . k o n . s e l . l o . s eu
fulbright	p u l . b eu . l a . i . t eu
simrock	j i m . l o . k eu
damascus	d a . m a . s eu . k u . s eu
armand	a . l eu . m a ng
david	d e . i . b i . d eu
delaware	d e l . l a . we . eo
avenarius	a . b e n . n a . l i . u . s eu
ramsey	l ae m . j i
dausset	d o . s e
storm	s yu . t o . l eu m
hulme	h yu m
baruch	b a . l u . k eu
nicolas	n i . k eo l . l eo . s eu
hein	h e . i n
blackwell	b eu l . l ae g . we l
verga	b e . l eu . g a
monrovia	m o n . l o . b i . a
haushofer	h a . u . s eu . h o . p eo
herriot	e . l i . o
binyon	b i . n i . eo n
vieira	b i . e . l a
claudius	k eu l . l a . u . d i . u . s eu
reg	l e . j i
wren	l e n
marne	m a . l eu n
salisbury	s o l . j eu . b e . l i
paolo	p a . o l . l o
emilio	e . m i l . l i . o
auden	o . d eu n
tangier	t ae n . j i . eo
candice	k ae n . d i . s eu
hering	h e . l i ng
jonas	yo . n a . s eu
ocampo	o . k a m . p o
phillippe	p i l . l i . p eu
henley	h e n . l i
gregorius	g eu . l e . g o . l i . u . s eu
jacques	j a . k eu
ljubljana	l yu . b eu l . l ya . n a
carlson	k a l . s eu n
cowper	k u . p eo
tavares	t a . b a . l e . s eu
verhaeren	b e . l eu . h a . l e n
balmer	b a l . m eo
dagerman	d a . g e . l eu . m a n
zhukov	j u . k o . p eu
mohawk	m o . h o . k eu
avvakum	a . b a . k u m
burgess	b eo . j i . s eu
martin	m a . l eu . t ae ng
providence	p eu . l o . b i . d eo n . s eu
camerarius	k a . m e . l a . l i . u . s eu
hobsbawm	h o b . s eu . b o m
bates	b e . i . ch eu
kathleen	k ae . s eo . l i n
mannheim	m a n . h a . i m
bergmann	b e . l eu . k eu . m a n
martine	m a . l eu . t i n
azad	a . j a . d eu
edison	e . d i . s eu n
dufy	d wi . p i
kolmogorov	k o l . m o . g o . l o . p eu
stravinsky	s eu . t eu . l a . b i n . s eu . k i
rameau	l a . m o
asmara	a . s eu . m a . l a
piaget	p i . a . j e
lea	l e . a
kamil	k a . m i l
werth	we l . s eu
monika	m o . n i . k a
whittier	h wi . t i . eo
tula	t u l . l a
seifert	s a . i . p e . l eu . t eu
johansson	yo . h a n . s o n
steinheil	s yu . t a . i n . h a . i l
chung	j eo ng
delano	d i l . l a . n o
maupertuis	m o . p e . l eu . t wi . i
biagio	b i . a . j i . o
herzl	h e . l eu . ch eu l
nehru	n e . l u
rabat	l a . b a . t eu
hagen	h a . g e n
molander	m o l . l a n . d eo
fries	p eu . l i . s eu
reel	l i l
oregon	o . l i . g eo n
tyson	t a . i . s eu n
massine	m a . s i n
chemnitz	k e m . n i . ch eu
card	k a . d eu
bruch	b eu . l u . h eu
budapest	b u . d a . p e . s eu . t eu
elijah	e l . l i . ya
delibes	d eu l . l i . b eu
bettina	b e . t i . n a
giacosa	j a . k o . s a
mccann	m ae g . k ae n
pym	p i m
schiele	s i l . l e
oxford	o g . s eu . p eo . d eu
ruben	l u . b e n
yahya	ya . h i . a
oran	o . l a ng
severo	s e . b e . l o
schwarz	s yu . wa l . ch eu
sandi	s ae n . d i
campigli	k a m . p i l . l i
humperdinck	h u m . p eo . d i ng . k eu
duarte	d u . a . l eu . t e
moldova	m o l . d o . b a
metastasio	m e . t a . s eu . t a . s i . o
gerd	g e . l eu . t eu
hayes	h e . i . s eu
wilkinson	wi l . k i n . s eu n
gleizes	g eu l . l e . i . j eu
morgenstern	m o . l eu . g e n . s yu . t e . l eu n
seyfert	s i . p eo . t eu
monge	m o ng . j u
greenland	g eu . l i n . l a n . d eu
angell	e . i n . j eo l
nimitz	n i . m i . ch eu
sami	s a . m i
clyde	k eu l . l a . i . d eu
kornfeld	k o n . p i l . d eu
sem	s e m
rodrigo	l o . d eu . l i . g o
tupolev	t u . p o l . l e . p eu
aubrey	o . b eu . l i
haren	h a . l e n
kirsch	k i . l eu . s wi
henning	h e . n i ng
cunningham	k eo . n i ng . eo m
bromfield	b eu . l o m . p i l . d eu
dunkirk	d wi ng . k e . l eu . k eu
moseley	m o . j eu l . l i
hazel	h e . i . j eu l
earle	eo l
colin	k o l . l ae ng
michelle	m i . s ye l
schwarzkopf	s yu . wo . ch eu . k o . p eu
mellon	m e l . l eo n
rambo	l a m . b o
stratford	s eu . t eu . l ae s . p o . d eu
hopkins	h o b . k i n . s eu
mariana	m a . l i . a . n a
gunther	g eo n . s eo
gasser	g ae . s eo
sue	s wi
kolbe	k o l . b e
nolan	n o l . l eo n
laval	l a . b a l
palikir	p a l . l a . k i . l eu
bataille	b a . t a . yu
beckett	b e . k e . t eu
valerie	b a l . l e . l i
cattell	k eo . t e l
giaever	g i . e . b eo
einstein	a . i n . s yu . t a . i n
tendryakov	t e n . d eu . l ya . k o . p eu
doha	d o . h a
shawn	s yo n
temin	t e . m i n
calderon	kk a l . d e . l o n
hugh	h yu
diallo	d i . ae l . l o
lev	ye . p eu
fano	p a . n o
presley	p eu . l e . s eu l . l i
gobineau	g o . b i . n o
garborg	g a . l eu . b o . l eu . g eu
cleve	k eu l . l e . b e
ortelius	o . l eu . t e l . l i . u . s eu
feuerbach	p o . i . eo . b a . h eu
maastricht	m a . s eu . t eu . l i . h i . t eu
johan	yo . h a n
solow	s o l . l o
reginald	l e . j eo . n eo l . d eu
tirana	t i . l a . n a
manuela	m a . n u . e l . l a
heckman	h e . k eu . m eo n
rangoon	l ae ng . g u n
pons	p o ng . s eu
dafoe	d e . p o
nieuwland	n yu . l ae n . d eu
kai	k a . i
clemens	k eu l . l e . m e n . s eu
caprivi	k a . p eu . l i . b i
beddoes	b e . d o . s eu
ireland	a . i l . l ae n . d eu
doreen	d o . l i n
verhoeven	b eo . h o . b e n
nebojsa	n e . b o . i . s a
sudermann	j u . d eo . m a n
gneisenau	g eu . n a . i . j e . n a . u
heckler	h e . k eu l . l eo
foreman	p o . m eo n
anatolia	a . n a . t o l . l i . a
wole	wo l . l e
noble	n o . b eu l
beattie	b i . t i
dilthey	d i l . t a . i
liz	l i . j eu
zambia	j a m . b i . a
olympia	o l . l i m . p i . a
gamba	g a m . b a
mussolini	m u s . s o l . l i . n i
meissner	m a . i . s eu . n eo
steers	s eu . t i . eo . s eu
roth	l o . t eu
beiqi	b e . i . ch i
philadelpia	p i l . l a . d e l . p i . a
polevoi	p o l . l e . b o . i
pretorius	p eu . l e . t o . l i . u . s eu
chateaubriand	s ya . t o . b eu . l i . a ng
pasternack	p a . s eu . t eo . n e g
agnelli	a . n ye l . l i
santer	s a ng . t e . l eu
gladys	g eu l . l a . i . d i . s eu
camille	k a . m i . yu
taya	t a . ya
chiara	k i . a . l a
dyer	d a . i . eo
kruger	k eu . l wi . g eo
espinoza	e . s eu . p i . n o . j a
gascoyne	g ae . s eu . k o . i n
garang	g a . l a ng
rio	l i . u
ludwik	l u . d eu . wi g
walter	b a l . t eo
borge	b o . l eu . g eu
estremadura	e . s eu . t eu . l e . m a . d u . l a
zunzunegui	s u n . s u . n e . g i
waksman	wa g . s eu . m eo n
brynner	b eu . l i . n eo
leonard	l e . n eo . d eu
tehran	d e . h e . l a n
davisson	d e . i . b i . s eu n
bowyer	b a . u . eo
klitzing	k eu l . l i . ch i ng
izquierdo	i . s eu . k i . e . l eu . d o
wand	b a n . t eu
vida	b i . d a
novikov	n o . b i . k o . p eu
laughlin	l o . p eu l . l i n
abbott	ae . b eo . t eu
reykjavik	l e . i . k ya . b i . k eu
montana	m o n . t ae . n a
guldberg	g u l . d eu . b e . l eu . g eu
puck	p eo g
sholes	s yo l . s eu
kaufmann	k a . u . p eu . m a n
scranton	s eu . k eu . l ae n . t eo n
eichmann	a . i . h i . m a n
brenan	b eu . l e . n eo n
mehdi	m e . d i
dorn	d o n
dartmouth	d a . t eu . m eo . s eu
zane	j e . i n
harwood	h a . u . d eu
brendel	b eu . l e n . d e l
dacca	d a . k a
rolf	l o l . p eu
scheidemann	s ya . i . d e . m a n
darmstadt	d a . l eu m . s yu . t a . t eu
tonga	t o ng . g a
kari	k a . l i
tomas	t o . m a . s eu
polanyi	p o l . l a . n i
mccoy	m ae g . k o . i
parini	p a . l i . n i
gisela	j i . j e l . l a
cavendish	k ae . b eo n . d i . s i
hibernia	h a . i . b eo . n i . a
castillo	k a . s eu . t i l . l o
oswald	o . s eu . b a l . t eu
funk	p u ng . k eu
russo	l u . s o
korngold	k o n . g o l . d eu
ahmad	a . m a . d eu
dahl	d a l
cavalcanti	k a . b a l . k a n . t i
willie	wi l . l i
gottlieb	g o . t eu l . l i . b eu
gabriele	g a . b eu . l i . e l . l e
quiroga	k i . l o . g a
gresham	g eu . l e . s yeo m
gabrielle	g a . b eu . l i . e l
morales	m o . l a l . l e . s eu
resnick	l u . s eu . n i g
turin	t u . l i n
cameroon	k a . m e . l u n
seaborg	s i . b o . g eu
glickman	g eu l . l i . k eu . m eo n
kulikov	k u l . l i . k o . p eu
northcliffe	n o . s eu . k eu l . l i . p eu
brunner	b eu . l u . n eo
johns	j o n . s eu
heymans	h a . i . m a n . s eu
macauley	m ae g . k o l . l i
sitwell	s i . t eu . we l
bose	b o . s eu
gatto	g a . t o
malthus	m ae l . s eo . s eu
golgi	g o l . j i
canberra	k ae n . b eo . l a
dieter	d i . t eu . l eu
gaskell	g ae . s eu . k e l
horacio	h o . l a . s i . o
cali	k a l . l i
chisinau	ch i . s i . n a . u
els	e l . s eu
carl	k a . l eu l
louise	l u . i . j eu
stockhausen	s yu . t o . k eu . h a . u . j e n
horst	h o . l eu . s eu . t eu
hawkins	h o . k i n . s eu
kramer	k eu . l e . i . m eo
bissau	b i . s a . u
grenier	g eu . l eu . n i . e
hankel	h a ng . k e l
sansovino	s a n . s o . b i . n o
marot	m a . l o
espinosa	e . s eu . p i . n o . j a
reeves	l i . b eu . s eu
kraft	k eu . l a . p eu . t eu
orel	o . l e l
agricola	a . g eu . l i . k o l . l a
massimo	m a . s i . m o
ellie	e l . l i
reyes	l e . i . eo . s eu
chuvash	ch u . b a . s yu
appel	a . p e l
schmitz	s yu . m i . ch eu
henri	a ng . l i
kayser	k a . i . j eo
durango	d u . l a ng . g o
mulliken	m eo l . l i . k eo n
rex	l e g . s eu
zeyer	jj eo . ye . eo l
gerald	j e . l eo l . d eu
hildebrand	h i l . d e . b eu . l a n . d eu
luna	l u . n a
freytag	p eu . l a . i . t a . k eu
verwey	p e . l eu . we . i
harte	h a . t eu
abigail	ae . b i . g ae . i l
chapman	ch ae . p eu . m eo n
beets	b e . ch eu
habre	a . b eu . l eu
galland	g a l . l a ng
nasmyth	n e . i . j eu . m i . s eu
steinbeck	s eu . t a . i n . b e g
ankrah	a n . k eu . l a
lasker	l ae . s eu . k eo
rostov	l o . s eu . t o . p eu
lelewel	l e l . l e . b e l
voigt	p o . k eu . t eu
lugo	l u . g o
eyre	e . eo
kearsley	k i . eo . s eu l . l i
tindemans	t i n . d e . m a n . s eu
campra	k a ng . p eu . l a
grekov	g eu . l e . k o . p eu
freda	p eu . l e . d a
ghiberti	g i . b e . l eu . t i
guetta	g we . t a
dodds	d o . j eu
spenser	s eu . p e n . s eo
fiona	p i . o . n a
palembang	p a l . l e m . b a ng
bernstein	b eo n . s eu . t a . i n
racine	l a . s i n
solomon	s o l . l o . m o n
naiman	n a . i . m a n
brunel	b eu . l u . n e l
canetti	k a . n e . t i
nick	n i g
alek	a l . l e g
brody	b eu . l o . d i
exeter	e g . s eo . t eo
polk	p o . k eu
tashkent	t a . s yu . k e n . t eu
perdue	p eo . d yu
farouk	p a . l u . k eu
sologub	s o l . l o . g u . p eu
livermore	l i . b eo . m o l
cynthia	s i n . s i . a
june	j yu n
bowles	b o l . s eu
alberts	ae l . b eo . ch eu
pauli	p a . u l . l i
eritrea	e . l i . t eu . l e . a
goethals	g o . s eo l . s eu
gobat	g o . b a
tucci	t u . ch i
swanson	s eu . wa n . s eu n
neilson	n i l . s eu n
hastings	h e . i . s eu . t i ng . s eu
satish	s a . t i . s wi
silber	s i l . b eo
tallahassee	t ae l . l eo . h ae . s i
aaron	a . l o n
ast	a . s eu . t eu
grosse	g eu . l o . s e
edward	e . d eu . wo . d eu
jackie	j ae . k i
brett	b eu . l e . t eu
buckley	b eo . k eu l . l i
olaf	o l . l a . p eu
piston	p i . s eu . t eo n
mora	m o . l a
haley	h a l . l i
damen	d e . i . m eo n
hus	h u . s eu
cournot	k u . l eu . n o
frechette	p eu . l e . s ye . t eu
renato	l e . n a . t o
longchamp	l o ng . s ya ng
alan	a l . l a n
zola	j o l . l a
leboeuf	l eu . b oe . p eu
belfort	b e l . p o
page	p e . i . j i
swaziland	s eu . wa . j i l . l a n . d eu
huntsville	h eo n . ch eu . b i l
shaheen	s yae . h i n
eindhoven	e . i n . t eu . h o . b e n
kirsten	k eo . s eu . t i n
mikoyan	m i . k o . ya n
berti	b e . l eu . d i
wien	b i n
thackeray	s ae . k eo . l i
schiller	s i l . l eo
herren	h e . l e n
bruin	b eu . l wi n
heinz	h a . i n . ch eu
granet	g eu . l a . n e
kigali	k i . g a l . l i
kohler	k o l . l eo
beth	b e . s eu
vesuvius	b e . s u . b i . o
whitworth	h wi . t eu . wo . s eu
downing	d a . u . n i ng
malebranche	m a l . b eu . l a ng . s yu
rosenberg	l o . j e n . b e . l eu . k eu
olander	o l . l ae n . d eo
shockley	s yo . k eu l . l i
rockingham	l a g . k i ng . h ae m
poe	p o
petric	p e . t eu . l i g
heidenstam	h e . i . d e n . s eu . t a m
connelly	k o . n eo l . l i
woolley	u l . l i
hain	h e . i n
sperling	s eu . p eo l . l i ng
clifford	k eu l . l i . p eo . d eu
veronese	b e . l o . n e . s e
kandahar	k a n . d a . h a . l eu
bullock	b u l . l eo g
felix	p e l . l i g . s eu
haarlem	h a . l eu l . l e m
mackay	m ae g . k e . i
alger	a l . j e
huntsman	h eo n . ch eu . m eo n
braga	b eu . l a . g a
darryl	d ae . l i l
haynes	h e . i n . j eu
karachi	k a . l a . ch i
babson	b ae b . s eu n
howells	h a . u . eo l . s eu
chapsal	s ya . p eu . s a l
ransom	l ae n . s eo m
tomsk	t o m . s eu . k eu
pavel	p a . b e l
heisenberg	h a . i . j e n . b e . l eu . k eu
johnston	j o n . s eu . t o n
jessica	j e . s i . k a
rowan	l o . eo n
portman	p o . t eu . m a n
ramsay	l ae m . j i
sandro	s a n . d eu . l o
bamberger	b ae m . b eo . g eo
bracton	b eu . l ae g . t eo n
beuys	b o . i . s eu
morel	m o . l e l
whistler	h wi . s eu l . l eo
tamm	t a m
lyttelton	l i . t eu l . t eo n
strang	s eu . t eu . l ae ng
mackinder	m ae . k i n . d eo
welsh	we l . s wi
franklin	p eu . l ae ng . k eu l . l i n
theo	t e . o
margaret	m a . g eo . l i s
blinder	b eu l . l a . i n . d eo
louisiana	l u . i . j i . ae . n a
cheshire	ch e . s yeo
livingstone	l i . b i ng . s eu . t eo n
duchamp	d wi . s ya ng
billy	b i l . l i
wrangel	b eu . l a ng . g e l
donatus	d o . n a . t u . s eu
marinetti	m a . l i . n e . t i
rasmussen	l a . s eu . m u . s e n
dallapiccola	d a l . l a . p i . k o l . l a
ballard	b a l . l a . d eu
raman	l a . m a n
camden	k ae m . d eo n
lavoisier	l a . b u . a . j i . e
loewe	l oe . b e
deakin	d i . k i n
russia	l eo . s i . a
peter	b e . d eu . l o
dongen	d o ng . g e n
iacocca	a . i . eo . k o . k a
botha	b o . t a
utrillo	yu . t eu . l i l . l o
andrea	a n . d eu . l e . a
bonnet	b o . n e
michael	m a . i . k eu l
idris	i . d eu . l i . s eu
gerber	g eo . b eo
langmuir	l ae ng . m yu . eo
withers	wi . d eo . s eu
rob	l o b
brock	b eu . l o g
bjerknes	b i . e . l eu . k eu . n e . s eu
jespersen	ye . s eu . p e . l eu . s e n
mun	m eo n
franks	p eu . l ae ng . k eu . s eu
ficino	p i . ch i . n o
luise	l u . i . j e
arias	a . l i . a . s eu
floyd	p eu l . l o . i . d eu
hanon	a . n o ng
ken	k e n
fryer	p eu . l a . i . eo
henle	h e n . l e
janine	j e . n i n
albano	a l . b a . n o
shannon	s yae . n eo n
bianco	b i . a n . k o
kania	k a . n i . a
morocco	m o . l o . k o
souter	s u . t eo
conakry	k o . n a . k eu . l i
hopper	h o . p eo
armando	a . l eu . m a n . d o
pourcel	p u . l eu . s e l
lobo	l o . b o
ullman	u l . m a n
nat	n ae s
meisheng	m e . i . s eo ng
osborn	o . j eu . b eo n
chicago	s i . k a . g o
neutra	n o . i . t eu . l a
bible	b a . i . b eu l
eugen	o . i . g e n
kronecker	k eu . l o . n e . k eo
tegucigalpa	t e . g u . s i . g a l . p a
gore	g o . eo
velayati	b e l . l a . ya . t i
hope	h o . p eu
elena	e l . l e . n a
aphra	ae . p eu . l a
read	l i . d eu
hort	h o l . t eu
bernal	b eo . n eo l
caetano	kk a . e . tt a . n u
galileo	g a l . l i l . l e . o
raabe	l a . b e
kesey	k i . j i
pace	p e . i . s eu
rydberg	l wi . d eu . b e . l i
viktor	b i g . t o . l eu
kone	k o . n e
wilke	wi l . k eu
osbert	o . s eu . b eo . t eu
cassell	k a . s e l
kentucky	k e n . t eo . k i
mosley	m o . j eu l . l i
dern	d eo n
cornwall	k o n . wo l
boethius	b o . i . t i . u . s eu
benjamin	b ae ng . j a . m ae ng
pufendorf	p u . p e n . d o . l eu . p eu
scorsese	s eu . k o l . s e . i . j i
toma	t o . m a
roos	l u . s eu
flanders	p eu l . l ae n . d eo . s eu
frankenstein	p eu . l a ng . k e n . s yu . t a . i n
spada	s eu . p a . d a
potsdam	p o . s eu . d a m
moura	m o . l a
brittan	b eu . l i . t eu n
schweizer	s yu . b a . i . ch eo
wernicke	b e . l eu . n i . k e
gay	g e . i
frankfurt	p eu . l a ng . k eu . p u . l eu . t eu
cushing	k u . s i ng
altissimo	a l . t i . s i . m o
maldives	m o l . d i . b eu
ammon	a . m o n
margot	m a . l eu . g o . t eu
carpini	k a . l eu . p i . n i
berlin	b e . l eu l . l i n
gaborone	g a . b o . l o . n e
malcolm	m ae l . k eo m
montreuil	m o ng . t eu . l eu . yu
nebraska	n e . b eu . l ae . s eu . k a
rouse	l o . j eu
perenlei	p e . l e n . l e . i
tamir	t a . m i . l eu
ellis	e l . l i . s eu
jellinek	ye l . l i . n e . k eu
islamabad	i . s eu l . l a . m a . b a . d eu
murray	m a . l e
tijuana	t i . h u . a . n a
reilly	l a . i l . l i
dawkins	d o . k i n . s eu
richard	l i . ch a . d eu
daisy	d a . i . s i
needham	n i . d eo m
sardou	s a . l eu . d u
gozzoli	g o . ch o l . l i
beatrice	b e . a . t eu . l i . ch e
poussin	p u . s ae ng
mann	m a n
petrograd	p e . t eu . l o . g eu . l a . d eu
canaro	k a . n a . l o
athos	e . i . s o . s eu
bias	b i . a . s eu
lenormand	l eu . n o . l eu . m a ng
rossetti	l o . s e . t i
wolfgang	b o l . p eu . g a ng
marlin	m a l . l i n
sudan	s u . d a n
baxter	b ae g . s eu . t eo
valero	b a l . l e . l o
aurelio	a . u . l e l . l i . o
victoria	b i g . t o . l i . a
schinkel	s i ng . k e l
artsybashev	a . l eu . ch i . b a . s ye . p eu
ostade	o . s eu . t a . d e
lesotho	l e . s o . t o
vera	b e . l a
wight	wa . i . t eu
erdmann	e . l eu . d eu . m a n
manfred	m a n . p eu . l e . t eu
balch	b o l . ch i
metternich	m e . t e . l eu . n i . h i
lillian	l i l . l i . eo n
leszek	l e . s ye . k eu
fletcher	p eu l . l ae . ch eo
bernardino	b e . l eu . n a . l eu . d i . n o
pershing	p eo . s i ng
memphis	m e m . p i . s eu
dietrich	d i . t eu . l i . s i
valente	b a l . l e n . t e
vila	b i l . l a
glover	g eu l . l o . b eo
matias	m a . t i . a . s eu
winters	wi n . t eo . s eu
proudhon	p eu . l u . d o ng
halifax	h ae l . l i . p ae g . s eu
kira	k i . l a
hubertus	h u . b e . l eu . t u . s eu
chester	ch e . s eu . t eo
alan	ae l . l eo n
dixie	d i g . s i
manrique	m a n . l i . k e
arjun	a . j u n
vancouver	b ae n . k u . b eo
kirpichnikov	k i . l eu . p i . ch i . n i . k o . p eu
regan	l i . g eo n
blanche	b eu l . l a ng . s wi
bangemann	b a ng . g e . m a n
diego	d i . e . g o
goncourt	g o ng . k u . l eu
marchais	m a . l eu . s ye
romer	l o . m eo
engel	e ng . g e l
turco	t u . l eu . k o
wentworth	we n . t eu . wo . s eu
nanny	n ae . n i
burr	b eo
offenbach	o . p e n . b a . h eu
garrett	g a . l e . t eu
burckhardt	b u . l eu . k eu . h a . l eu . t eu
ruud	l wi . t eu
truman	t eu . l u . m eo n
marsha	m a . s ya
libya	l i . b i . a
rosalie	l o . j a l . l i
rogge	l o . g e
adolfo	a . d o l . p o
casella	k a . s e l . l a
stone	s eu . t o n
danny	d ae . n i
ronan	l o . n a n
painter	p e . i n . t eo
jue	j we
nicolai	n i . k o l . l a . i
errol	e . l eo l
frankfort	p eu . l ae ng . k eu . p eo . t eu
voisin	b eu . wa . j ae ng
renard	l eu . n a . l eu
henry	a ng . l i
naess	n e . s eu
forsyth	p o . s a . i . s eu
inger	i ng . g eo
gauss	g a . u . s eu
krueger	k eu . l u . g eo
compton	k o m . p eu . t eo n
ossola	o . s o l . l a
reddy	l e . d i
beck	b e g
gentz	g e n . ch eu
chang	j a ng
byrd	b eo . d eu
uribe	u . l i . b e
albers	a l . b e . l eu . s eu
antoni	a n . t o . n i
nilsson	n i l . s o n
cane	k e . i n
jennings	j e . n i ng . s eu
bonsels	b o n . j e l . s eu
primakov	p eu . l i . m a . k o . p eu
khalil	k a l . l i l
brito	b eu . l i . t o
odets	o . d e . ch eu
durham	d eo . l eo m
lujo	l u . j o
hendrikx	h e n . d eu . l i g . s eu
vaucanson	b o . k a ng . s o ng
lina	l i . n a
erickson	e . l i g . s eu n
stafford	s eu . t ae . p o . d eu
mack	m ae g
gooch	g u . ch i
len	l e n
indira	i n . d i . l a
behring	b e . l i ng
bausch	b a . u . s yu
dube	d u . b e
ricketts	l i . k e . ch eu
schultz	s yu l . ch eu
faye	p e . i
glass	g eu l . l a . s eu
ernest	eo . n i . s eu . t eu
milos	m i l . l o . s eu
hasenclever	h a . j e n . k eu l . l e . b eo
almond	a l . m o n . d eu
felder	p e l . d eo
luiz	l u . i . j eu
cole	k o l
jorge	j o . l eu . j e
schweitzer	s yu . b a . i . ch eo
erin	e . l i n
rivera	l i . b e . l a
tommy	t o . m i
sylvain	s i l . b ae ng
appert	a . p e . l eu
abruzzi	a . b eu . l u . ch i
barranquilla	b a . l a ng . k i . ya
hayat	h a . ya s
tarawa	t a . l a . wa
celso	s e . l eu . s o
eichendorff	a . i . h e n . d o . l eu . p eu
ruggiero	l u . j i . e . l o
shaginyan	s ya . g i . n ya n
niklas	n i . k eu l . l a . s eu
silvestre	s i l . b e . s eu . t eu . l eu
pfeffer	p e . p eo
seneca	s e . n e . k a
farjeon	p a . j eo n
jodelle	j o . d e l
hilary	h i l . l eo . l i
adel	a . d e l
ulrike	u l . l i . k eu
cellini	ch e l . l i . n i
gallagher	g ae l . l eo . g eo
weddell	we . d eu l
eder	e . d eo
wycliffe	wi . k eu l . l i . p eu
grotius	g eu . l o . t i . u . s eu
gaultier	g o . t i . e
nigeria	n a . i . j i . l i . a
laptev	l a b . t e . p eu
gesner	g e . s eu . n eo
dulbecco	d u l . b e . k o
nesmeyanov	n e . s eu . m e . ya . n o . p eu
ringer	l i ng . g eo
lexington	l e g . s i ng . t eo n
bahr	b a . l eu
dolores	d o l . l o . l e . s eu
eck	e . k eu
small	s eu . m o l
slovenia	s eu l . l o . b e . n i . a
freddie	p eu . l e . d i
vives	b i . b e . s eu
sale	s a . l eu
niels	n i l . s eu
gleim	g eu l . l a . i m
leroy	l i . l o . i
rocha	l o . k a
rushdie	l u . s yu . d i
gambetta	g a ng . b e . t a
elam	e l . l a m
morgagni	m o . l eu . g a . n i
gillespie	g i l . l e . s eu . p i
berwick	b e . l i g
diocletianus	d i . o . k eu l . l e . t i . a . n u . s eu
singh	s i ng
hilty	h i l . t i
cabot	k ae . b eo s
doria	d o . l i . a
stipe	s eu . t i . p e
hamza	h a m . j a
eliade	e l . l i . a . d e
acheson	ae . ch i . s eu n
junkers	yu ng . k eo . s eu
lyle	l a . i l
hartline	h a . t eu l . l a . i n
salazar	s a l . l a . j a . l eu
sauvy	s o . b i
grimm	g eu . l i m
willcocks	wi l . k o g . s eu
langley	l ae ng . g eu l . l i
melinda	m e l . l i n . d a
julian	yu l . l i . a . n u . s eu
blum	b eu l . l eo m
fitzpatrick	p i . ch eu . p ae . t eu . l i g
doisy	d o . i . j i
heckscher	h e . k eu . s ye . l eu
tamayo	t a . m a . yo
solovyov	s o l . l o . b i . yo . p eu
howard	h a . wo . d eu
jackson	j ae g . s eu n
maier	m a . i . e . l eu
diller	d i l . l eo
tiselius	t i . s e l . l i . u . s eu
imhoff	i m . h o . p eu
duluth	d eo l . l u . s eu
dyson	d a . i . s eu n
milles	m i l . l e . s eu
rambert	l ae m . b eo . t eu
renoir	l eu . n u . a . l eu
chianti	k a n . t i
piazzi	p i . a . ch i
wittfogel	b i . t eu . p o . g e l
poliziano	p o l . l i . ch i . a . n o
lyman	l a . i . m eo n
carnarvon	k a . n a . b o n
neal	n i l
adler	a . d eu l . l eo
hristov	h eu . l i . s eu . t o . p eu
prager	p eu . l a . g eo
lini	l i . n i
kern	k eo n
pekka	p e . k a
adamov	a . d a . m o . p eu
dubinin	d u . b i . n i n
caro	k a . l o
easton	i . s eu . t eo n
newbolt	n yu . b o l . t eu
davidoff	d ae . b i . d o . p eu
swart	s eu . wa . l eu . t eu
brockman	b eu . l o . k eu . m a n
ji	j i
keane	k i n
nunn	n eo n
andrews	ae n . d eu . l u . s eu
jam	j ae m
padgett	p ae . j e s
eddie	e . d i
oparin	o . p a . l i n
summers	s eo . m eo . s eu
mackenzie	m ae . k e n . j i
edith	e . d i . s eu
leicester	l e . s eu . t eo
wilhelm	b i l . h e l . l eu m
valeri	b a l . l e . l i
mounier	m u . n i . e
auerbach	a . u . eo . b a . h eu
canaletto	k a . n a l . l e . t o
nureyev	n u . l e . ye . p eu
banville	b a ng . b i l
zhaozhen	j a . o . j eo n
pfleiderer	p eu l . l a . i . t e . l eo
hogg	h o . g eu
quant	k wo n . t eu
stephen	s eu . t i . b eu n
balenciaga	b a l . l e n . s i . a . g a
constance	k o n . s eu . t a n . s eu
borgia	b o . l eu . j a
nicola	n i . k o l . l a
vivien	b i . b i . eo n
witz	b i . ch eu
wali	wa . l i
karajan	k a . l a . ya n
tylor	t a . i l . l eo
georg	g e . o . l eu . g eu
moberg	m o . b e . l i
ambler	ae m . b eu l . l eo
ewald	e . b a l
pattani	p a . t a . n i
akron	ae . k eu . l eo n
higgins	h i . g i n . s eu
malkin	m a l . k i n
mancini	m ae n . s i . n i
howell	h a . we l
trudeau	t eu . l wi . d o
muir	m yu . eo
lambert	l a m . b e . l eu . t eu
appalachia	a . p a . l a . ch i . a
renzo	l e n . j o
theresa	t e . l e . s a
henne	h e . n i
falconet	p a l . k o . n e
lytton	l i . t eo n
sardinia	s a . l eu . d i . n i . a
veresaev	b e . l e . s a . ye . p eu
wolsey	u l . j i
gaul	g o l
negroponte	n e . g eu . l o . p o n . t e
schott	s yo . t eu
honda	h o n . d a
laurence	l o . l e n . s eu
debs	d e . b eu . s eu
limburg	l i m . b u . l eu . h eu
agnes	a . g eu . n e . s eu
leonard	l e . o . n a . d eu
ralston	l ae l . s eu . t eo n
virginia	b eo . j i . n i . a
dufour	d u . p o . b o ng
marcia	m a . l eu . s ya
cottbus	k o s . b u . s eu
ludwig	l u . t eu . b i . h i
elmer	e l . m eo
windhoek	b i n . t eu . h u . k eu
ohana	o . h a . n a
jenner	j e . n eo
dirac	d i . l ae g
nassau	n a . s a . u
cohn	k o n
renan	l eu . n a ng
augustin	o . g u . s eu . t i n
waldheim	b a l . t eu . h a . i m
trieste	t eu . l i . e . s eu . t e
hulbert	h eo l . b eo . t eu
temple	t e m . p eu l
gonzalez	g o n . s a l . l e . s eu
angel	e n . j e l
jagan	j e . i . g eo n
kimberley	k i m . b eo l . l i
cuomo	k u . o . m o
comte	k o ng . t eu
honduras	h o n . d u . l a . s eu
hoover	h u . b eo
nekrasov	n e . k eu . l a . s o . p eu
lise	l i . j e
giulio	j u l . l i . o
annette	a . n e . t eu
byelorussia	b e l . l o . l u . s i
ibadan	i . b a . d a n
randolph	l ae n . d o l . p eu
recorde	l e . k o . d eu
soutine	s u . t i n
dolph	d o l . p eu
monod	m o . n o
jaime	h a . i . m e
singer	s i ng . eo
gouled	g u l . l e . d eu
freiberg	p eu . l a . i . b eo . g eu
mander	m a n . d e . l eu
torino	t o . l i . n o
melbourne	m e l . b eo . l eu n
whipple	h wi . p eu l
tatum	t e . i . t eo m
feininger	p a . i . n i ng . eo
carrillo	k a . l i l . l o
bailey	b e . i l . l i
jaruzelski	ya . l u . j e l . s eu . k i
carlton	k a l . t eu n
webern	b e . b e . l eu n
reiner	l a . i . n eo
brandes	b eu . l a . d e . s eu
lange	l a ng . e
benny	b e . n i
fragonard	p eu . l a . g o . n a . l eu
kristin	k eu . l i . s eu . t i n
anthony	a n . t o . n i . o
elton	e l . t eu n
mali	m a l . l i
machiavelli	m a . k i . a . b e l . l i
hamlin	h ae m . l i n
severini	s e . b e . l i . n i
boulanger	b u l . l a ng . j e
roseau	l o . j o
antonius	a n . t o . n i . u . s eu
cheney	ch e . n i
rhine	l a . i n
honiara	h o . n i . a . l a
barry	b ae . l i
panofsky	p a . n o . p eu . s eu . k i
scholz	s yo l . ch eu
kraepelin	k eu . l e . p e l . l i n
amelia	a . m e l . l i . a
rugby	l eo g . b i
binoche	b i . n o . s yu
raymond	l e . m o ng
fazal	p a . j a l
katharine	k ae . s eo . l i n
orson	o . s eo n
fouquet	p u . k e
lancaster	l ae ng . k eo . s eu . t eo
fet	p e . t eu
giraudoux	j i . l o . d u
cech	ch e . k eu
achilles	a . k i l . l e . s eu
condo	k o n . d o
mahmoud	m a . m u . d eu
lang	l a ng
beecham	b i . ch eo m
overbeck	o . b eo . b e . k eu
ortiz	o . l eu . t i . s eu
valadon	b a l . l a . d o ng
juliana	j u l . l i . a . n a
peacock	p i . k o g
macmillan	m ae g . m i l . l a n
bahar	b a . h a . l eu
ionesco	i . o . n e . s eu . k o
queneau	k eu . n o
moody	m u . d i
gaitskell	g e . i . ch eu . k e l
schiff	s wi . p eu
rollo	l o l . l o
calder	k o l . d eo
bedford	b e . d eu . p eo . d eu
galtung	g a l . t u ng
levine	l eo . b a . i n
ochirbat	o . ch i . l eu . b a . t eu
benn	b e n
lemarchand	l eu . m a g . s yeo ng
gladstone	g eu l . l ae . d eu . s eu . t eo n
hubble	h eo . b eu l
grigorovich	g eu . l i . g o . l o . b i . ch i
ponce	p o n . s eu
fox	p o g . s eu
benedict	b e . n e . d i g . t eu
toledo	t eo l . l i . d o
riga	l i . g a
paige	p e . i . j i
hassanal	h a . s a . n a l
pampas	p a m . p a . s eu
matt	m ae s
hubbard	h eo . b eo . d eu
kuhn	k u n
finch	p i n . ch i
prishvin	p eu . l i . s yu . b i n
kondo	k o n . d o
funafuti	p u . n a . p u . t i
wetzel	we . j e l
deville	d eu . b i l
ava	e . b a
gigli	j i l . l i
languedoc	l a ng . g eu . d o . k eu
hodgkin	h o . j i . k i n
afghanistan	a . p eu . g a . n i . s eu . t a n
geoff	j e . p eu
reinhard	l a . i n . h a . l eu . t eu
hermann	h e . l eu . m a n
suk	s u . k eu
hubert	wi . b e . l eu
fairbanks	p e . eo . b ae ng . k eu . s eu
meier	m a . i . eo
bangkok	b a ng . k o g
arrhenius	a . l e . n i . u . s eu
robles	l o . b eu l . l e . s eu
dominique	d o . m i . n i . k eu
sibelius	s i . b e l . l i . u . s eu
drew	d eu . l yu
mill	m i l
churchill	ch eo . ch i l
schelling	s ye l . l i ng
botticelli	b o . t i . ch e l . l i
athanasius	a . t a . n a . s i . u . s eu
pinero	p i . n e . l o
packer	p ae . k eo
vernet	b e . l eu . n e
managua	m a . n a . g wa
gupta	g u b . t a
robson	l o b . s eu n
huff	h eo . p eu
martina	m a . l eu . t i . n a
dimitri	d i . m i . t eu . l i
canth	k a n . t eu
dunham	d eo n . h ae m
melvil	m e l . b i l
philips	p i l . l i b . s eu
schacht	s ya . h eu . t eu
springer	s eu . p eu . l i ng . g eo
dehmel	d e . m e l
arnaud	a . l eu . n o
fonseca	p o n . s e . k a
kempff	k e m . p eu
trina	t eu . l i . n a
berkeley	b a . k eu l . l i
pottinger	p o . t i n . j eo
schaap	s eu . k a b
cummins	k eo . m i n . s eu
peters	p i . t eo . s eu
mazowiecki	m a . j o . b i . e . ch eu . k i
vance	b eo n . s eu
boye	b o . wi . e
stolypin	s eu . t o l . l i . p i n
merriman	m e . l i . m eo n
yamoussoukro	ya . m u . s u . k eu . l o
pride	p eu . l a . i . d eu
nigel	n a . i . j eo l
albin	a l . b i n
dior	d i . o . l eu
loy	l o . i
joseph	yo . s e b
drury	d eu . l u . eo . l i
oldenburg	o l . d e n . b u . l eu . k eu
sol	s o l
quincy	k wi n . s i
angle	ae ng . g eu l
alejandro	a l . l e . h a n . d eu . l o
mason	m e . i . s o n
josephson	j o . j i . p eu . s eu n
cope	k o . p eu
delgado	d e l . g a . d o
melissa	m e l . l i . s a
patricio	p a . t eu . l i . s i . o
samar	s a . m a . l eu
imam	i . m a m
sacramento	s ae . k eu . l a . m e n . t o
enrico	e n . l i . k o
antunes	a n . t u . n e . s eu
sully	s wi l . l i
gerda	g e . l eu . d a
paderewski	p a . d e . l e . p eu . s eu . k i
amy	e . i . m i
itzhak	i . j a g
aurelia	o . l e l . l i . a
frunze	p eu . l u n . j e
copland	k o . p eu l . l ae n . d eu
shelley	s ye l . l i
blunt	b eu l . l eo n . t eu
bosworth	b o . j eu . wo . s eu
pakistan	p a . k i . s eu . t a n
biya	b i . ya
stewart	s eu . t yu . eo . t eu
euler	o . i l . l eo
maloney	m eo l . l o . n i
amir	a . m i . l eu
golding	g o l . d i ng
liza	l i . j a
reuben	l eu . u . b e n
krasnoyarsk	k eu . l a . s eu . n o . ya . l eu . s eu . k eu
violet	b a . i . o l . l e s
concha	k o n . ch a
potanin	p o . t a . n i n
ribeiro	l i . b e . i . l u
sutherland	s eo . d eo l . l ae n . d eu
edmond	e . d eu . m o ng
sheridan	s ye . l i . d eo n
voss	p o . s eu
horkheimer	h o . l eu . k eu . h a . i . m eo
rogers	l o . j eo . s eu
boucher	b a . u . ch eo
bevan	b e . b eo n
cartan	k a . l eu . t a ng
ryan	l a . i . eo n
apelt	a . p e l . t eu
philip	b i l . l i b
kogan	k o . g a n
neander	n e . a n . d eo
monica	m o . n i . k a
pacher	p a . h eo
alexis	a l . l e g . s i
carmen	k a . l eu . m e n
koller	k o l . l eo
fiji	p i . j i
andropov	a n . d eu . l o . p o . p eu
hansard	h ae n . s eo . d eu
barney	b a . n i
maher	m a . h e . l eu
benitez	b e . n i . t e . j eu
arnim	a . l eu . n i m
dorset	d o . s e . t eu
backhaus	b a . k eu . h a . u . s eu
jean	j a n
husseini	h u . s e . i . n i
bessemer	b e . s e . m eo
scofield	s eu . k o . p i l . d eu
nauru	n a . u . l u
madsen	m ae . d eu . s eu n
grenfell	g eu . l e n . p e l
marini	m a . l i . n i
farmington	p a . m i ng . t eo n
lebanon	l e . b a . n o n
toni	t a . n i
houston	h yu . s eu . t eo n
wieman	wi . m eo n
boothroyd	b u . s eu . l o . i . d eu
carlisle	k a l . l a . i l
marconi	m a . l eu . k o . n i
wise	wa . i . j eu
joaquim	h o . a . k i m
tina	t i . n a
sayce	s e . i . s eu
maurizio	m a . u . l i . ch i . o
abreu	eo . b eu . l e . u
riefenstahl	l i . p e n . s yu . t a l
asturias	a . s eu . t u . l i . a . s eu
sloan	s eu . l o n
balzac	b a l . j a . k eu
urbano	eo l . b a . n o
humboldt	h u m . b o l . t eu
brzezinski	b eu . l e . j i n . s eu . k i
wolfrum	wo l . p eu . l eo m
northumberland	n o . s eo m . b eo l . l ae n . d eu
epirus	e . p i . l u . s eu
husak	h u . s a g
joanna	j o . a n . n a
fred	p eu . l e . d eu
goodyear	g u s . i . eo
gabriela	g a . b eu . l i . e l . l a
dvorak	d eu . b o . l eu . j a g
jack	j ae g
valdes	b a l . d e . s eu
hamlet	h ae m . l i s
onegin	o . n e . g i n
beaumarchais	b o . m a . l eu . s ye
lenin	l e . n i n
gustavo	g u . s eu . t a . b o
marjorie	m a . j eo . l i
doolittle	d u l . l i . t eu l
cesalpino	ch e . s a l . p i . n o
fallopius	p a l . l o . p i . u . s eu
moustapha	m u . s eu . t a . p a
butterworth	b eo . t eo . wo . s eu
doppler	d o . p eu l . l eo
tutu	t u . t u
percy	p eo . s i
korneichuk	k o . l eu . n e . i . ch u . k eu
gropius	g eu . l o . p i . u . s eu
palmerston	p a l . m eo . s eu . t o n
scheler	s ye l . l eo
luanda	l u . a n . d a
schmidt	s yu . m i . t eu
lilian	l i l . l i . a ng
chaplin	ch ae . p eu l . l i n
dallas	d ae l . l eo . s eu
welles	we l . s eu
angelica	a n . j e l . l i . k a
richardson	l i . ch eo . d eu . s eu n
warhol	wo . h o l
planck	p eu l . l a ng . k eu
katharina	k a . t a . l i . n a
guido	g u . i . d o
angela	a n . j e l . l a
salt	s o l . t eu
milan	m i l . l a . n o
kilby	k i l . b i
brodsky	b eu . l o . d eu . s eu . k i
carmona	k a . m o . n a
thomas	d o . m a
stresemann	s yu . t eu . l e . j e . m a n
audrey	o . d eu . l i
chaumont	s yo . m o ng
greuze	g eu . l oe . j eu
hagerstown	h e . g eo . s eu . t a . u n
oslo	o . s eu l . l o
herbert	h eo . b eo . t eu
nelly	n e l . l i
kadun	k a . d u n
dard	d a . d eu
singleton	s i ng . g eu l . t o n
corsica	k o . l eu . s i . k a
michels	m i . h e l . s eu
vasco	b a . s eu . k o
gentile	j e n . t i l . l e
karakhan	k a . l a . h a n
sanger	s ae ng . eo
reis	l a . i . s eu
edmund	e . d eu . m u n . d eu
corradi	k o . l a . d i
andrzejewski	a n . j e . ye . p eu . s eu . k i
cruz	k eu . l u . s eu
glaspell	g eu l . l ae . s eu . p e l
sonia	s o . n ya
shelby	s ye l . b i
charles	s ya . l eu l
lipatti	l i . p a . t i
wilt	wi l . t eu
goddard	g o . d eo . d eu
munch	m u ng . k eu
khorana	k o . l a . n a
alam	a l . eo m
giono	j i . o . n o
schleiermacher	s yu l . l a . i . eo . m a . h eo
collins	k o l . l i n . s eu
melton	m e l . t o n
carla	k a l . l a
ide	i . d eu
geulincx	g oe l . l i ng . k eu . s eu
edgar	e . d eu . g a
daladier	d a l . l a . d i . e
namur	n a . m u . l eu
brahm	b eu . l a m
desai	d e . s a . i
carlyle	k a l . l a . i l
knut	k eu . n u . t eu
wilde	wa . i l . d eu
reade	l i . d eu
wald	wo l . d eu
isabelle	i . j a . b e l
gierek	g i . e . l e . k eu
penck	p e ng . k eu
khamenei	h a . m e . n e . i
mathieu	m a . t i . oe
ryder	l a . i . d eo
pratt	p eu . l ae s
vespucci	b e . s eu . p u . ch i
edwin	e . d eu . wi n
nero	n e . l o
branca	b eu . l a n . k a
joyner	j o . i . n eo
karel	k a . l e l
lasky	l ae . s eu . k i
runge	l u ng . g e
morelli	m o . l e l . l i
engels	e ng . g e l . s eu
benares	b e . n a . l e . s eu
isherwood	i . s yeo . u . d eu
aptidon	a b . t i . d o n
lasswell	l a . s eu . we l
alekseev	a l . l e g . s e . ye . p eu
eisenstein	a . i . j e n . s yu . t a . i n
guyana	g a . i . a . n a
florence	p eu l . l o . l e n . s eu
christ	g u . s e . j u
donovan	d o . n o . b eo n
riyadh	l i . ya . d eu
weizman	b a . i . ch eu . m a n
modena	m o . d e . n a
kane	k e . i n
flavio	p eu l . l a . b i . o
altman	o l . t eu . m eo n
melanchthon	m e l . l a n . h i . t o n
kendall	k e n . d eu l
masaccio	m a . s a . ch o
coronado	k o . l o . n a . d o
marsden	m a . s eu . d eu n
drozdova	d eu . l o . j eu . d o . b a
foster	p o . s eu . t eo
brent	b eu . l e n . t eu
bosch	b o . s yu
beda	b e . d a
suzanne	s u . j a n
bulgakov	b u l . g a . k o . p eu
saunders	s eo n . d eo . s eu
durante	d yu . l a n . t e
bongo	b o ng . g o
bowdler	b o . d eu l . l eo
houdon	u . d o ng
stephan	s yu . t e . p a n
donen	d o . n eo n
doran	d o . l eo n
henk	h e ng . k eu
hargreaves	h a . g eu . l i . b eu . s eu
wordsworth	wo . j eu . wo . s eu
beardsley	b i . eo . j eu l . l i
martha	m a . s ya
balboa	b a l . b o . a
krishna	k eu . l i . s yu . n a
loschmidt	l o . s yu . m i . t eu
goa	g o . a
dina	d i . n a
curt	k u . l eu . t eu
karsavina	k a . l eu . s a . b i . n a
cugnot	k wi . n yo
alford	a l . p o . d eu
bing	b i ng
grillparzer	g eu . l i l . p a . l eu . ch eo
groth	g eu . l o . t eu
byers	b a . i . eo . s eu
bryan	b eu . l a . i . eo n
mahan	m eo . h ae n
bek	b e g
apollo	a . p o l . l o
hutton	h eo . t eo n
lynch	l i n . ch i
venn	b e n
manning	m ae . n i ng
friedrich	p eu . l i . d eu . l i . h i
antwerp	ae n . t eu . wo . p eu
tura	t u . l a
gregory	g eu . l e . g o . l i
hannibal	h a n . n i . b a l
berlage	b e . l eu l . l a . h e
bales	b e . i l . j eu
ferris	p e . l i . s eu
varela	b a . l e . l a
abel	a . b e l
janez	ya . n e . j eu
anchorage	ae ng . k eo . l i . j i
connolly	k o . n eo l . l i
clark	k eu l . l a . k eu
fini	p i . n i
gomes	g o . m e . s eu
johnstown	j o n . s eu . t a . u n
lawrence	l o . l e n . s eu
peru	p e . l u
richmond	l i . ch i . m eo n . d eu
feldstein	p e l . d eu . s eu . t a . i n
manhattan	m ae n . h ae . t eu n
dennis	d e . n i . s eu
ernst	e . l eu n . s eu . t eu
pigalle	p i . g a l
iskandar	i . s eu . k a n . d a l
lamartine	l a . m a . l eu . t i n
christopher	k eu . l i . s eu . t o . p eo
baer	b e . eo
bondi	b o n . d i
macedonia	m a . k e . d o . n i . a
reiter	l a . i . t eo
iberia	i . b e . l i . a
gennaro	j e n . n a . l o
torsten	t o l . s eu . t eo n
henriquez	e n . l i . k e . s eu
griffith	g eu . l i . p i . s eu
tormod	t o . m o . d eu
voronin	b o . l o . n i n
charlottetown	s ya l . l eo s . t a . u n
stephanopoulos	s eu . t e . p a . n o . p u l . l o . s eu
mayer	m a . i . eo
shea	s ye . i
sander	s ae n . d eo
hensen	h e n . j e n
vinci	b i n . ch i
annemarie	a . n e . m a . l i
klimt	k eu l . l i m . t eu
foerster	p oe . l eu . s eu . t eo
finney	p i . n i
pajou	p a . j u
norah	n o . l a
botsford	b o . ch eu . p o . d eu
georgetown	j o . j i . t a . u n
schulze	s yu l . ch e
nana	n a . n a
annie	ae . n i
tammy	t ae . m i
ramo	l a . m o
sommaruga	s o . m a . l u . g a
posada	p o . s a . d a
hamburg	h a m . b u . l eu . k eu
maurus	m o . l wi . s eu
brisbane	b eu . l i . j eu . b eo n
jacobus	ya . k o . b wi . s eu
faulkner	p o . k eu . n eo
gibbon	g i . b eo n
tempest	t e m . p e . s eu . t eu
teitelbaum	t a . i . t e l . b a . u m
lanvin	l a ng . b a ng
anibal	a . n i . b a l
cohen	k o . eo n
spyri	s yu . p i . l i
mick	m i g
beckmann	b e . k eu . m a n
laurent	l o . l a ng
hart	h a . t eu
billings	b i l . l i ng . s eu
stig	s eu . t i . g e
anderton	a n . d eo . t o n
torrence	t o . l eo n . s eu
wittgenstein	b i . t eu . g e n . s yu . t a . i n
rudolf	l u . d o l . p eu
martins	m a . t i n
birch	b eo . ch i
josie	j o . s wi
perkins	p eo . k i n . s eu
holliday	h o l . l i . d e . i
arminius	a . l eu . m i . n i . u . s eu
weller	we l . l eo
pimentel	p i . m e n . t e l
corneille	k o . l eu . n e . yu
cukor	k u . k eo
servetus	s e . l eu . b e . t u . s eu
kemble	k e m . b eu l
hassan	h a . s a n
hungary	h eo ng . g a . l i
malone	m a l . l o n
banjul	b a n . j u l
hammerstein	h ae . m eo . s eu . t a . i n
bosco	b o . s eu . k o
frida	p eu . l i . d a
sal	s a l
puente	p u . e n . t e
henrik	h e n . l i . k eu
balas	b a l . l a . s eu
crivelli	k eu . l i . b e l . l i
claudia	k eu l . l a . u . d i . a
calhoun	k a l . h u n
alaska	a l . l ae . s eu . k a
thorne	ss o n
wilm	b i l . l eu m
herz	h e . l eu . ch eu
amsterdam	a m . s eu . t e . l eu . d a m
kilpinen	k i l . p i . n e n
oaxaca	o . a g . s a . k a
gustaf	g u . s eu . t a . p eu
menuhin	m e . n yu . i n
catilina	k a . t i l . l i . n a
poter	p o . t eo
lully	l wi l . l i
susanna	s u . s a n . n a
delta	d e l . t a
aldington	o l . d i ng . t eo n
schreyer	s yu . l a . i . eo
elba	e l . b a
rosa	l o . j a
alain	a l . l ae ng
hacker	h ae . k eo
lai	l a . i
stanford	s eu . t ae n . p eo . d eu
ridley	l i . d eu l . l i
olson	o l . s eu n
lewes	l u . i . s eu
michal	m a . i . k eu l
marcel	m a . l eu . s e l
holden	h o l . d eu n
lukas	l u . k a . s eu
chabrier	s ya . b eu . l i . e
clements	k eu l . l e . m eo n . ch eu
muris	m yu . l i . s eu
granville	g eu . l ae n . b i l
tallis	t ae l . l i . s eu
newport	n yu . p o . t eu
regine	l e . j i n
green	g eu . l i n
oklahoma	o . k eu l . l eo . h o . m a
davenport	d ae . b eu n . p o . t eu
jude	yu . d a
avogadro	a . b o . g a . d eu . l o
ivan	i . b a n
rodrigues	l o . d eu . l i . g e . s eu
austerlitz	a . u . s eu . t eo . l i . ch eu
arena	a . l e . n a
monty	m o n . t i
nichols	n i . k o l . s eu
cairns	k e . i n . j eu
falkland	p o . k eu l . l ae n . d eu
eisenhower	a . i . j e n . h a . wo
dodson	d a s . s eu n
sutter	s u . t eo
ewing	yu . i ng
hales	h e . i l . j eu
luchino	l u . k i . n o
beveridge	b e . b eo . l i . j i
stam	s eu . t a m
qi	ch i
marvell	m a . b eo l
oughtred	o . t eu . l e . d eu
couplet	k u . p eu l . l e
octavio	o g . t a . b i . o
alfonsin	a l . p o n . s i n
mackintosh	m ae . k i n . t o . s i
dane	d e . i n
germain	j e . l eu . m ae ng
magellan	m a . j e l . l a n
bergius	b e . l eu . g i . u . s eu
poli	p o l . l i
nightingale	n a . i . t i ng . g e . i l
ayala	a . ya l . l a
arther	a . s eo
souza	s u . j a
helsinki	h e l . s i ng . k i
baucus	b a . k eu . s eu
cadiz	k a . d i . s eu
naha	n a . h a
vailland	b a . ya ng
halls	h o l . s eu
rome	l o . m a
hardie	h a . d i
geoffrey	j o . p eu . l i
francisco	p eu . l a n . s i . s eu . k o
ricou	l i . k o . u
kelsey	k e l . s i
rumsey	l eo m . j i
halma	h ae l . m eo
galloni	g ae l . l o . n i
fosse	p o . s e
delius	d i l . l i . eo . s eu
hague	h e . i . g eu
monteverdi	m o n . t e . b e . l eu . d i
jospin	j o . s eu . p ae ng
werfel	b e . l eu . p e l
navarro	n a . b a . l o
lipps	l i b . s eu
dost	d o . s eu . t eu
holt	h o l . t eu
johnny	j o . n i
ackermann	a . k eo . m a n
crompton	k eu . l eo m . p eu . t eo n
verrocchio	b e . l o . k i . o
vauvenargues	b o . b eu . n a . l eu . g eu
cassini	k a . s i . n i
hegel	h e . g e l
narayan	n a . l a . ya n
rosemary	l o . j eu . m a . l i
volpi	b o l . p i
alia	a l . l i . a
middlesex	m i . d eu l . s e g . s eu
helms	h e l . l eu m . s eu
schubert	s yu . b e . l eu . t eu
ruiz	l u . i . j eu
nairobi	n a . i . l o . b i
colmar	k o l . m a . l eu
thomas	t o . m eo . s eu
lincoln	l i ng . k eo n
stirling	s eu . t eo . l i ng
akbar	a . k eu . b a . l eu
fontaine	p o ng . t e n
bingham	b i ng . h ae m
baylor	b ae . i l . l eo
cherry	ch e . l i
kamen	k e . i . m eo n
abuja	a . b u . j a
macrae	m ae g . l e . i
nathaniel	n eo . d ae . n i . eo l
hepburn	h e b . b eo n
iverson	a . i . b eo . s eu n
woodward	u . d eu . wo . d eu
dublin	d eo . b eu l . l i n
emily	e . m i l . l i
pauling	p o l . l i ng
ehrenfeld	e . l eo n . p e l . d eu
hebel	h e . b e l
peter	p i . t eo
costa	k o . s eu . t a
bachelard	b a . s yu l . l a . l eu
frege	p eu . l e . g e
rolls	l o l . s eu
martinson	m a . l eu . t i n . s o n
queens	k wi n . j eu
midas	m i . d a . s eu
ilse	i l . s eu
petrie	p i . t eu . l i
knightley	n a . i . t eu l . l i
asch	ae . s wi
annika	a . n i . k a
campo	k a m . p o
leonardo	l e . o . n a . l eu . d o
mcguire	m ae g . g wa . i . eo
quinton	k wi n . t eo n
beernaert	b e . l eu . n a . l eu . t eu
matilda	m a . t i l . d a
hoffa	h o . p a
sickingen	j i . k i ng . g e n
liebermann	l i . b e . l eu . m a n
richet	l i . s ye
achille	a . k i l . l e
longman	l o ng . m ae n
melchior	m e l . k i . o . l eu
jammes	j a m
kursk	k u . l eu . s eu . k eu
donald	d o . n eo l . d eu
frisch	p eu . l i . s yu
caine	k e . i n
nena	n i . n a
kolja	k o l . l i . ya
bergman	b eo . g eu . m eo n
diane	d a . i . a n
jacobi	ya . k o . b i
edgeworth	e . j i . wo . s eu
poulenc	p u l . l a ng . k eu
boden	b o . d e n
bergen	b e . l eu . g e n
malden	m o l . d e n
cosa	k o . s a
bruno	b eu . l u . n o
gwen	g eu . we n
erick	e . l i g
scarborough	s eu . k a . b o . l o
remington	l e . m i ng . t eo n
lucas	l u . k a . s eu
ian	i . eo n
newton	n yu . t eo n
webster	we b . s eu . t eo
praia	p eu . l a . i . a
grafton	g eu . l a . p eu . t eu n
rhodes	l o . d o . s eu
macon	m a . k o ng
lockett	l o . k e s
boerner	b oe . l eu . n eo
dolce	d o l . ch e
grey	g eu . l e . i
haggard	h ae . g eo . d eu
geist	g a . i . s eu . t eu
domingo	d o . m i ng . g o
sidney	s i . d eu . n i
greenfield	g eu . l i n . p i l . d eu
erving	eo . b i ng
atlanta	ae . t eu l . l ae n . t a
huysmans	wi . s eu . m a ng . s eu
johanson	j o . h ae n . s eu n
focke	p o . k e
hauser	h a . u . j eo
gallegos	g a l . l e . g o . s eu
clausen	k eu l . l o . j e n
havel	h a . b e l
ducommun	d wi . k o . m oe ng
jourdan	j o . d a n
prescott	p eu . l e . s eu . k eo s
sternberg	s eu . t eo n . b eo . g eu
trujillo	t eu . l u . h i . yo
valery	b a l . l e . l i
sanguinetti	s a ng . g i . n e . t i
minogue	m i . n o . g eu
pulitzer	p yu l . l i . ch eo
oakeshott	o . k eu . s yeo . t eu
caragiale	k a . l a . j i . a l . l e
leipold	l a . i . p o l . t eu
danieli	d a . n i . e l . l i
dobriansky	d o . b eu . l i . eo n . s eu . k i
britten	b eu . l i . t eu n
belcher	b e l . ch eo
sunderland	s eo n . d eo . l ae n . d eu
jacqueline	j ae . k eu l . l i n
schiaparelli	s eu . k i . a . p a . l e l . l i
kovalenko	k o . b a l . l e n . k o
merz	m e . l eu . ch eu
knox	n o g . s eu
hilton	h i l . t eo n
amar	a . m a . l eu
holl	h o l
niamey	n i . a . m e
pachelbel	p a . h e l . b e l
rosetti	l o . s e . t i
koenigsberger	k wi . n i . s eu . b eo . g eo
moraes	m o . l a . e . s eu
wollaston	u l . l eo . s eu . t eo n
congo	k o ng . g o
calcutta	k ae l . k eo . t a
anaheim	ae . n eo . h a . i m
rowe	l o . we
rutherford	l eo . d eo . p eo . d eu
romanov	l o . m a . n o . p eu
cornelio	k o . l eu . n e l . l i . o
kafka	k a . p eu . k a
penn	p e n
gjellerup	g i . e l . l e . l u . p eu
musil	m u . j i l
kircher	k i . l eu . h eo
colt	k o l . t eu
ryszard	l i . s eu . j a . d eu
gabin	g a . b ae ng
kirk	k eo . k eu
nie	n ye
bliss	b eu l . l i . s eu
meindert	m a . i n . d e . l eu . t eu
hewish	h yu . i . s i
lusaka	l u . s a . k a
walker	wo . k eo
latvia	l a . t eu . b i . a
edita	e . d i . t a
tucker	t eo . k eo
einhorn	a . i n . h o n
pacino	p a . ch i . n o
gaj	g a . i
moudud	m u . d u . d eu
vento	b e n . t o
bartolommeo	b a . l eu . t o l . l o m . m e . o
belfast	b e l . p a . s eu . t eu
drucker	d eu . l eo . k eo
winch	wi n . ch i
canto	k a n . t o
trygve	t eu . l wi . g eu . b e
phoebe	p o . i . b e
whitaker	h wi . t ae . k eo
bruni	b eu . l u . n i
labuan	l a . b u . a n
sousa	s u . j a
greta	g eu . l e . t a
stefani	s eu . t e . p a . n i
ines	i . n e . s eu
carpentier	k a . l eu . p e n . t i . e . l eu
detroit	d i . t eu . l o . i . t eu
capra	k ae . p eu . l a
mircea	m i . l eu . ch e . a
avraham	a . b eu . l a . h a m
worthy	wo . d i
miriam	m i . l i . eo m
minot	m a . i . n eo s
cesarotti	ch e . s a . l o . t i
serlio	s e . l eu l . l i . o
priscilla	p eu . l i . s i l . l a
picabia	p i . k a . b i . a
sergi	s e . l eu . h i
patricia	p eo . t eu . l i . s ya
mignon	m i . n yo ng
pickford	p i g . p eo . d eu
steinem	s eu . t a . i . n eo m
marina	m a . l i . n a
lyonnet	l i . o . n e
roberto	l o . b e . l eu . t o
queen	k wi n
gounod	g u . n o
caldecott	k o l . d eo . k eo s
greer	g eu . l i . eo
borchardt	b o . l eu . h a . l eu . t eu
magnani	m a . n ya . n i
albinoni	a l . b i . n o . n i
vouet	b u . e
maine	m e . i n
menzel	m e n . j e l
andres	a n . d eu . l e . s eu
chernenko	ch e . l eu . n e n . k o
dean	d i n
plato	p eu l . l a . t o n
byrnes	b eo n . s eu
soyinka	s o . i ng . k a
lilley	l i l . l i
nicolson	n i . k eo l . s eu n
suslov	s u . s eu l . l o . p eu
georges	j e . o . l eu . j e . s eu
zimmern	j i m . m e . l eu n
chan	ch ae n
cuvier	k wi . b i . e
palissy	p a l . l i . s i
abdus	a b . d u . s eu
dionysius	d i . o . n i . s i
armen	a . l eu . m e n
rankine	l ae ng . k i n
dixit	d i g . s i . t eu
lefebvre	l eu . p e . b eu . l eu
ellison	e l . l i . s eu n
clarence	k eu l . l ae . l eo n . s eu
mayo	m e . i . o
jaroslav	ya . l o . s eu l . l a . p eu
stoney	s eu . t o . n i
zaragoza	s a . l a . g o . s a
karim	k a . l i m
luce	l u . s eu
pire	p i . l eu
bulganin	b u l . g a . n i n
benedetto	b e . n e . d e . t o
kendrick	k e n . d eu . l i g
astrakhan	a . s eu . t eu . l a . h a n
glasgow	g eu l . l ae . s eu . g o
lex	l e g . s eu
petroni	p e . t eu . l o . n i
gary	g e . l i
chatterton	ch ae . t eo . t eo n
desiderius	d e . s i . d e . l i . u . s eu
frankel	p eu . l a n . k e l
swami	s eu . wa . m i
albertville	a l . b e . l eu . b i l
nair	n a . i . l eu
jaipur	j a . i . p u . l eu
anita	a . n i . t a
hamsun	h a m . s u n
smit	s eu . m i . t eu
stalin	s eu . t a l . l i n
muzio	m u . ch i . o
linton	l i n . t eo n
moniz	m o . n i . j eu
allard	a l . l a . d eu
steinmetz	s eu . t a . i n . m e . ch eu
downs	d a . u n . s eu
camdessus	k a ng . d eu . s wi
weaver	wi . b eo
waldo	wa l . d o
nerval	n e . l eu . b a l
elgin	e l . g i n
kolar	k o l . l a . l eu
maugham	m o m
beard	b i . eo . d eu
phyllis	p i l . l i . s eu
serge	s e . l eu . g e
cage	k e . i . j i
karol	k a . l o l
ambrose	ae m . b eu . l o . j eu
madras	m a . d eu . l a . s eu
morgan	m o . l eu . g eo n
kinsey	k i n . j e . i
whittall	h wi s . t o l
gerrit	h e . l i . t eu
sienkiewicz	s ye ng . k i . e . b i . ch i
march	m a . ch i
phoenix	p i . n i g . s eu
daniel	d a . n i . e l
gonsalves	g o n . s a l . b e . s eu
sidgwick	s i . j i . wi g
strasburger	s yu . t eu . l a . s eu . b u . l eu . g eo
zasulich	j a . s u l . l i . ch i
salvatore	s a l . b a . t o . l e
ingarden	i ng . g a . l eu . d e n
pino	p i . n o
freud	p eu . l o . i . t eu
muscat	m u . s eu . k a . t eu
grote	g eu . l o . t eu
nico	n i . k o
pais	p a . i . s eu
romania	l u . m a . n i . a
paula	p o l . l a
lind	l i n . d eu
alfieri	a l . p i . e . l i
camara	k a . m a . l a
algren	o l . g eu . l eo n
joni	j o . n i
tiele	t i l . l e
zacharias	j a . k a . l i . a . s eu
kowalski	k o . wa l . s eu . k i
foggia	p o . j i . a
toronto	t o . l o n . t o
kaverin	k a . b e . l i n
andre	a n . d eu . l e
warga	wa . g a
iliev	i l . l i . ye . p eu
mantovani	m a n . t o . b a . n i
hindenburg	h i n . d e n . b u . l eu . k eu
granit	g eu . l a . n i . t eu
indianapolis	i n . d i . ae . n a . p o l . l i . s eu
cale	k e . i l
borst	b o . l eu . s eu . t eu
kyd	k i . d eu
harsanyi	h eo . s ya . n i
bothe	b o . t e
bellow	b e l . l o
erfurt	e . l eu . p u . l eu . t eu
keaton	k i . t eu n
malaysia	m a l . l e . i . s i . a
danny	d a . n i
cain	k a . i n
tata	t a . t a
brook	b eu . l u g
william	b i l . l i . a m
vasilevskaya	b a . s i l . l e . p eu . s eu . k a . ya
frazier	p eu . l e . i . j eo
crommelynck	k eu . l o m . l ae ng . k eu
weinberg	wa . i n . b eo . g eu
angora	a ng . g o . l a
ana	a . n a
donne	d eo n
gallio	g a l . l i . o
monk	m eo ng . k eu
rosset	l o . s e . t eu
manet	m a . n e
filipov	p i l . l i . p o . p eu
lamennais	l a . m eu . n e
smirnov	s eu . m i . l eu . n o . p eu
chardonne	s ya . l eu . d o n
secchi	s e . k i
gassendi	g a . s a ng . d i
aldo	a l . d o
ciriaco	k eu . l i . a . k o
bath	b a . s eu
austin	o . s eu . t i n
eusebio	e . u . s e . b i . u
fay	p e . i
bujumbura	b u . j u m . b u . l a
hertwig	h e . l eu . t eu . b i . h i
abdul	a b . d u l
moore	m u . eo
gervinus	g e . l eu . b i . n u . s eu
ephraim	e . p eu . l a . i m
harman	h a . m eo n
uzi	u . j i
cass	k ae . s eu
vallejo	b a . ye . h o
schnabel	s yu . n a . b e l
vogt	p o . k eu . t eu
marianne	m a . l i . a n . n eu
stuart	s eu . t yu . eo . t eu
comenius	k o . m e . n i . u . s eu
rosen	l o . s eu n
magdalena	m a g . d a l . l e . n a
roland	l o l . l a ng
mira	m i . l a
shadwell	s yae . d eu . we l
andreev	a n . d eu . l e . ye . p eu
jevons	j e . b eo n . s eu
garcia	g a . l eu . s i . a
couto	k o . t u
park	p a . k eu
thom	t o m
kuibyshev	k u . i . b i . s ye . p eu
gertrude	g eo . t eu . l u . d eu
aman	a . m a n
papini	p a . p i . n i
husserl	h u . s eo l
rama	l a . m a
brand	b eu . l ae n . d eu
deaver	d i . b eo
wangchuck	wa ng . ch u . k eu
paola	p a . o l . l a
ferrero	p e . l e . l o
suffolk	s eo . p eo g
kerstin	k eo . s eu . t i n
elder	e l . d eo
josephus	yo . s e . p u . s eu
finland	p i n . l a n . d eu
moltke	m o l . t eu . k e
bowie	b o . wi
clement	k eu l . l e . m e n . t eu
castlereagh	k ae . s eu l . l e . i
burstein	b eo . s eu . t a . i n
bethlehem	b e . d eu l . l e . h e m
burroughs	b eo . l o . s eu
thorpe	s o . p eu
jain	j e . i n
alison	ae l . l i . s eu n
saran	s a . l a n
dobrolyubov	d o . b eu . l u l . l yu . b o . p eu
hofer	h o . p eo
lessing	l e . s i ng
driver	d eu . l a . i . b eo
ockham	o . k eo m
prout	p eu . l a . u . t eu
maccoby	m ae . k o . b i
camilla	k a . m i l . l a
gretchen	g eu . l e . ch e n
judd	j eo . d eu
krakow	k eu . l a . k o . p eu
bolt	b o l . t eu
senegal	s e . n e . g a l
boghossian	b o . g o . s i . a ng
motta	m o . t a
celia	s e l . l i . a
stoss	s yu . t o . s eu
ensor	e n . s o . l eu
wundt	b u n . t eu
cathy	k ae . s i
swedenborg	s eu . b e . d e n . b o . l i
leoncavallo	l e . o n . k a . b a l . l o
poole	p u l
kyle	k a . i l
george	g e . o . l eu . g eu
guiana	g i . a . n a
forster	p o . s eu . t eo
chopra	ch o . p eu . l a
kipling	k i . p eu l . l i ng
freire	p eu . l e . i . l e
adriana	a . d eu . l i . a . n a
parry	p e . l i
french	p eu . l e n . ch i
shapiro	s ya . p i . l o
ugo	u . g o
gusou	g u . ss eo . u
bellman	b e l . m a n
phillips	p i l . l i b . s eu
peres	p e . l e . s eu
harald	h a . l a l . t eu
hutten	h u . t e n
zeno	j e . n o n
oliveira	o l . l i . b e . i . l a
hepplewhite	h e . p eu l . h wa . i . t eu
posse	p o . s e
ron	l o n
weder	we . d eo
donahue	d o . n a . h yu
jeanette	j i . n e s
gwyn	g eu . wi n
barrett	b a . l e s
snowdon	s eu . n o . d eu n
gardner	g a . d eu . n eo
kyrgyzstan	k i . l eu . g i n . s eu . s eu . t a n
ince	i n . s eu
bolivia	b o l . l i . b i . a
ivanov	i . b a . n o . p eu
gleysteen	g eu l . l a . i . s eu . t i n
medici	m e . d i . ch i
pate	p e . i . t eu
boccaccio	b o . k a . ch i . o
bohemia	b o . h e . m i . a
puccini	p u . ch i . n i
saar	j a . l eu
gallup	g ae l . l eo b
andrew	ae n . d eu . l yu
cudworth	k eo . d eu . wo . s eu
ardennes	a . l eu . d e n
alvin	ae l . b i n
lowell	l o . we l
pennsylvania	p e n . s i l . b e . i . n i . a
hector	h e g . t o . l eu
patel	p a . t e l
bethe	b e . t e
roma	l o . m a
pontormo	p o n . t o . l eu . m o
grimmelshausen	g eu . l i . m e l . s eu . h a . u . j e n
hearst	h eo . s eu . t eu
kochanowski	k o . h a . n o . p eu . s eu . k i
bolton	b o l . t eo n
yogi	yo . g i
bremen	b eu . l e . m e n
vermeer	b e . l eu . m e . l eu
huston	h yu . s eu . t eo n
forbes	p o . b eu . s eu
freemantle	p eu . l i . m ae n . t eu l
ilona	i l . l o . n a
niebuhr	n i . b u . eo
morice	m o . l i . s eu
dessau	d e . s a . u
santander	s a n . t a n . d e . l eu
crosby	k eu . l o . s eu . b i
stefan	s yu . t e . p a n
kathryn	k ae . s eo . l i n
topelius	t o . p e l . l i . u . s eu
emanuel	e . m a . n u . e l
fizeau	p i . j o
bagehot	b ae . j eo s
milovan	m i l . l o . b a n
luc	l wi . k eu
lucena	l u . s e . n a
lewin	l e . b i n
soupault	s u . p o
hindemith	h i n . d e . m i . t eu
lopez	l o . p e . s eu
claude	k eu l . l a . u . d e
cronin	k eu . l o . n i n
milo	m i l . l o
sheldon	s ye l . d eo n
frye	p eu . l a . i
bismarck	b i . j eu . m a . k eu
jamison	j e . i . m i . s eu n
levin	l e . b i n
sinclair	s i ng . k eu l . l e . eo
hale	h e . i l
bangladesh	b a ng . g eu l . l a . d e . s i
millet	m i l . l e
weiss	b a . i . s eu
appleton	ae . p eu l . t eo n
barnet	b a . n e s
laurencin	l o . l a ng . s ae ng
reich	l a . i . h i
supervielle	s wi . p e . l eu . b i . e l
philippines	p i l . l i . p i n
nezval	n e . j eu . b a l
kerschensteiner	k e . l eu . s ye n . s yu . t a . i . n eo
zwingli	ch eu . b i ng . g eu l . l i
athens	a . t e . n e
mona	m o . n a
quin	k wi n
oud	o . d eu
waterbury	wo . t eo . b e . l i
bandiera	b a n . d i . e . l a
cadillac	k ae . d i l . l a g
spemann	s yu . p e . m a n
rolando	l o l . l a n . d o
lauren	l o . l e n
banach	b a . n a . h eu
brandt	b eu . l a n . t eu
schuman	s wi . m a ng
bourgeois	b u . l eu . j u . a
vargas	b a . l eu . g a . s eu
wilder	wa . i l . d eo
tennant	t e . n eo n . t eu
harnack	h a . l eu . n a . k eu
bluff	b eu l . l eo . p eu
terrace	t e . l a . s eu
austria	o . s eu . t eu . l i . a
salerno	s a l . l e . l eu . n o
aston	ae . s eu . t eo n
moses	m o . s e . s eu
ratzinger	l a . ch i ng . g eo
palade	p eo l . l e . i . d eu
mortimer	m o . t i . m eo
soledad	s o l . l i . d a . d eu
lynd	l i n . d eu
horn	h o . l eu n
limoges	l i . m o . j u
steel	s eu . t i l
crashaw	k eu . l ae . s yo
telford	t e l . p o . d eu
isabel	i . s a . b e l
simonov	s i . m o . n o . p eu
chissano	s i . s a . n o
solari	s o l . l a . l i
unamuno	u . n a . m u . n o
chernov	ch e . l eu . n o . p eu
babylon	b a . b i l . l o n
rauschenbusch	l a . u . s yeo n . b u . s i
williamson	wi l . l i . eo m . s eu n
damiani	d a . m i . a . n i
meir	m e . i . l eu
saussure	s o . s wi . l eu
fried	p eu . l a . i . d eu
broadbent	b eu . l o . d eu . b e n . t eu
ahn	a n
dmitry	d eu . m i . t eu . l i
caruso	k a . l u . s o
steffens	s yu . t e . p e n . s eu
uganda	u . g a n . d a
sanchez	s a n . ch e . s eu
bastian	b a . s eu . t i . a n
richer	l i . ch eo
edkins	ae . d eu . k i n . s eu
jawara	j a . wa . l a
lindsay	l i n . j i
andrej	a n . d eu . l e . i
umberto	u m . b e . l eu . t o
somerset	s eo . m eo . s i s
schumacher	s yu . m a . h eo
duer	d yu . eo
thayer	s e . i . eo
luisa	l u . i . j a
axel	a g . s e l
julio	h u l . l i . o
chambers	ch e . i m . b eo . s eu
schmalenbach	s yu . m a l . l e n . b a . h eu
jameson	j e . i m . s eu n
mel	m e l
hynninen	h a . i n . n i . n e n
kepler	k e . p eu l . l eo
madge	m e . j wi
harbison	h a . b i . s eu n
machel	m a . s ye l
cowan	k o . wa n
vicente	b i . s e n . t e
hawthorn	h o . s o n
bonner	b o . n eo
makarov	m a . k a . l o . p eu
bloomberg	b eu l . l u m . b eo . g eu
hodel	h o . d eu l
more	m o . eo
beaufort	b o . p eo . t eu
edouard	e . d u . a . l eu
potapenko	p o . t a . p e n . k o
henie	h e . n i
shelton	s ye l . t eo n
sazonov	s a . j o . n o . p eu
erwin	eo . wi n
nicol	n i . k o l
augustine	eo . g eo . s eu . t i n
mara	m a . l a
macleod	m ae . k eu l . l a . u . d eu
rwanda	l eu . wa n . d a
schell	s we l
libby	l i . b i
cate	k e . i . t eu
alba	a l . b a
lynen	l i . n e n
wolff	b o l . p eu
sanderson	s ae n . d eo . s eu n
rosalyn	l o . j eo l . l i n
amalia	a . m a l . l i . a
bardeen	b a . d i n
bela	b e l . l a
owen	o . we n
walden	we l . d eo n
rice	l a . i . s eu
pagnol	p a . n yo l
viking	b a . i . k i ng
rosenbusch	l o . j e n . b u . s yu
barone	b a . l o . n e
robyn	l o . b i n
jacks	j ae g . s eu
emmerich	e . m eo . l i . h i
bandeira	b a n . d e . i . l a
eccles	e . k eu l . s eu
dalton	d a l . t o n
poncelet	p o ng . s eu l . l e
hodgson	h o . j i . s eu n
hans	h a n . s eu
broadway	b eu . l o . d eu . we . i
baekeland	b e . i . k eu l . l ae n . d eu
huguette	wi . g e . t eu
waters	wo . t eo . s eu
pavlov	p a . b eu l . l o . p eu
port	p o . t eu
eysenck	a . i . s eo n . k eu
keeley	k e l . l i
clare	k eu l . l e . eo
medina	m e . d i . n a
switzerland	s eu . wi . s eu
guam	g wa m
dunlop	d eo n . l o b
denzel	d e n . j eo l
korolenko	k o . l o l . l e n . k o
abbot	a . b o . t eu
lie	l i
rozier	l o . j i . e
aberdeen	ae . b eo . d i n
shestov	s ye . s eu . t o . p eu
chamorro	ch a . m o . l o
winston	wi n . s eu . t eo n
daniele	d a . n i . e l
roberta	l o . b eo . t a
fiorentino	p i . o . l e n . t i . n o
beust	b o . i . s eu . t eu
achard	a . s ya . l eu
sodoma	s o . d o . m a
busse	b u . s e
leeds	l i . j eu
martha	m a . s a
tasha	t a . s ya
swammerdam	s eu . wa m . m e . l eu . d a m
ara	a . l a
cutler	k eo . t eu l . l eo
spielberg	s eu . p i l . b eo . g eu
carr	k a
hobhouse	h o b . h a . u . s eu
ravi	l a . b i
koror	k o . l o . l eu
lennart	l e n . n a . l eu . t eu
esenin	ye . s e . n i n
montevideo	m o n . t e . b i . d e . o
basso	b a . s o
perot	p e . l o
geneva	j e . n e . b a
bienville	b i . e n . b i l
aske	a . s eu . k e
cato	k a . t o
coburn	k o . b eo n
cennini	ch e n . n i . n i
azevedo	a . j e . b e . d o
hanks	h ae ng . k eu . s eu
obando	o . b a n . d o
geraint	j e . l e . i n . t eu
zajac	j a . j a . k eu
sanders	s ae n . d eo . s eu
aram	a . l a m
din	d i n
cooper	k u . p eo
oppenheimer	o . p e n . h a . i . m eo
rockefeller	l o g . p e l . l eo
emin	e . m i n
dana	d e . i . n a
bogota	b o . g o . t a
soufflot	s u . p eu l . l o
hebra	h e . b eu . l a
huss	h u . s eu
saint	s ae n . t eu
antoine	a ng . t u . a n
candela	k a ng . d e l . l a
gibson	g i . b eu . s eu n
eikhenbaum	e . i . h e n . b a . u m
calgary	k ae l . g eo . l i
auer	a . u . eo
steger	s yu . t e . g eo
bianchi	b i . a ng . k i
ritchie	l i . ch i
chantal	s ya n . t a l
diogenes	d i . o . g e . n e . s eu
walt	wo l . t eu
peccei	p e . ch e . i
chippendale	ch i . p e n . d e . i l
dian	d i . a n
barrios	b a . l i . o . s eu
gossen	g o . s e n
goodnow	g u s . n o . u
pirenne	p i . l e n
boz	b o . j eu
germany	d o g . i l
neri	n e . l i
ivory	a . i . b o . l i
schilling	s i l . l i ng
nunes	n u . n i . s eu
antonina	a n . t o . n i . n a
weierstrass	b a . i . eo . s yu . t eu . l a . s eu
albania	a l . b a . n i . a
kessler	k e . s eu l . l eo
langevin	l a ng . j u . b ae ng
otis	o . t i . s eu
hugo	wi . g o
drago	d eu . l a . g o
helga	h e l . g a
empson	e m . p eu . s eu n
jansson	ya n . s o n
josh	j o . s i
huber	h u . b eo
weyl	b a . i l
lundberg	l u n . d eu . b e . l i
nobel	n o . b e l
prebisch	p eu . l e . b i . s i
goldschmidt	g o l . t eu . s yu . m i . t eu
betjeman	b e . ch eo . m eo n
susan	s u . j a n
pittsburgh	p i . ch i . b eo . g eu
kretschmer	k eu . l e . ch i . m eo
dragan	d eu . l a . g a n
gracia	g eu . l a . s i . a
guerra	g e . l a
principe	p eu . l i n . s i . p e
colette	k o l . l e . t eu
kierkegaard	k i . e . l eu . k e . g o . l eu
wiesbaden	b i . s eu . b a . d e n
abebe	a . b e . b e
kempis	k e m . p i . s eu
blaine	b eu l . l e . i n
pellegrini	p e l . l e . g eu . l i . n i
ethel	e . d e l
enrique	e n . l i . k e
salem	s a l . l e m
poulet	p u l . l e
caxias	k a . s i . a . s eu
covington	k o . b i ng . t eo n
walter	wo l . t eo
welch	we l . ch i
rucker	l eo . k eo
kaunda	k a . u n . d a
gottfried	g o . t eu . p eu . l i . t eu
basie	b e . i . s i
jess	j e . s eu
gail	g e . i l
mousa	m u . s a
luca	l u . k a
amontons	a . m o ng . t o ng
goth	g o . t eu
sanaa	s a . n a
burt	b eo . t eu
dickens	d i . k i n . j eu
passy	p a . s i
liebknecht	l i . p eu . k eu . n e . h i . t eu
ockeghem	o . k e . g e m
goldoni	g o l . d o . n i
todd	t o . d eu
iglesias	i . g eu l . l e . s i . a . s eu
croce	k eu . l o . ch e
guyon	g wi . yo ng
oliver	o l . l i . b eo
lewis	l u . i . s eu
kenton	k e n . t eo n
rudenko	l u . d e n . k o
chamai	ch a . m a . i
edna	e . d eu . n a
colbert	k o l . b e . l eu
peng	p eo ng
delane	d i l . l e . i n
ellington	e l . l i ng . t eo n
sholokhov	s yo l . l o . h o . p eu
shute	s yu . t eu
boyce	b o . i . s eu
sandra	s ae n . d eu . l a
asam	a . j a m
dorothy	d o . l o . s i
tom	t o m
saraiva	s a . l a . i . b a
lund	l u n . d eu
colorado	k o l . l o . l a . d o
lucille	l u . s i l
ericson	e . l i g . s eu n
bessie	b e . s i
jouhaux	j u . o
northampton	n o . s ae m . p eu . t eo n
glendale	g eu l . l e n . d e . i l
liam	l i . eo m
wenders	b e n . d eo . s eu
kharkov	k a . k o . h eu
marguerite	m a . g eo . l i . t eu
platt	p eu l . l ae s
minnesota	m i . n e . s o . t a
goebel	g oe . b e l
kimberly	k i m . b eo l . l i
haeckel	h e . k e l
dowson	d a . u . s eu n
rudin	l u . d i n
eberhard	e . b e l . h a . l eu . t eu
knies	k eu . n i . s eu
alfred	ae l . p eu . l e . d eu
batoni	b a . t o . n i
rodbertus	l o . t eu . b e . l eu . t u . s eu
freundlich	p eu . l u n . d i . ch i
ruth	l u . s eu
rooney	l u . n i
portugal	p o . l eu . t u . g a l
boring	b o . l i ng
hayden	h e . i . d eu n
fuentes	p u . e n . t e . s eu
pompel	p o m . p e . i
paddy	p ae . d i
celan	ch e l . l a n
cervantes	s e . l eu . b a n . t e . s eu
marquand	m a . k wo n . d eu
huxley	h eo g . s eu l . l i
bonomi	b o . n o . m i
petersen	p i . t eo . s eu n
keynes	k e . i n . s eu
frankland	p eu . l ae ng . k eu l . l ae n . d eu
laud	l o . d eu
dunstable	d eo n . s eu . t eo . b eu l
habermas	h a . b eo . m a . s eu
preminger	p eu . l e . m i n . j eo
khabarovsk	h a . b a . l o . p eu . s eu . k eu
armin	a . l eu . m i n
cardinale	k a . l eu . d i . n a l . l e
baldung	b a l . d u ng
jacobson	j e . i . k o b . s eu n
emerson	e . m eo . s eu n
castro	k a . s eu . t eu . l o
ellsworth	e l . j eu . wo . s eu
lipmann	l i . p eu . m eo n
michnik	m i . h eu . n i . k eu
neill	n i l
schmitt	s yu . m i . t eu
sebastian	s eo . b ae . s eu . ch eo n
toffler	t o . p eu l . l eo
lent	l e n . t eu
negri	n e . g eu . l i
judah	yu . d a
linares	l i . n a . l e . s eu
peck	p e g
maclean	m ae g . k eu l . l ae n
herrera	h e . l e . l a
ford	p o . d eu
ueberweg	yu . b eo . b e g
pieter	p i . t eo
reynolds	l e . i . n o l . j eu
lorenzen	l o . l e n . j e n
basel	b a . j e l
ribot	l i . b o
finsen	p i n . s e n
wlodzimierz	b eu l . l o . ch i . m i . e . l eu . ch eu
mario	m a . l i . o
bratteli	b eu . l a . t e l . l i
montesquieu	m o ng . t e . s eu . k i . oe
mexico	m e g . s i . k o
gutenberg	g u . t e n . b e . l eu . k eu
frenchman	p eu . l a ng . s eu . i n
russell	l eo . s e l
isler	a . i . s eu l . l eo
fessenden	p e . s e n . d e n
bridie	b eu . l a . i . d i
teller	t e l . l eo
henriot	a ng . l i . o
schleiden	s yu l . l a . i . d e n
borchert	b o . l eu . h e . l eu . t eu
potter	p o . t eo
zahn	j ae n
brangwyn	b eu . l ae ng . g wi n
antonov	a n . t o . n o . p eu
janusz	ya . n u . s i
adolf	a . d o l . p eu
calais	k a l . l e
markus	m a . k eo . s eu
ranasinghe	l a . n a . s i ng . h e
habsburg	h a b . s eu . b u . l eu . k eu
rowell	l o . we l
bohuslav	b o . h u . s eu l . l a . p eu
mauritz	m a . u . l i . ch eu
perrier	p e . l i . e
neverov	n e . b e . l o . p eu
wilberforce	wi l . b eo . p o . s eu
earl	eo l
thomson	t o m . s eu n
dresden	d eu . l e . s eu . d e n
rubinstein	l u . b i n . s yu . t a . i n
carson	k a . s eu n
trevithick	t eu . l e . b i . s i g
frakes	p eu . l e . i . k eu
barents	b a . l e n . ch eu
kamenev	k a . m e . n e . p eu
gaede	g e . d e
althusser	a l . t wi . s e . l eu
pekkanen	p e . k a . n e n
pinto	p i n . t o
cecilia	s e . s i l . l i . a
layton	l e . i . t eu n
krupp	k eu . l u . p eu
granada	g eu . l a . n a . d a
osler	o . s eu l . l eo
thorvaldsen	t o . l eu . b a l . s e n
magyar	m a . j a . l eu
salween	s a l . wi n
lieberman	l i . b eo . m eo n
kruczkowski	k eu . l u . ch i . k o . p eu . s eu . k i
canada	k ae . n a . d a
saleh	s a l . l e
cabell	k ae . b eo l
boyle	b o . i l
knowles	n o l . s eu
dillon	d i l . l eo n
landgrebe	l ae n . d eu . g eu . l e . b e
swinburne	s eu . wi n . b eo n
lawton	l o . t eo n
benton	b e n . t eo n
mansfield	m ae n . s eu . p i l . d eu
pavlova	p a . b eu l . l o . b a
blythe	b eu l . l i . d eu
remnant	l e m . n eo n . t eu
bernard	b eo . n a . d eu
stacey	s eu . t e . i . s i
lao	l a . o
bari	b a . l i
arne	a . l eu . n e
casablanca	k a . s a . b eu l . l a ng . k a
ginsburg	g i n . j eu . b eo . g eu
lagos	l a . g o . s eu
mubarak	m u . b a . l a . k eu
whorf	wo . p eu
hinshelwood	h i n . s yeo l . u . d eu
cassandra	k a . s a n . d eu . l a
pisano	p i . s a . n o
martinus	m a . l eu . t i . n u . s eu
benigno	b e . n i . g eu . n o
cube	k yu . b i g
maurois	m o . l eu . wa
neisser	n a . i . s eo
donnie	d o . n i
ciampi	ch a m . p i
hubel	h eo . b eu l
augusto	a . u . g u . s eu . t o
fokker	p o . k eo
mencken	m e ng . k e n
gaspard	g a . s eu . p a . l eu
kant	k a n . t eu
giovanni	j o . b a n . n i
buch	b u . h eu
harriet	h ae . l i . eo s
pam	p ae m
binder	b a . i n . d eo
bahrain	b a . l e . i n
micronesia	m i . k eu . l o . n e . s i . a
peggy	p e . g i
laurel	l a . u . l e l
ritz	l i . ch eu
dakar	d a . k a . l eu
maxim	m a g . s i m
juglar	j wi . g eu l . l a
simpson	s i n . p eu . s eu n
niger	n i . j e . l eu
wiley	wa . i l . l i
attenborough	ae . t eu n . b eo . l eo
danzig	d a n . ch i . h i
capa	k a . p a
karrer	k a . l eo
nascimento	n a . s i . m e n . t u
belloc	b e l . l o g
jansen	ya n . s e n
dunant	d wi . n a ng
jay	j e . i
logan	l o . g eo n
maguire	m ae g . g wa . i . eo
nasser	n a . s e . l eu
harrisburg	h ae . l i . s eu . b eo . g eu
barber	b a . b eo
eschenbach	e . s ye n . b a . h eu
mitra	m i . t eu . l a
wilma	wi l . m a
maseru	m a . s e . l u
butts	b eo . ch eu
cresson	k eu . l e . s o ng
merton	m eo . t eu n
arthur	a . d eo
nora	n o . l a
raul	l a . u l
khalid	k a l . l i . d eu
keller	k e l . l eo
nouri	n u . l i
szigeti	s i . g e . t i
essen	e . s e n
ulrich	u l . l i . h i
madagascar	m a . d a . g a . s eu . k a . l eu
zeppelin	ch e . p e l . l i n
annabel	a . n a . b e l
salas	s a l . l a . s eu
dow	d a . u
bridgeport	b eu . l i . j i . p o . t eu
alphonso	a l . p o n . s o
maki	m a . k i
hue	wi . e
rupert	l u . p eo . t eu
tito	t i . t o
gerlach	g e . l eu l . l a . h eu
rodolfo	l o . d o l . p o
crocker	k eu . l o . k eo
adani	a . d a . n i
paulsen	p o l . s eu n
dod	d o . d eu
herb	h eo . b eu
ungaro	u ng . g a . l o
burnet	b eo . n e s
dowden	d a . u . d eu n
oberon	o . b e . l o n
benito	b e . n i . t o
wissler	wi . s eu l . l eo
chamisso	s ya . m i . s o
memling	m e m . l i ng
portinari	p o . l eu . t i . n a . l i
bentley	b e n . t eu . l i
anzengruber	a n . ch e n . g eu . l u . b eo
merkel	m e . l eu . k e l
lyell	l a . i . e l
andrade	a n . d eu . l a . d e
jouve	j u . b eu
procter	p eu . l o g . t eo
peron	p e . l o n
stephens	s eu . t i . b eu n . s eu
barros	b ae . l o . s eu
kuznetsov	k u . j eu . n e . ch o . p eu
chess	ch e . s eu
gadda	g a . d a
ferrer	p e . l eo
joshi	j o . s i
mehta	m e . t a
jenkins	j e n . k i n . s eu
harold	h ae . l eo l . d eu
wrightson	l a . i . t eu . s eu n
africa	a . p eu . l i . k a
krim	k eu . l i m
andy	ae n . d i
dewey	d yu . i
meitner	m a . i . t eu . n eo
galpin	g a l . p i n
anna	a n . n a
carley	k a l . l i
evers	e . b eo . s eu
buford	b eo . p o . d eu
wyler	wa . i l . l eo
juliette	j wi l . l i . e . t eu
berg	b eo . g eu
kaspar	k a . s eu . p a . eo
kraus	k eu . l a . u . s eu
zbigniew	j eu . b i . g eu . n i . e . p eu
alicia	ae l . l i . s ya
julien	j wi l . l i . ae ng
hooper	h u . p eo
baron	b a . l o n
bednorz	b e . d eu . n o . l eu . ch eu
kean	k i n
anson	ae n . s eu n
caldwell	k o l . d eu . we l
texas	t e g . s a . s eu
stroessner	s eu . t eu . l o . e . s eu . n e . l eu
monroy	m o n . l o . i
razin	l a . j i n
noverre	n o . b e . l eu
berkshire	b a . k eu . s yeo
friche	p eu . l i . ch e
youngstown	yeo ng . s eu . t a . u n
courteline	k u . l eu . t eu l . l i n
freeman	p eu . l i . m eo n
odilon	o . d i l . l o ng
hardwicke	h a . d eu . wi . k e
felicia	p e l . l i . s i . a
roussel	l u . s e l
dowling	d a . u l . l i ng
peshawar	p e . s ya . wa . l eu
karlfeldt	k a l . p e l . t eu
zanzibar	j a n . j i . b a . l eu
ortega	o . l eu . t e . g a
gozzi	g o . ch i
freudenthal	p eu . l o . i . d e n . t a l
johannes	yo . h a . n e . s eu
everson	e . b eo . s eu n
lamb	l ae m
delaunay	d eu l . l o . n e
bella	b e l . l a
palma	p a l . m a
hieronymus	h i . e . l o . n i . m u . s eu
biddle	b i . d eu l
brezhnev	b eu . l e . j u . n e . p eu
lapp	l a . p eu
pedersen	p i . d eo . s eu n
peterborough	p i . t eo . b eo . l eo
wedekind	b e . d e . k i n . t eu
bethell	b e . d e l
stumpf	s yu . t u m . p eu
naipaul	n a . i . p o l
saroyan	s a . l o . i . eo n
yaounde	ya . u n . d e
camper	k a m . p e . l eu
robertson	l o . b eo . t eu . s eu n
giancarlo	j i . a n . k a . l eu l . l o
belize	b e l . l i . j eu
brightman	b eu . l a . i . t eu . m a n
savage	s e . b i . j i
boas	b o . ae . s eu
vella	b e l . l a
beatty	b i . t i
ramuz	l a . m wi
bohr	b o . eo
verlaine	b e . l eu l . l e n
karin	k a . l i n
fischer	p i . s yeo
copenhagen	k o . p e n . h a . g e n
woodrow	u . d eu . l o
babcock	b ae b . k o g
giles	j a . i l . s eu
morand	m o . l a ng
smiles	s eu . m a . i l . s eu
schwab	s yu . b a . p eu
elmo	e l . m o
garrison	g ae . l i . s eu n
oresme	o . l e m
mari	m a . l i
kensington	k e n . j i ng . t eo n
gorbachev	g o . l eu . b a . ch o . p eu
kaplan	k ae . p eu l . l a n
lenard	l e . n a . l eu . t eu
pierre	p i . eo
elgar	e l . g a
rauch	l o . k eu
pirie	p a . i . l i
liddell	l i . d eu l
conte	k o ng . t e
mood	m u . d eu
bentham	b e n . d a m
pavese	p a . b e . s e
palestrina	p a l . l e . s eu . t eu . l i . n a
middleton	m i . d eu l . t eo n
benjamin	b e n . j a . m i n
lotto	l o . t o
jaspers	ya . s eu . p eo . s eu
ord	o . d eu
bash	b ae . s wi
craig	k eu . l e . i . g eu
mcbride	m ae g . b eu . l a . i . d eu
healey	h i l . l i
whale	we . i l
gullstrand	g u l . s eu . t eu . l a n . d eu
vigeland	b i . g e l . l a n
moyse	m o . i . j eu
ratner	l e . t eu . n eo
monroe	m eo n . l o
millan	m i l . l eo n
geibel	g a . i . b e l
valois	b a l . l u . a
huguenot	wi . g eu . n o
samuelson	s a . m u . e l . s eu n
miura	m i . u . l a
eckersley	e . k eo . s eu l . l i
laban	l a . b a n
wood	u . d eu
weidman	wa . i . d eu . m eo n
chopin	s yo . p ae ng
lomonosov	l o . m o . n o . s o . p eu
burney	b eo . n i
bihar	b i . h a . l eu
darby	d a . b i
nijmegen	n e . i . m e . g e n
browne	b eu . l a . u n
nansen	n a n . s e n
westwood	we . s eu . t eu . u . d eu
minnie	m i . n i
snell	s eu . n e l
benin	b e . n ae ng
obrecht	o . b eu . l e . h i . t eu
lassus	l a . s u . s eu
ignatiev	i . g eu . n a . t i . ye . p eu
madeira	m a . d e . i . l a
vane	b e . i n
bertram	b e . l eu . t eu . l a m
irvine	eo . b i n
benz	b e n . ch eu
margarita	m a . g a . l i . t a
stirner	s yu . t i . l eu . n eo
jolivet	j o l . l i . b e
skelton	s eu . k e l . t eo n
lichtenberg	l i . h i . t e n . b e . l eu . k eu
bunche	b eo n . ch i
dov	d o . b eu
cambodia	k a m . b o . d i . a
kozlov	k o . j eu l . l o . p eu
donaldson	d o . n a l . d eu . s eu n
bayonne	b a . yo n . n eu
magdeburg	m a . g eu . d e . b u . l eu . k eu
foch	p o . s yu
rosenthal	l o . j e n . t a l
abercromby	ae . b eo . k eu . l o m . b i
jordaens	yo . l eu . d a n . s eu
peruzzi	p e . l u . ch i
ahmadabad	a . m a . d a . b a . d eu
abrams	a . b eu . l a m . s eu
bouts	b o . ch eu
stark	s yu . t a . l eu . k eu
henze	h e n . ch e
flamsteed	p eu l . l ae m . s eu . t i . d eu
cameron	k ae . m eo . l eo n
schumann	s yu . m a n
spaak	s eu . p a . k eu
tolle	t o l . l e
wieland	b i l . l a n . t eu
junqueiro	j u n . k e . i . l u
chaptal	s ya . p eu . t a l
savonarola	s a . b o . n a . l o l . l a
scarlett	s eu . k a l . l e s
emeric	i . m e . l i g
jacquard	j a . k a . d eu
hefner	h e . p eu . n eo
nicolle	n i . k o l
segal	s i . g a l
endre	e n . d eu . l e
justin	j eo . s eu . t i n
christie	k eu . l i . s eu . t i
adrienne	e . i . d eu . l i . e n
wanda	wa n . d a
teresa	t e . l e . s a
barnett	b a . n e s
faiz	p e . i . j eu
shield	s wi l . d eu
borrow	b o . l o
lucia	l u . ch i . a
barr	b a
gainsborough	g e . i n . j eu . b eo . l eo
bud	b eo . d eu
hazlitt	h ae . j eu l . l i s
barron	b ae . l o n
arvid	a . l eu . b i . d eu
krasheninnikov	k eu . l a . s ye . n i n . n i . k o . p eu
chekhov	ch e . h o . p eu
garnier	g a . l eu . n i . e
rubin	l u . b i n
moro	m o . l o
bourget	b u . l eu . j e
sterne	s eu . t eo n
desmond	d e . j eu . m eo n . d eu
hawn	h o n
lugar	l u . g a
jonathan	j o . n eo . s eo n
battle	b ae . t eu l
grosz	g eu . l o . s eu
adelaide	ae . d eu l . l e . i . d eu
sid	s i . d eu
ezekiel	e . j e . k i . e l
jocelyn	j o . s e l . l i n
france	p eu . l a ng . s eu
nernst	n e . l eu n . s eu . t eu
minneapolis	m i . n i . ae . p o l . l i . s eu
wollstonecraft	u l . s eu . t eo n . k eu . l ae . p eu . t eu
lombard	l o m . b a . l eu . d eu
valera	b a l . l e . l a
mickey	m i . k i
mironov	m i . l o . n o . p eu
elsie	e l . s i
gamble	g ae m . b eu l
gilbert	g i l . b eo . t eu
martindale	m a . t i n . d e . i l
chappe	s ya . p eu
lars	l a . l eu . s eu
pearson	p i . eo . s eu n
tolkien	t o l . k i n
mader	m a . d eo
manuel	m a . n u . e l
palme	p a l . m e
fadeev	p a . d e . ye . p eu
bell	b e l
dmitri	d eu . m i . t eu . l i
helmut	t eu
speight	s eu . p e . i . t eu
camus	k a . m wi
fontane	p o n . t a . n e
vaillant	b a . ya ng
basin	b a . s i n
brunei	b eu . l u . n a . i
burman	b eo . m a
larsson	l a . l eu . s o n
swan	s eu . wa n
rathenau	l a . t e . n a . u
saavedra	s a . b e . d eu . l a
benacerraf	b e . n a . s e . l a . p eu
brasilia	b eu . l a . j i l . l i . a
agrippina	a . g eu . l i . p i . n a
erbakan	e . l eu . b a . k a n
concord	k o ng . k o . d eu
grass	g eu . l a . s eu
marschner	m a . l eu . s yu . n eo
prosper	p eu . l o . s eu . p e . l eu
paine	p e . i n
federico	p e . d e . l i . k o
cassel	k a . s e l
morisot	m o . l i . j o
runeberg	l u . n e . b e . l i
brown	b eu . l a . u n
redon	l eu . d o ng
ibsen	i b . s e n
wesleyan	we . s eu l . l i
valla	b a l . l a
adama	a . d a . m a
karl	k a . l eu l
zemskov	j e m . s eu . k o . p eu
kiesinger	k i . j i ng . g eo
tauler	t a . u l . l eo
newcomb	n yu . k eo m
robert	l o . b e . l eu . t eu
erlanger	eo l . l ae ng . eo
baku	b a . k u
albani	a l . b a . n i
updike	eo b . d a . i . k eu
nkrumah	eu n . k eu . l u . m a
brundage	b eu . l eo n . d i . j i
seckel	s e . k eo l
concepcion	k o n . s e b . s i . o n
cardenas	k a . l eu . d e . n a . s eu
garnett	g a . n e s
konrad	k o n . l a . t eu
robb	l o b
crabbe	k eu . l ae . b eu
lacey	l e . i . s i
cairo	k a . i . l o
wilkes	wi l . k eu . s eu
re	l e
hobson	h o b . s eu n
ohio	o . h a . i . o
frederick	p eu . l e . d eu . l i g
berto	b e . l eu . t o
tiso	t i . s o
sombart	j o m . b a . l eu . t eu
michael	m i . s we l
gross	g eu . l o . s eu
owens	o . eo n . s eu
nubia	n u . b i . a
bradford	b eu . l e . d eu . p o . d eu
quesada	k we . s eu . d a
featherstone	p i . d eo . s eu . t o n
krasnodar	k eu . l a . s eu . n o . d a . l eu
koen	k o . e n
krzysztof	k eu . s i . s yu . t o . p eu
gianfranco	j a n . p eu . l a ng . k o
laplace	l a . p eu l . l a . s eu
masson	m a . s o ng
irene	i . l e . i n
ned	n e . d eu
melo	m e l . l o
heike	h a . i . k e
odessa	o . d e . s a
biber	b i . b eo
nash	n ae . s i
gerasimov	g e . l a . s i . m o . p eu
terra	t e . l a
fanning	p ae . n i ng
calfa	ch a l . p a
elizabethe	e l . l i . j a . b e . s eu
abbas	a . b a . s eu
kenya	k e . n ya
stimson	s eu . t i m . s eu n
visconti	b i . s eu . k o n . t i
berger	b eo . g eo
bakersfield	b e . k eo . j eu . p i l . d eu
dever	d e . b eo
gold	g o l . d eu
champlain	s ya ng . p eu l . l ae ng
villa	b i l . l a
lauderdale	l o . d eo . d e . i l
keon	k i . o n
bettino	b e . t i . n o
sadi	s a . d i
wittenberg	b i . t e n . b e . l eu . k eu
ban	b a n
northrop	n o . s eu . l eo b
schongauer	s yo n . g a . u . eo
florida	p eu l . l o . l i . d a
beadle	b i . d eu l
pisarev	p i . s a . l e . p eu
hoel	h o . e l
munsell	m eo n . s e l
blunden	b eu l . l eo n . d eo n
rada	l a . d a
stodola	s eu . t o . d o . l a
lucy	l u . s i
chadwick	ch ae . d eu . wi g
gartner	g a . t eu . n eo
evans	e . b eo n . s eu
weber	we . b eo
hana	h a . n a
wendy	we n . d i
barstow	b a . l eu . s eu . t o . u
inge	i ng
koblenz	k o . b eu l . l e n . ch eu
zeman	j e . m a n
colleen	k o l . l i n
lambeth	l ae m . b eo . s eu
felipe	p e l . l i . p e
navarre	n a . b a . l eu
lorena	l o . l e . n a
audubon	o . d yu . b o n
theiler	t a . i l . l eo
lodi	l o . d i
litt	l i s
barclay	b a . k eu l . l i
fichte	p i . h i . t e
bill	b i l
vorontsov	b o . l o n . ch o . p eu
fraser	p eu . l e . i . j eo
alecsandri	a l . l e g . s a n . d eu . l i
wolker	b o l . k e . l eu
hogan	h o . g eo n
moissan	m u . a . s a ng
valletta	b a l . l e . t a
eyck	e . i . k eu
boole	b u l
nye	n a . i
steven	s eu . t i . b eu n
lilienthal	l i l . l i . e n . s o l
columbia	k eo l . l eo m . b i . a
weir	wi . eo
adriano	a . d eu . l i . a . n o
vicki	b i . k i
antananarivo	a n . t a . n a . n a . l i . b o
gareth	g ae . l i . s eu
yala	ya l . l a
zeiss	ch a . i . s eu
stead	s eu . t e . d eu
firestone	p a . i . eo . s eu . t o n
mathilde	m a . t i l . d eu
honeywell	h a . n i . we l
kollwitz	k o l . b i . ch eu
helmholtz	h e l . l eu m . h o l . ch eu
ribbentrop	l i . b e n . t eu . l o . p eu
daumier	d o . m i . e
lucy	l u . ss i
underwood	eo n . d eo . u . d eu
cuba	k u . b a
busia	b u . s i . a
brentano	b eu . l e n . t a . n o
twardowski	t eu . wa . l eu . d o . p eu . s eu . k i
coleridge	k o l . l i . j i
staffordshire	s eu . t ae . p eo . d eu . s yeo
georgi	g e . o . l eu . g i
faust	p a . u . s eu . t eu
hoff	h o . p eu
hoare	h o . eo
reinecke	l a . i . n e . k e
palgrave	p o l . g eu . l e . i . b eu
bitter	b i . t eo
hettner	h e . t eu . n eo
natorp	n a . t o . l eu . p eu
binet	b i . n e
pritchard	p eu . l i . ch eo . d eu
emil	e . m i l
gonzalo	g o n . s a l . l o
mitropoulos	m i . t eu . l o . p o l . l o . s eu
berlioz	b e . l eu l . l i . o . j eu
andalusia	a n . d a l . l u . s i . a
buridan	b wi . l i . d a ng
asquith	ae . s eu . k wi . s eu
graaf	g eu . l a . p eu
encke	e ng . k e
tallinn	t a l . l i n
aleksander	a l . l e g . s a n . d eo
samantha	s a . m a n . d a
luke	l u g . k eu
vatican	b a . t i . k a n
rudolph	l u . d o l . p eu
olyphant	o l . l i . p eo n . t eu
girardon	j i . l a . l eu . d o ng
salam	s a l . l a m
milne	m i l . l eu n
collin	k o l . l i n
milton	m i l . t eo n
sandburg	s ae n . d eu . b eo . g eu
stephanie	s eu . t e . p a . n i
hogarth	h o . g a . s eu
osgood	o . s eu . g u s
denver	d e n . b eo
harrison	h ae . l i . s eu n
huch	h u . h eu
honorius	h o . n o . l i . u . s eu
moussa	m u . s a
pereira	p e . l e . i . l a
swift	s eu . wi . p eu . t eu
aylwin	a . i l . wi n
gerolamo	j e . l o l . l a . m o
lasse	l a . s e
hooch	h o . h eu
tajikistan	t a . j i . k i . s eu . t a n
yorktown	yo . k eu . t a . u n
eckhart	e . k eu . h a . l eu . t eu
bromley	b eu . l o m . l i
konstantin	k o n . s eu . t a n . t i n
simmonds	s i . m eo n . j eu
augustus	a . u . g u . s eu . t u . s eu
loewi	l oe . b i
freyssinet	p eu . l e . i . s i . n e s
zion	s i . o n
wallace	wo l . l i . s eu
suttner	j u . t eu . n eo
zdenek	j eu . d e . n e g
laos	l a . o . s eu
rakhmaninov	l a . h eu . m a . n i . n o . p eu
dent	t e n . t eu
auriol	o . l i . o l
vries	b eu . l i . s eu
stephenson	s eu . t i . b eu n . s eu n
garrick	g ae . l i g
bieber	b i . b eo
dowdeswell	d o . d e . s eu . b e l
aquino	a . k i . n o
pozzo	p o . j o
mukherjee	m u . k eo . l eu . j i
joel	yo . e l
volga	b o l . g a
koirala	k o . i . l a l . l a
rietveld	l i . t eu . b e l . t eu
ramus	l a . m u . s eu
schmid	s yu . m i . d eu
hellen	h e l . l e n
seth	s e s
rothschild	l o . s eu . ch a . i l . d eu
omar	o . m a
rivlin	l i . b eu l . l i n
stowe	s eu . t o
sinowatz	j i . n o . b a . ch eu
bernadette	b eo . n a . d e . t eu
dimitrov	d i . m i . t eu . l o . p eu
riddick	l i . d i g
lyons	l i . yo ng
white	h wa . i . t eu
chad	ch a . d eu
