galbraith	k ae l . b eu . l e . i . s eu
havana	a . b a . n a
georgia	g eu . l u . j i . a
cremer	k eu . l i . m eo
kessler	k e . s eu l . l eo
antonio	a n . t o . n i . o
french	p eu . l e n . ch i
giles	j a . i l . s eu
evanson	e . b a n . s eu n
branson	b eu . l ae n . s eu n
cayenne	k a . ye n
raya	l a . ya
ziegler	ch i . g eu l . l eo
myron	m i . l o n
hannibal	h a n . n i . b a l
wertheimer	b e . l eu . t eu . h a . i . m eo
rosenthal	l o . j e n . t a l
falcone	p a l . k o . n e
abbe	a . b e
pizarro	p i . s a . l o
kohn	k o n
stolz	s eu . t o l . ch eu
siegen	j i . g e n
elton	e l . t eu n
summer	s a . m a
stacey	s eu . t e . i . s i
barca	b a . l eu . k a
testa	t e . s eu . t a
hinton	h i n . t eo n
rangoon	l ae ng . g u n
bess	b e . s eu
chamisso	s ya . m i . s o
faith	p e . i . s eu
aasen	o . s e n
arnold	a . n o l . d eu
cannon	k ae . n eo n
larsson	l a . l eu . s o n
witz	b i . ch eu
lind	l i n . d eu
roth	l o . t eu
sholokhov	s yo l . l o . h o . p eu
werner	b e . l eu . n eo
tylor	t a . i l . l eo
ernie	eo . n i
morse	m o . s eu
steinberg	s eu . t a . i n . b eo . g eu
karrer	k a . l eo
clausen	k eu l . l o . j e n
imam	i . m a m
vigo	b i . g o
dean	d i n
augusta	o . g eo . s eu . t a
casey	k e . i . s i
gabriel	g a . b eu . l i . e l
michnik	m i . h eu . n i . k eu
shelley	s ye l . l i
frances	p eu . l a n . s i . s eu
zimmern	j i m . m e . l eu n
lilli	l i l . l i
ransom	l ae n . s eo m
levant	l e . b a n . t eu
salween	s a l . wi n
gioberti	j o . b e . l eu . t i
fazal	p a . j a l
rachel	l a . h e l
hobsbawm	h o b . s eu . b o m
jurgen	j u . g e n
buono	b o . n o
quentin	k wo n . t i n
tobin	t o . b i n
cagliari	k a l . l i . a . l i
junge	yu ng . g e
twardowski	t eu . wa . l eu . d o . p eu . s eu . k i
darryl	d ae . l i l
bernhardt	b e . l eu . n a . l eu
carroll	k ae . l o l
trendelenburg	t eu . l e n . d e l . l e n . b u . l eu . k eu
hubertus	h u . b e . l eu . t u . s eu
cambridge	k e . i m . b eu . l i . j i
alphonse	a l . p o ng . s eu
rugby	l eo g . b i
courteline	k u . l eu . t eu l . l i n
nurmi	n u . l eu . m i
hoffmann	h o . p eu . m a n
soddy	s o . d i
dirk	d eo . k eu
gould	g u l . d eu
darlington	d a l . l i ng . t eo n
lachmann	l a . h eu . m a n
jacobsen	ya . k o b . s e n
salem	s a l . l e m
ezra	e . s eu . l a
lemarchand	l eu . m a g . s yeo ng
paige	p e . i . j i
manson	m ae n . s eu n
dyke	d a . i . k eu
north	n o . s eu
sperry	s eu . p e . l i
halle	h a l . l e
inglis	i ng . g eu l . l i . s eu
dodoma	d o . d o . m a
memling	m e m . l i ng
diouf	d i . u . p eu
fanny	p a . n i
konstantinos	k o n . s eu . t a n . t i . n o . s eu
margarete	m a . l eu . g a . l e . t e
marta	m a . l eu . t a
bowden	b o . u . d e n
grigorovich	g eu . l i . g o . l o . b i . ch i
emily	e . m i l . l i
poul	p o . u l
ferrero	p e . l e . l o
dirichlet	d i . l i . k eu l . l e
indiana	i n . d e . e . n a
nye	n a . i
boileau	b u . a l . l o
bernstein	b eo n . s eu . t a . i n
lynen	l i . n e n
cornelius	k o . l eu . n e l . l i . u . s eu
caton	k e . i . t eu n
rau	l a . u
pierce	p i . eo . s eu
gerrit	h e . l i . t eu
mila	m i l . l a
gotthelf	g o . t eu . h e l . p eu
montreal	m o n . t eu . l i . o l
mann	m a n
mason	m e . i . s o n
enesco	e . n e . s eu . k o
vento	b e n . t o
khomeini	h o . m e . i . n i
ferry	p e . l i
malpighi	m a l . p i . g i
gauss	g a . u . s eu
granet	g eu . l a . n e
obando	o . b a n . d o
pestalozzi	p e . s eu . t a l . l o . ch i
galway	g o l . we . i
zeppelin	ch e . p e l . l i n
borchert	b o . l eu . h e . l eu . t eu
birmingham	b eo . m i ng . eo m
nat	n ae s
jansen	ya n . s e n
lopez	l o . p e . s eu
wanda	wa n . d a
maurras	m o . l a . s eu
bentley	b e n . t eu . l i
poncelet	p o ng . s eu l . l e
managua	m a . n a . g wa
marriner	m a . l i . n eo
piero	p i . e . l o
montalvo	m o n . t a l . b o
urbain	wi . l eu . b ae ng
ismailia	i . s eu . m a . i l . l i . a
lombard	l o m . b a . d eu
asmara	a . s eu . m a . l a
lobo	l o . b o
aylwin	a . i l . wi n
wien	b i n
lorenzo	l o . l e n . ch o
leonardo	l e . o . n a . l eu . d o
southern	s eo . d eo n
potts	p o . ch eu
humphreys	h eo m . p eu . l i . s eu
bolt	b o l . t eu
sommerfield	s eo m . m eo . p i l . d eu
antonius	a n . t o . n i . u . s eu
keller	k e l . l eo
asso	a . s o
tennessee	t e . n e . s i
soares	s o . a . l e . s eu
cornelio	k o . l eu . n e l . l i . o
rodgers	l o . j eo . s eu
shu	s u
mortimer	m o . t i . m eo
philipe	p i l . l i . p eu
peters	p i . t eo . s eu
ensor	e n . s o . l eu
ribot	l i . b o
zbigniew	j eu . b i . g eu . n i . e . p eu
amato	a . m a . t o
allan	ae l . l eo n
kampala	k a m . p a l . l a
rabelais	l a . b eu l . l e
huxley	h eo g . s eu l . l i
brezhnev	b eu . l e . j u . n e . p eu
dunstable	d eo n . s eu . t eo . b eu l
tartini	t a . l eu . t i . n i
catherine	k ae . d eo . l i n
whittall	h wi s . t o l
szell	s e l
harlow	h a l . l o
ashton	ae . s yu . t eo n
gerard	j e . l a . l eu
mead	m i . d eu
bertini	b eo . t i . n i
blaine	b eu l . l e . i n
trollope	t eu . l o l . l eo b
merlin	m eo l . l i n
laurie	l o . l i
alex	a l . l e g . s eu
cynthia	s i n . s i . a
feinberg	p a . i n . b eo . g eu
pettit	p e . t i . t eu
daniels	d a . n i . e l . j eu
harsanyi	h eo . s ya . n i
pelle	p e l . l e
bentham	b e n . d a m
sunderland	s eo n . d eo . l ae n . d eu
bergengruen	b e . l eu . g e n . g eu . l wi n
cuvier	k wi . b i . e
herzberg	h e . l eu . ch eu . b e . l eu . k eu
tajo	t a . h o
olivier	o l . l i . b i . e
bloemfontein	b eu l . l u m . p o n . t e . i n
krim	k eu . l i m
naess	n e . s eu
arne	a . l eu . n e
belmopan	b e l . m o . p a n
jesse	j e . s i
voigt	p o . k eu . t eu
bain	b e . i n
swammerdam	s eu . wa m . m e . l eu . d a m
boghossian	b o . g o . s i . a ng
alfonsin	a l . p o n . s i n
allen	ae l . l eo n
marquand	m a . k wo n . d eu
rossini	l o . s i . n i
albert	ae l . b eo . t eu
prebisch	p eu . l e . b i . s i
gyula	j u l . l eo
sergio	s e . l eu . j o
miriam	m i . l i . eo m
dehmel	d e . m e l
tracy	t eu . l e . i . s i
milovan	m i l . l o . b a n
itzhak	i . j a g
smit	s eu . m i . t eu
berthold	b e . l eu . t o l . t eu
ankara	a ng . k a . l a
schiele	s i l . l e
sylvester	s i l . b e . s eu . t eo
donatus	d o . n a . t u . s eu
irene	i . l e . i n
nebojsa	n e . b o . i . s a
behaim	b e . h a . i m
frazier	p eu . l e . i . j eo
med	m e . d eu
godfrey	g o . d eu . p eu . l i
solti	s o l . t i
march	m a . ch i
grenfell	g eu . l e n . p e l
chandler	ch ae n . d eu l . l eo
carnarvon	k a . n a . b o n
procter	p eu . l o g . t eo
suarez	s u . a . l e . j eu
winkler	b i ng . k eu l . l eo
antunes	a n . t u . n e . s eu
osborn	o . j eu . b eo n
vernon	b eo . n o n
oxford	o g . s eu . p eo . d eu
gillespie	g i l . l e . s eu . p i
clifton	k eu l . l i . p eu . t eo n
gutenberg	g u . t e n . b e . l eu . k eu
piatigorsky	p i . a . t i . g o . l eu . s eu . k i
landsteiner	l a n . t eu . s yu . t a . i . n eo
pavel	p a . b e l
cadena	k a . d e . n a
zambia	j a m . b i . a
perugino	p e . l u . j i . n o
mill	m i l
hutson	h eo . t eu . s eu n
hale	h e . i l
ungaretti	u ng . g a . l e . t i
dalcroze	d a l . k eu . l o . j eu
gluck	g eu l . l u . k eu
bang	b a ng
hague	h e . i . g eu
borst	b o . l eu . s eu . t eu
alessio	a l . l e . s i . o
chippendale	ch i . p e n . d e . i l
lubbock	l eo . b eo g
nerva	n e . l eu . b a
bamako	b a . m a . k o
pulci	p u l . ch i
frederic	p eu . l e . d eo . l i g
foucault	p u . k o
hollingworth	h o l . l i ng . wo . s eu
ackermann	a . k eo . m a n
say	s e
yamoussoukro	ya . m u . s u . k eu . l o
ruo	l wo
nunn	n eo n
foley	p o l . l i
baron	b a . l o n
pieter	p i . t eo
worms	b o . l eu m . s eu
markus	m a . k eo . s eu
senior	s i . n i . eo
hedtoft	h e . d eu . t o . p eu . t eu
voronin	b o . l o . n i n
fowler	p a . u l . l eo
marquis	m a . l eu . k i . s eu
iran	i . l a n
hopkins	h o b . k i n . s eu
hartline	h a . t eu l . l a . i n
cheyenne	s ya . i . e n
wrightson	l a . i . t eu . s eu n
armand	a . l eu . m a ng
schnitzler	s yu . n i . ch eu l . l eo
paul	p o l
bachelard	b a . s yu l . l a . l eu
malebranche	m a l . b eu . l a ng . s yu
yvette	i . b e . tt eu
ida	i . d a
madagascar	m a . d a . g a . s eu . k a . l eu
arthur	a . l eu . t u . l eu
thiers	t i . e . l eu
leno	l e . n o
carlin	k a l . l i n
palma	p a l . m a
badajoz	b a . d a . h o . s eu
count	k a . u n . t eu
geibel	g a . i . b e l
angel	e n . j e l
varga	b a . l eu . g a
peper	p e . p e . l eu
strand	s eu . t eu . l ae n . d eu
jaques	j a . k eu
warwickshire	wo . l i g . s yeo
woolf	u l . p eu
esther	e . s eu . d eo
becket	b e . k e . t eu
bessel	b e . s e l
sherry	s ye . l i
pittsburgh	p i . ch i . b eo . g eu
mingdao	m i ng . d a . o
thurnwald	t u . l eu n . b a l . t eu
natta	n a . t a
posner	p o . j eu . n eo
schwerin	s yu . b e . l i n
althusser	a l . t wi . s e . l eu
dorn	d o n
chaucer	ch o . s eo
jahn	ya n
schally	s ya l . l i
wakefield	we . i . k eu . p i l . d eu
chavez	ch a . b e . s eu
torrence	t o . l eo n . s eu
kinsey	k i n . j e . i
chelmsford	ch e l . l eu m . s eu . p eo . d eu
bek	b e g
rosebery	l o . j eu . b eo . l i
novoa	n o . b o . a
marlowe	m a l . l o
vallejo	b a . ye . h o
kapp	k a . p eu
cain	k a . i n
luigi	l u . i . j i
ericson	e . l i g . s eu n
ernesto	e . l eu . n e . s eu . t o
vinogradoff	b i . n o . g eu . l a . d o . p eu
morgan	m o . l eu . g eo n
scherman	s ye . l eu . m a n
perl	p eo l
tata	t a . t a
herzl	h e . l eu . ch eu l
hulbert	h eo l . b eo . t eu
hearst	h eo . s eu . t eu
northrop	n o . s eu . l eo b
eudora	yu . d o . l a
serafin	s e . l a . p i n
myanmar	m ya n . m a
buchanan	b yu . k ae . n eo n
ciampi	ch a m . p i
crashaw	k eu . l ae . s yo
maistre	m e . s eu . t eu . l eu
drinkwater	d eu . l i ng . k eu . wo . t eo
potsdam	p o . s eu . d a m
nevelson	n i . b e l . s eu n
speyer	s yu . p a . i . eo
fick	p i . k eu
christoph	k eu . l i . s eu . t o . p eu
rolf	l o l . p eu
ryszard	l i . s eu . j a . d eu
farrell	p ae . l eo l
saleh	s a l . l e
hofer	h o . p eo
richards	l i . ch eo . j eu
robb	l o b
chung	j eo ng
auken	a . u . k e n
vinogradov	b i . n o . g eu . l a . d o . p eu
jamieson	j e . m i . s eu n
hogan	h o . g eo n
malinowski	m a l . l i . n o . p eu . s eu . k i
frei	p eu . l e . i
hornby	h o n . b i
jacques	j a . k eu
elam	e l . l a m
pembroke	p e m . b eu . l u g
janez	ya . n e . j eu
camargo	k a . m a . l eu . g o
obrecht	o . b eu . l e . h i . t eu
hines	h a . i n . j eu
laplace	l a . p eu l . l a . s eu
schiff	s wi . p eu
sand	s a ng . d eu
kimberly	k i m . b eo l . l i
marvell	m a . b eo l
savage	s e . b i . j i
mendes	m e n . d e . s eu
sal	s a l
holbrooke	h o l . b eu . l u g
rais	l a . i . s eu
heiberg	h e . i . b e . l eu . g eu
dumas	d wi . m a
gibb	g i b
yala	ya l . l a
kenneth	k e . n i . s eu
amos	a . m o . s eu
kuibyshev	k u . i . b i . s ye . p eu
ioan	i . o . a n
benz	b e n . ch eu
dilthey	d i l . t a . i
kafka	k a . p eu . k a
carl	k a . l eu l
selim	s e l . l i m
wise	wa . i . j eu
field	p i l . d eu
mance	m ae n . s eu
poter	p o . t eo
turing	t yu . l i ng
filmer	p i l . m eo
ava	e . b a
nora	n o . l a
pisarev	p i . s a . l e . p eu
enos	e . n o . s eu
cornwell	k o n . wo l
esteban	e . s eu . t e . b a n
fleischer	p eu l . l a . i . s yeo
plato	p eu l . l a . t o n
soledad	s o l . l i . d a . d eu
windelband	b i n . d e l . b a n . t eu
damen	d e . i . m eo n
brooke	b eu . l u g
peterson	p i . t eo . s eu n
boole	b u l
rahman	l a . m a n
clausius	k eu l . l a . u . j i . u . s eu
witherspoon	wi . d eo . s eu . p u n
faye	p e . i
dekker	d e . k eo
marina	m a . l i . n a
caesar	s i . j eo
hennebique	e n . b i . k eu
pompel	p o m . p e . i
beardsley	b i . eo . j eu l . l i
melvil	m e l . b i l
avogadro	a . b o . g a . d eu . l o
schmitt	s yu . m i . t eu
thoreau	s o . l o
patrick	p a . t eu . l i . k eu
vincenzo	b i n . ch e n . ch o
henne	h e . n i
gross	g eu . l o . s eu
pace	p e . i . s eu
sagan	s e . i . g eo n
bloomfield	b eu l . l u m . p i l . d eu
langmuir	l ae ng . m yu . eo
delon	d eu . l o ng
como	k o . m o
freya	p eu . l o . i . ya
sweelinck	s eu . b e l . l i ng . k eu
leicester	l e . s eu . t eo
yaounde	ya . u n . d e
honda	h o n . d a
babs	b a b . s eu
yahya	ya . h i . a
eugenio	e . u . j e . n i . o
peron	p e . l o n
hewitt	h yu . i s
lucille	l u . s i l
brutus	b eu . l u . t u . s eu
vondel	p o n . d e l
duisburg	d wi . s eu . b u . l eu . k eu
serena	s e . l i . n a
horatio	h eo . l e . i . s yo
sarney	s a . l eu . n e . i
flamsteed	p eu l . l ae m . s eu . t i . d eu
hardwicke	h a . d eu . wi . k e
mahmood	m a . h eu . m u . d eu
bhutan	b u . t a n
stifter	s yu . t i . p eu . t eo
archer	a . ch eo
shepherd	s e . p eo . d eu
holberg	h o l . b e . l eu
ortelius	o . l eu . t e l . l i . u . s eu
seattle	s i . ae . t eu l
hazlitt	h ae . j eu l . l i s
cremona	k eu . l e . m o . n a
surrey	s eo . l i
malthus	m ae l . s eo . s eu
quantz	k eu . b a n . ch eu
botticelli	b o . t i . ch e l . l i
steger	s yu . t e . g eo
carothers	k ae . l eo . d eo . s eu
perkin	p eo . k i n
bast	b a . s eu . t eu
jerusalem	ye . l u . s a l . l e m
segovia	s e . g o . b i . a
casella	k a . s e l . l a
hampton	h ae m . p eu . t eo n
machiavelli	m a . k i . a . b e l . l i
hubbard	h eo . b eo . d eu
agassi	ae . g eo . s i
shoup	s yu . p eu
wolfrum	wo l . p eu . l eo m
frida	p eu . l i . d a
ortega	o . l eu . t e . g a
firestone	p a . i . eo . s eu . t o n
vazov	b a . j o . p eu
konstantin	k o n . s eu . t a n . t i n
morrissey	m o . l i . ss i
negroponte	n e . g eu . l o . p o n . t e
bellman	b e l . m a n
ely	i l . l i
lotto	l o . t o
fournier	p u . l eu . n i . e
swift	s eu . wi . p eu . t eu
brangwyn	b eu . l ae ng . g wi n
parry	p e . l i
sert	s eo . t eu
jay	j e . i
bateson	b e . i . t eu . s eu n
belfort	b e l . p o
bulgakov	b u l . g a . k o . p eu
nadar	n a . d a . l eu
gramsci	g eu . l a m . s i
montaigne	m o ng . t e . n yu
margot	m a . l eu . g o . t eu
walpole	wo l . p o l
stilwell	s eu . t i l . we l
garvey	g a . b i
milt	m i l . t eu
taft	t ae . p eu . t eu
karlgren	k a l . g eu . l e n
franks	p eu . l ae ng . k eu . s eu
hooke	h u g
shaftesbury	s yae . p eu . ch eu . b e . l i
monticelli	m o ng . t i . s e l . l i
gutierrez	g u . t i . e . l e . s eu
reed	l i . d eu
northampton	n o . s ae m . p eu . t eo n
kania	k a . n i . a
verrocchio	b e . l o . k i . o
holloway	h o l . l eo . we . i
valeri	b a l . l e . l i
slim	s eu l . l i m
rowe	l o . we
thomas	t o . m eo . s eu
saillant	s a . ya ng
bolkiah	b o l . k i . a
lang	l a ng
oursler	a . wo . s eu l . l eo
judas	yu . d a
brasilia	b eu . l a . j i l . l i . a
arturo	a . l eu . t u . l o
ibarbourou	i . b a . l eu . b u . l u
barcelona	b a . l eu . s e l . l o . n a
thayer	s e . i . eo
tijuana	t i . h u . a . n a
miami	m a . i . e . m i
gabriela	g a . b eu . l i . e l . l a
santer	s a ng . t e . l eu
valera	b a l . l e . l a
woodworth	u . d eu . wo . s eu
wolfe	u l . p eu
mathilde	m a . t i l . d eu
orange	o . l a ng . ye
semenov	s e . m yo . n o . p eu
goes	g u . s eu
reinach	l a . i . n a . h eu
roussel	l u . s e l
pitcairn	p i s . k e . eo n
meany	m i . n i
baty	b a . t i
tuvalu	t u . b a l . l u
escoffier	e . s eu . k o . p i . e
dowling	d a . u l . l i ng
kowalski	k o . wa l . s eu . k i
wegener	b e . g e . n eo
donnay	d o . n e
garrett	g a . l e . t eu
hall	h o l
asser	a . s e . l eu
kern	k eo n
manger	m ae ng . g eo
anfinsen	a n . p i n . s eu n
walt	wo l . t eu
lorenzen	l o . l e n . j e n
arjun	a . j u n
barrymore	b e . l i . m o . eo
ratzinger	l a . ch i ng . g eo
nekrasov	n e . k eu . l a . s o . p eu
yassin	ya . s i n
welty	we l . t i
orel	o . l e l
kaunda	k a . u n . d a
cochrane	k o . k eu . l eo n
chapman	ch ae . p eu . m eo n
schiller	s i l . l eo
chopra	ch o . p eu . l a
merriam	m e . l i . eo m
tamara	t a . m a . l a
crawford	k eu . l o . p eo . d eu
aldanov	a l . d a . n o . p eu
proudhon	p eu . l u . d o ng
varro	b a . l o
pippin	p i . p i n
erich	e . l i . h i
carlson	k a l . s eu n
kennan	k e . n eo n
gabrielle	g a . b eu . l i . e l
lindgren	l i n . d eu . g eu . l e n
olga	o l . g a
sawyer	s o . i . eo
habib	h a . b i . b eu
pidgeon	p i . j eo n
anaheim	ae . n eo . h a . i m
christie	k eu . l i . s eu . t i
thebes	t e . b e
blakeslee	b eu l . l e . i . k eu . s eu l . l i
thornton	s o n . t eu n
featherstone	p i . d eo . s eu . t o n
frederick	p eu . l e . d eu . l i g
hawkins	h o . k i n . s eu
toma	t o . m a
cornforth	k o n . p o . s eu
lucie	l u . s i
arnaud	a . l eu . n o
renard	l eu . n a . l eu
matthew	m a . t ae
lorenz	l o . l e n . ch eu
omaha	o . m a . h a
michie	m i . ch i . e
zaragoza	s a . l a . g o . s a
hyndman	h a . i n . d eu . m eo n
hue	wi . e
ribeiro	l i . b e . i . l u
champaigne	s a ng . p a . n yu
guayaquil	g wa . ya . k i l
raman	l a . m a n
weygand	b e . g a ng
bouton	b u . t o ng
gibbons	g i . b eo n . s eu
valla	b a l . l a
stodola	s eu . t o . d o . l a
barrera	b a . l e . l a
wolff	b o l . p eu
gavin	g ae . b i n
ruska	l u . s eu . k a
hutton	h eo . t eo n
valente	b a l . l e n . t e
heath	h i . s eu
guinea	g i . n i
garnet	g a . a . n e s
clementi	k eu l . l e . m e n . t i
zimbabwe	j i m . b a . b eu . we
angola	a ng . g o l . l a
marit	m a . l i . t eu
burdin	b eo . d i n
gautier	g o . t i . e
bowdler	b o . d eu l . l eo
johnnie	j o . n i
calais	k a l . l e
denny	d e . n i
entebbe	e n . t e . b e
conway	k o n . we . i
elman	e l . m eo n
argentina	a . l eu . h e n . t i . n a
basso	b a . s o
gayoom	g a . yu m
whitelaw	h wa . i . t eu l . l o
nureyev	n u . l e . ye . p eu
hahnemann	h a . n e . m a n
hebrides	h e . b eu . l i . d i . s eu
balenciaga	b a l . l e n . s i . a . g a
hepworth	h e b . wo . s eu
grosso	g eu . l o . s o
crommelynck	k eu . l o m . l ae ng . k eu
fisher	p i . s yeo
bronte	b eu . l o n . t e
gierek	g i . e . l e . k eu
dausset	d o . s e
rolando	l o l . l a n . d o
chile	ch i l . l e
novi	n o . b i
dupuy	d wi . p yu . i
laforgue	l a . p o . l eu . g eu
treitschke	t eu . l a . i . ch i . k e
nascimento	n a . s i . m e n . t u
akron	ae . k eu . l eo n
pagano	p a . g a . n o
hobbes	h o b . s eu
heckler	h e . k eu l . l eo
jonsson	j o n . s eu n
havel	h a . b e l
saarinen	s a . l i . n e n
pam	p ae m
felder	p e l . d eo
kraus	k eu . l a . u . s eu
carpaccio	k a . l eu . p a . ch o
kolbenheyer	k o l . b e n . h a . i . eo
oskar	o . s eu . k a . l eu
bryce	b eu . l a . i . s eu
harrisburg	h ae . l i . s eu . b eo . g eu
limburg	l i m . b u . l eu . h eu
cameron	k ae . m eo . l eo n
bahrain	b a . l e . i n
mandela	m a n . d e l . l a
margarita	m a . g a . l i . t a
penny	p e . n i
junkers	yu ng . k eo . s eu
warga	wa . g a
ansermet	a ng . s e . l eu . m e
roberta	l o . b eo . t a
stokowski	s eu . t o . k o . p eu . s eu . k i
trevor	t eu . l e . b eo
cervantes	s e . l eu . b a n . t e . s eu
emery	e . m eo . l i
pisa	p i . s a
belgium	b e l . g i . e
golgi	g o l . j i
delta	d e l . t a
gil	g i l
marian	m a . l i . a n
waltari	b a l . t a . l i
labuan	l a . b u . a n
sacramento	s ae . k eu . l a . m e n . t o
mendes	m e n . d i . s eu
flesch	p eu l . l e . s wi
sutherland	s eo . d eo l . l ae n . d eu
simonov	s i . m o . n o . p eu
dawson	d o . s eu n
ute	u . t eu
gneist	g eu . n a . i . s eu . t eu
proctor	p eu . l o g . t eo
mariana	m a . l i . a . n a
oswald	o . s eu . b a l . t eu
burrows	b eo . l o . u . j eu
senna	s e . n a
rosemary	l o . j eu . m a . l i
emanuel	e . m a . n u . e l
freitas	p eu . l e . i . t a . s eu
vesaas	b e . s o . s eu
veen	b i n
ob	o . b eu
dembinski	d e m . b i n . s eu . k i
howells	h a . u . eo l . s eu
boz	b o . j eu
basra	b a . s eu . l a
arbuzov	a . l eu . b u . j o . p eu
sardinia	s a . l eu . d i . n i . a
lucien	l wi . s i . ae ng
tito	t i . t o
hilbert	h i l . b e . l eu . t eu
constant	k o ng . s eu . t a ng
hartle	h a . t eu l
devi	d e . b i
wiener	wi . n eo
rockingham	l a g . k i ng . h ae m
das	d a . s eu
port_of_spain	p o . t eu . o . b eu . s eu . p e . i n
wohlfahrt	b o l . p a . l eu . t eu
rembrandt	l e m . b eu . l a n . t eu
gupta	g u b . t a
fiori	p i . o . l i
morgagni	m o . l eu . g a . n i
ness	n e . s eu
medici	m e . d i . ch i
gramme	g eu . l a m
west	we . s eu . t eu
tagore	t a . g o . l eu
lim	l i m
caen	k a ng
doran	d o . l eo n
cesar	s e . s a . l eu
bondi	b o n . d i
gaye	g e . i
kollwitz	k o l . b i . ch eu
haeckel	h e . k e l
wetzel	we . j e l
jolly	j o l . l i
hilary	h i l . l eo . l i
rameau	l a . m o
ralston	l ae l . s eu . t eo n
enrique	e n . l i . k e
westinghouse	we . s eu . t i ng . h a . u . s eu
boye	b o . wi . e
fillmore	p i l . m o . eo
francesco	p eu . l a n . ch e . s eu . k o
verdier	b e . l eu . d i . e
herschel	h eo . s yeo l
cronin	k eu . l o . n i n
holland	h o l . l a n . d eu
attwood	ae . t u . d eu
athabasca	ae . s eo . b ae . s eu . k a
dedekind	d e . d e . k i n . t eu
winch	wi n . ch i
ossola	o . s o l . l a
sen	s e n
eckermann	e . k eo . m a n
halls	h o l . s eu
seles	s e l . l e . s eu
bath	b a . s eu
vries	b eu . l i . s eu
jill	j i l
anand	a . n a n . d eu
daniel	d a . n i . e l
atlanta	ae . t eu l . l ae n . t a
garfield	g a . p i l . d eu
lauder	l o . d eo
mildred	m i l . d eu . l e . d eu
quin	k wi n
hibernia	h a . i . b eo . n i . a
howard	h a . wo . d eu
bok	b o g
hendrickson	h e n . d eu . l i g . s eu n
henze	h e n . ch e
surikov	s u . l i . k o . p eu
dee	d i
epstein	e b . s eu . t a . i n
banville	b a ng . b i l
carey	k e . l i
utrillo	yu . t eu . l i l . l o
gerhardt	g e . l eu . h a . l eu . t eu
latham	l e . i . d a m
galtung	g a l . t u ng
tiepolo	t i . e . p o l . l o
craven	k eu . l e . i . b eu n
winchester	wi n . ch e . s eu . t eo
celso	s e . l eu . s o
ferrante	p e . l a n . t eu
paz	p a . s eu
langley	l ae ng . g eu l . l i
volpi	b o l . p i
daugherty	d o . h eo . t i
columbia	k eo l . l eo m . b i . a
cottbus	k o s . b u . s eu
lubbers	l wi . b e . l eu . s eu
carla	k a l . l a
ludovic	l u . d o . b i
guericke	g e . l i . k e
ingarden	i ng . g a . l eu . d e n
eileen	a . i l . l i n
sudermann	j u . d eo . m a n
loren	l o . l e n
manfred	m a n . p eu . l e . t eu
lorraine	l o . l e n
bui	b u . i
schliemann	s yu l . l i . m a n
rudolph	l u . d o l . p eu
wellington	we l . l i ng . t eo n
zeman	j e . m a n
namibia	n a . m i . b i . a
hannah	h ae . n a
cadillac	k ae . d i l . l a g
dalton	d a l . t o n
wilder	wa . i l . d eo
borrow	b o . l o
sherman	s yeo . m eo n
bogarde	b o . g a . d eu
sophia	s o . p i . a
paxton	p ae g . s eu . t eo n
carvalho	k a . l eu . b a l . l yo
elder	e l . d eo
guzman	g u . j eu . m eo n
worcester	u . s eu . t eo
lai	l a . i
baku	b a . k u
avenarius	a . b e n . n a . l i . u . s eu
denzel	d e n . j eo l
belfast	b e l . p a . s eu . t eu
miller	m i l . l eo
lille	l i l
hanslick	h a n . s eu l . l i . k eu
frost	p eu . l o . s eu . t eu
moneta	m o . n e . t a
cadiz	k a . d i . s eu
long	l o ng
eminescu	e . m i . n e . s eu . k u
dubois	d wi . b u . a
zimmer	ch i . m eo
braga	b eu . l a . g a
leipold	l a . i . p o l . t eu
rohmer	l o . m e . l eu
caceres	k a . s e . l e . s eu
clapton	k eu l . l ae b . t eu n
sami	s a . m i
boothroyd	b u . s eu . l o . i . d eu
gambetta	g a ng . b e . t a
harold	h ae . l eo l . d eu
forester	p o . l e . s eu . t eo
sewell	s yu . eo l
nolde	n o l . d e
kilauea	k i . l a . we . a
pire	p i . l eu
vanuatu	b a . n u . a . t u
gaston	g a . s eu . t o ng
euclid	yu . k eu l . l i . d eu
peirce	p eo . s eu
watt	wa . t eu
dollar	d a l . l eo
hauser	h a . u . j eo
bale	b e . i l
semyonov	s e . m yo . n o . p eu
yannick	ya . n i g
jonathan	j o . n eo . s eo n
kuwait	k u . we . i . t eu
resnick	l u . s eu . n i g
raven	l e . i . b eu n
williamson	wi l . l i . eo m . s eu n
carpini	k a . l eu . p i . n i
athens	a . t e . n e
siewert	s i . wo . t eu
lyell	l a . i . e l
natan	n a . t a n
brescia	b eu . l e . s i . a
gwyn	g eu . wi n
danton	d a ng . t o ng
anouilh	a . n u . i
lynn	l i n
driesch	d eu . l i . s yu
speth	s eu . p e . s eu
dagerman	d a . g e . l eu . m a n
elsie	e l . s i
trieste	t eu . l i . e . s eu . t e
cromer	k eu . l o . m eo
scholz	s yo l . ch eu
abe	a . b e
haines	h e . i n . j eu
luise	l u . i . j e
grotius	g eu . l o . t i . u . s eu
schubert	s yu . b e . l eu . t eu
boer	b o . eo
dunlop	d eo n . l o b
hassanal	h a . s a . n a l
rajiv	l a . j i . b eu
theiler	t a . i l . l eo
davidson	d e . i . b i . s eu n
luc	l wi . k eu
irina	i . l i . n a
frenchman	p eu . l a ng . s eu . i n
hastings	h e . i . s eu . t i ng . s eu
fryer	p eu . l a . i . eo
bertin	b e . l eu . t ae ng
sanchez	s a n . ch e . s eu
florence	p eu l . l o . l e n . s eu
oppert	o . p e . l eu . t eu
salgado	s a l . g a . d o
malkin	m a l . k i n
steele	s eu . t i l
palme	p a l . m e
laurencin	l o . l a ng . s ae ng
armstrong	a m . s eu . t eu . l o ng
carducci	k a . l eu . d u . ch i
canberra	k ae n . b eo . l a
tod	t o . d eu
salinger	s ae l . l i n . j eo
william	wi l . l i . eo m
aileen	e . i l . l i n
casanova	k a . s a . n o . b a
fanon	p a . n o ng
tripoli	t eu . l i . p o l . l i
reyes	l e . i . eo . s eu
meissner	m a . i . s eu . n eo
minnie	m i . n i
michaux	m i . s yo
rousseau	l u . s o
rouse	l o . j eu
piscator	p i . s eu . k a . t o . l eu
jerome	j e . l o m
courtney	k o . t eu . n i
gullstrand	g u l . s eu . t eu . l a n . d eu
lisa	l i . s a
eastwood	i . s eu . t eu . u . d eu
raj	l a . j i
jaspers	ya . s eu . p eo . s eu
ferris	p e . l i . s eu
bonham	b o n . h ae m
millard	m i l . l eo . d eu
epirus	e . p i . l u . s eu
gianni	j a n . n i
karen	k a . l e n
cunningham	k eo . n i ng . eo m
jonson	j o n . s eu n
dern	d eo n
reppe	l e . p e
stead	s eu . t e . d eu
phillpotts	p i l . p o . ch eu
hodge	h o . j i
schmid	s yu . m i . d eu
doria	d o . l i . a
guiana	g i . a . n a
rashid	l a . s i . d eu
morice	m o . l i . s eu
rasputin	l a . s eu . p u . t i n
gaul	g o l
radbruch	l a . d eu . b eu . l u . h eu
hodel	h o . d eu l
quigley	k wi . g eu l . l i
littleton	l i . t eu l . t eo n
harvard	h a . b eo . d eu
bodin	b o . d ae ng
spiegel	s eu . p i . g e l
eurasia	yu . l a . s i . a
forsyth	p o . s a . i . s eu
frances	p eu . l ae n . s i . s eu
bunin	b u . n i n
marsha	m a . s ya
maia	m a . i . a
pires	p i . l e . s eu
guam	g wa m
stern	s yu . t e . l eu n
vera	b e . l a
nairobi	n a . i . l o . b i
alf	a l . p eu
stevens	s eu . t i . b eu n . s eu
swanson	s eu . wa n . s eu n
edwin	e . d eu . wi n
staffordshire	s eu . t ae . p eo . d eu . s yeo
luciano	l u . ch i . a . n o
bari	b a . l i
uwe	u . b e
wallach	b a l . l a . h eu
maas	m a . s eu
norman	n o . l eu . m a n
nafis	n a . p i . s eu
lucy	l u . ss i
herbart	h e . l eu . b a . l eu . t eu
weir	wi . eo
giancarlo	j i . a n . k a . l eu l . l o
janine	j e . n i n
tristan	t eu . l i . s eu . t a ng
clint	k eu l . l i n . t eu
philippe	p i l . l i . p eu
adler	a . d eu l . l eo
abdus	a b . d u . s eu
dixon	d i g . s eu n
kirsten	k eo . s eu . t i n
petrie	p i . t eu . l i
herren	h e . l e n
mckenzie	m ae g . k e n . j i
kimmel	k i . m e l
korngold	k o n . g o l . d eu
tyutchev	t yu . ch e . p eu
ann	ae n
geijer	ye . i . ye . l eu
hepburn	h e b . b eo n
karina	k a . l i . n a
benghazi	b e ng . g a . j i
bruch	b eu . l u . h eu
romano	l o . m a . n o
joshua	j o . s u . a
baldung	b a l . d u ng
lorrain	l o . l ae ng
geissler	g a . i . s eu l . l eo
smirnov	s eu . m i . l eu . n o . p eu
herb	h eo . b eu
funke	p u ng . k e
terrace	t e . l a . s eu
painter	p e . i n . t eo
segantini	s e . g a n . t i . n i
melanchthon	m e l . l a n . h i . t o n
senefelder	j e . n e . p e l . d eo
tennyson	t e . n i . s eu n
salt	s o l . t eu
eichmann	a . i . h i . m a n
iglesias	i . g eu l . l e . s i . a . s eu
gerolamo	j e . l o l . l a . m o
waugh	wo
holley	h o l . l i
philippa	p i l . l i . p a
bakunin	b a . k u . n i n
durand	d yu . l a n . d eu
bihar	b i . h a . l eu
luxenberg	l o g . s e m . b u . l u . k eu
kari	k a . l i
israel	i . s eu . l a . e l
wedekind	b e . d e . k i n . t eu
solana	s o l . l a . n a
kekkonen	k e . k o . n e n
murry	m eo . l i
rudolf	l u . d o l . p eu
hersey	h eo . s i
kuhnau	k u . n a . u
sulla	s u l . l a
brightman	b eu . l a . i . t eu . m a n
villon	b i . yo ng
groza	g eu . l o . j a
goldin	g o l . d i n
esenin	ye . s e . n i n
darby	d a . b i
rome	l o . m a
redon	l eu . d o ng
grote	g eu . l o . t eu
svevo	s eu . b e . b o
guardini	g wa . l eu . d i . n i
martina	m a . l eu . t i . n a
hagen	h a . g e n
gaetano	g a . e . t a . n o
krupskaya	k eu . l u . p eu . s eu . k a . ya
gleizes	g eu l . l e . i . j eu
bernd	b e . l eu n . t eu
moss	m o . s eu
libya	l i . b i . a
gaultier	g o . t i . e
strasser	s eu . t eu . l a . j eo
rafik	l a . p i . k eu
kline	k eu l . l a . i n
adonis	a . d o . n i . s eu
darling	d a l . l i ng
philippi	b i l . l i b . b o
held	h e l . d eu
fiennes	p a . i n . j eu
meisheng	m e . i . s eo ng
kubrick	k yu . b eu . l i g
buchenwald	b u . h e n . b a l . t eu
portman	p o . t eu . m a n
renzo	l e n . j o
stokes	s eu . t o . k eu . s eu
ponce	p o n . s eu
hamel	h a . m e l
bandaranaike	b a n . d a . l a . n a . i . k e
benvenuto	b e n . b e . n u . t o
planck	p eu l . l a ng . k eu
hildebrand	h i l . d e . b eu . l a n . d eu
kenton	k e n . t eo n
liebermann	l i . b e . l eu . m a n
simons	s a . i . m eo n . j eu
aurelia	o . l e l . l i . a
negro	n i . g eu . l o
gneisenau	g eu . n a . i . j e . n a . u
burton	b eo . t eo n
shoemaker	s yu . m e . i . k eo
haris	h a . l i . s eu
godin	g o . d i n
timberlake	t i m . b eo . l e . i . k eu
karel	k a . l e l
singleton	s i ng . g eu l . t o n
staub	s eu . t a . u b
padua	p a . d u . a
mesopotamia	m e . s o . p o . t a . m i . a
ricken	l i . k e n
dessau	d e . s a . u
queen	k wi n
steinberger	s eu . t a . i n . b eo . g eo
bolivia	b o l . l i . b i . a
canning	k ae . n i ng
hess	h e . s eu
bean	b i n
lujo	l u . j o
white	h wa . i . t eu
galilei	g a l . l i l . l e . i
donna	d o . n a
david	d a . b i . d eu
sitwell	s i . t eu . we l
nouakchott	n u . a g . s yo . t eu
iceland	a . i . s eu l . l a n . d eu
braine	b eu . l e . i n
kokoschka	k o . k o . s yu . k a
royce	l o . i . s eu
binding	b i n . d i ng
elizabeth	e l . l i . j a . b e . s eu
reger	l e . g eo
elisabeth	e l . l i . j a . b e . s eu
duclos	d wi . k eu l . l o
brundtland	b eu . l u n . t eu l . l a n
denver	d e n . b eo
malta	m o l . t a
ghana	g a . n a
bishkek	b i . s yu . k e . k eu
jade	j e . i . d eu
sologub	s o l . l o . g u . p eu
tulasne	t u l . l a . s eu n
vijay	b i . j e . i
balzac	b a l . j a . k eu
feynman	p a . i n . m eo n
cutler	k eo . t eu l . l eo
dodson	d a s . s eu n
peano	p e . a . n o
ricou	l i . k o . u
winston	wi n . s eu . t eo n
vince	b i n . s eu
cochin	k o . ch i n
dopsch	d o . p eu . s yu
salomon	s a l . l o . m o n
carlisle	k a l . l a . i l
bertil	b e . l eu . t i l
fechner	p e . h i . n eo
longfellow	l o ng . p e l . l o
klondike	k eu l . l o n . d a . i . k eu
rahal	l a . h o . l eu
ingram	i ng . g eu . l ae m
pacino	p a . ch i . n o
vincent	b ae ng . s a ng
sholes	s yo l . s eu
helga	h e l . g a
marc	m a . l eu . k eu
morrison	m o . l i . s eu n
besson	b e . s o ng
hutten	h u . t e n
baum	b a . u m
helm	h e l . l eu m
osgood	o . s eu . g u s
massachusetts	m ae . s a . ch u . s e . ch eu
heidegger	h a . i . d e . g eo
lionel	l i . o . n e l
hanon	a . n o ng
mulliken	m eo l . l i . k eo n
korn	k o n
novgorod	n o . b eu . g o . l o . t eu
tolkien	t o l . k i n
escobar	e . s eu . k o . b a
niamey	n i . a . m e
henderson	h e n . d eo . s eu n
benson	b e n . s eu n
victorien	b i g . t o . l i . ae ng
canada	k ae . n a . d a
navarra	n a . b a . l a
torres	t o . l e . s eu
panama	p a . n a . m a
arnauld	a . l eu . n o
alicia	ae l . l i . s ya
bacchus	b a . k eo . s eu
hay	h e . i
fisk	p i . s eu . k eu
gooch	g u . ch i
sharp	s ya . p eu
gago	g a . g o
caldwell	k o l . d eu . we l
rush	l eo . s i
christina	k eu . l i . s eu . t i . n a
humboldt	h u m . b o l . t eu
nico	n i . k o
hedin	h e . d i n
bruin	b eu . l wi n
jorge	j o . l eu . j e
milo	m i l . l o
alexander	a l . l e g . s a n . d eo
ibrahim	i . b eu . l a . h i m
cumberland	k eo m . b eo l . l ae n . d eu
diane	d a . i . a n
card	k a . d eu
sassoon	s eo . s u n
videla	b i . d e l . l a
salman	s a l . m a n
brynner	b eu . l i . n eo
maimon	m a . i . m o n
smetana	s eu . m e . t a . n a
mikoyan	m i . k o . ya n
kirkland	k eo . k eu l . l eo n . d eu
petipa	p e . t i . p a
balch	b o l . ch i
drago	d eu . l a . g o
patterson	p ae . t eo . s eu n
hefner	h e . p eu . n eo
lindsey	l i n . j i
heckscher	h e . k eu . s ye . l eu
smeaton	s eu . m i . t eo n
oaxaca	o . a g . s a . k a
athos	e . i . s o . s eu
coronado	k o . l o . n a . d o
dacca	d a . k a
mauritz	m a . u . l i . ch eu
irma	i . l eu . m a
ferreira	p e . l e . i . l a
octave	o g . t a . b eu
bradstreet	b eu . l ae . d eu . s eu . t eu . l i . t eu
gertsen	g e . l eu . ch e n
colette	k o l . l e . t eu
chevrolet	s i . b o . l e
daryl	d ae . l i l
daudet	d o . d e
vittorini	b i . t o . l i . n i
noble	n o . b eu l
veblen	b e . b eu l . l eo n
gwen	g eu . we n
serrano	s e . l a . n o
freeman	p eu . l i . m eo n
geoff	j e . p eu
kabul	k a . b u l
fogel	p o . g e l
zagreb	j a . g eu . l e . b eu
weil	b a . i l
levy	l e . b i
bergson	b e . l eu . g eu . s o ng
gerda	g e . l eu . d a
wassily	b a . s i l . l i
eddie	e . d i
wilma	wi l . m a
melville	m e l . b i l
shapiro	s ya . p i . l o
verdi	b e . l eu . d i
cummings	k eo . m i ng . s eu
nicolaus	n i . k o l . l a . u . s eu
kalamazoo	k a l . l a . m a . j u
uccello	u . ch e l . l o
sampson	s ae m . s eu n
claudius	k eu l . l a . u . d i . u . s eu
sigourney	s i . g eo . n i
bailey	b e . i l . l i
eckardt	e . k a . l eu . t eu
angelika	a ng . g e l . l i . k a
mbasogo	eu m . b a . s o . g o
lyttelton	l i . t eu l . t eo n
belcher	b e l . ch eo
wilton	wi l . t eo n
duke	d yu . k eu
buckle	b eo . k eu l
burroughs	b eo . l o . s eu
manila	m a . n i l . l a
juma	j u . m a
piazzi	p i . a . ch i
ortiz	o . l eu . t i . s eu
rogers	l o . j eo . s eu
apollinaire	a . p o l . l i . n e . l eu
denise	d e . n i . j eu
pigou	p i . g u
makin	m a . k i n
tourneur	t eo . n eo
ciano	ch i . a . n o
idris	i . d eu . l i . s eu
frakes	p eu . l e . i . k eu
mei	m e . i
fenton	p e n . t eu n
lesseps	l e . s e b . s eu
geulincx	g oe l . l i ng . k eu . s eu
hardin	h a . d i n
stafford	s eu . t ae . p o . d eu
poliziano	p o l . l i . ch i . a . n o
escudero	e . s eu . k u . d e . l o
evans	e . b eo n . s eu
murillo	m u . l i . yo
blackwell	b eu l . l ae g . we l
gosset	g o . s e s
empson	e m . p eu . s eu n
giono	j i . o . n o
massinger	m ae . s i n . j eo
ryan	l a . i . eo n
strickland	s eu . t eu . l i g . l ae n . d eu
madge	m e . j wi
betty	b e . t i
herrera	h e . l e . l a
radu	l a . d u
prince	p eu . l i n . s eu
bougainville	b u . g eo n . b i l
covington	k o . b i ng . t eo n
biya	b i . ya
roger	l o . j eo
vignola	b i . n yo l . l a
guillermo	g i . ye . l eu . m o
barnett	b a . n e s
broadbent	b eu . l o . d eu . b e n . t eu
maya	m a . ya
koerner	k oe . l eu . n eo
laval	l a . b a l
espinosa	e . s eu . p i . n o . j a
weiner	wa . i . n eo
melchior	m e l . k i . o . l eu
shestov	s ye . s eu . t o . p eu
boveri	b o . b e . l i
wohlgemut	b o l . g e . m u . t eu
garang	g a . l a ng
geoffrey	j o . p eu . l i
arden	a . d eu n
jourdan	j o . d a n
erik	e . l i . k eu
worthy	wo . d i
linda	l i n . d a
muller	m eo l . l eo
emma	e . m a
loewi	l oe . b i
wilm	b i l . l eu m
clough	k eu l . l a . p eu
marilyn	m e . l i l . l i n
pride	p eu . l a . i . d eu
hanna	h a n . n a
waigel	b a . i . g e l
murmansk	m u . l eu . m a n . s eu . k eu
erving	eo . b i ng
huch	h u . h eu
toffler	t o . p eu l . l eo
brunat	b eu . l wi . n a
gaitskell	g e . i . ch eu . k e l
chaumont	s yo . m o ng
austen	o . s eu . t i n
lockett	l o . k e s
queens	k wi n . j eu
nelson	n e l . s eu n
strachey	s eu . t eu . l e . i . ch i
blanco	b eu l . l a ng . k o
mendelssohn	m e n . d e l . s eu . j o n
gompers	g o m . p eo . s eu
weierstrass	b a . i . eo . s yu . t eu . l a . s eu
runge	l u ng . g e
ajaccio	a . j a g . s i . o
alice	e l . l i . s eu
natalia	n a . t a l . l i . a
kraepelin	k eu . l e . p e l . l i n
alecsandri	a l . l e g . s a n . d eu . l i
simmons	s i . m eo n . s eu
monroy	m o n . l o . i
matthews	m ae . s yu . s eu
burman	b eo . m a
nicolson	n i . k eo l . s eu n
erasmus	e . l a . s eu . m u . s eu
aziz	a . j i . j eu
lanning	l ae . n i ng
green	g eu . l i n
brasseur	b eu . l a . s oe . l eu
lehmbruck	l e m . b eu . l u . k eu
jozef	yo . j e . p eu
tate	t e . i . t eu
johansen	yo . h a n . s e n
osbert	o . s eu . b eo . t eu
sula	s u . l a
giaever	g i . e . b eo
lyman	l a . i . m eo n
herrington	h e . l i ng . t eo n
pierluigi	p i . e . l eu l . l u . i . j i
provence	p eu . l o . b a ng . s eu
louis	l u . i . s eu
uli	u l . l i
reines	l a . i . n eo . s eu
schumpeter	s yu m . p e . t eo
alfons	a l . p o n . s eu
friedrich	p eu . l i . d eu . l i . h i
brandenburg	b eu . l a n . d e n . b u . l eu . k eu
noel	n o . e l
doris	d o . l i . s eu
andre	a n . d eu . l e
riesman	l i . s eu . m eo n
russ	l eo . s eu
warburg	b a . l eu . b u . l eu . k eu
campbell	k ae m . b e l
jens	ye n . s eu
bamberger	b ae m . b eo . g eo
burke	b eo . k eu
attenborough	ae . t eu n . b eo . l eo
finsen	p i n . s e n
alston	e l . s eu . t o n
port_au_prince	p o . l eu . t o . p eu . l ae ng . s eu
duisenberg	d o . i . s e n . b e . l eu . h eu
sheila	s wi l . l a
bowyer	b a . u . eo
ware	we . eo
ilona	i l . l o . n a
montfort	m o ng . p o . l eu
wolfowitz	u l . p o . wi . ch eu
kachalov	k a . ch a l . l o . p eu
howe	h a . u
waterloo	wo . t eo l . l u
auerbach	a . u . eo . b a . h eu
chamson	s ya ng . s o ng
landers	l ae n . d eo . s eu
berry	b e . l i
gayle	g e . i l
toller	t o l . l eo
fritsch	p eu . l i . ch i
gigli	j i l . l i
copenhagen	k o . p e n . h a . g e n
flores	p eu l . l o . l e . s eu
aloysius	a l . l u . a . s i . u . s eu
savinkov	s a . b i n . k o . p eu
monmouth	m o n . m eo . s eu
aguirre	a . g i . l e
rudiger	l u . d i . g eo
walsh	wa l . s i
rex	l e g . s eu
behrman	b e . eo . m eo n
hagerstown	h e . g eo . s eu . t a . u n
alexis	a l . l e g . s i
tan	t a n
wicksell	b i g . s e l
hunter	h eo n . t eo
albany	o l . b eo . n i
kansas	k ae n . j a . s eu
shield	s wi l . d eu
balfour	b a l . p u . eo
heintze	h a . i . t eu . ch e
russel	l eo . s e l
masefield	m e . i . s eu . p i l . d eu
penelope	p e . n e l . l o . p e
gantt	g ae n . t eu
almond	a l . m o n . d eu
bissau	b i . s a . u
kallas	k a l . l a . s eu
horton	h o . t eu n
ferrara	p e . l a . l a
damon	d e . i . m eo n
roseau	l o . j o
limerick	l i . m eo . l i g
dirac	d i . l ae g
teresa	t e . l e . s a
makarov	m a . k a . l o . p eu
burma	b eo . m a
schiaparelli	s eu . k i . a . p a . l e l . l i
schulz	s yu l . ch eu
lewin	l e . b i n
carnot	k a . l eu . n o
jamaica	j a . m e . i . k a
johnstown	j o n . s eu . t a . u n
khan	k a n
lise	l i . j e
detroit	d i . t eu . l o . i . t eu
schwabe	s yu . b a . b e
singh	s i ng
welhaven	b e l . h a . b e n
dudley	d eo . d eu l . l i
house	h a . u . s eu
straub	s eu . t eu . l a . u . b eu
freemantle	p eu . l i . m ae n . t eu l
herz	h e . l eu . ch eu
raabe	l a . b e
lansing	l ae n . s i ng
rios	l i . o . s eu
most	m o . s eu . t eu
yemen	ye . m e n
larson	l a . s eu n
arber	a . l eu . b eo
browning	b eu . l a . u . n i ng
ahern	eo . h eo n
aleksandr	a l . l e g . s a n . d eu . l eu
stephen	s eu . t i . b eu n
joule	j u l
kusch	k u . s i
porto_novo	p o . l eu . t o . n o . b o
huysmans	wi . s eu . m a ng . s eu
wrangel	b eu . l a ng . g e l
lawrence	l o . l e n . s eu
syse	s wi . s e
roland	l o l . l a n . d eu
dmitry	d eu . m i . t eu . l i
mogadishu	m o . g a . d i . s yu
berkshire	b a . k eu . s yeo
key	k e . i
vasari	b a . s a . l i
columbus	k o l . l eo m . b eo . s eu
grau	g eu . l a . u
kendrick	k e n . d eu . l i g
titulescu	t i . t u l . l e . s eu . k u
munich	m wi n . h e n
pedro	p e . d eu . l o
mel	m e l
huggins	h eo . g i n . s eu
poussin	p u . s ae ng
weizman	b a . i . ch eu . m a n
leila	l e . i l . l a
hesse	h e . s e
zwingli	ch eu . b i ng . g eu l . l i
ross	l o . s eu
molnar	m o l . n a
rabin	l a . b i n
lasky	l ae . s eu . k i
phyllis	p i l . l i . s eu
billings	b i l . l i ng . s eu
walesa	b a . we n . s a
hadley	h a . d eu l . l i
spohr	s yu . p o . eo
witt	wi s
rosetta	l o . j e . t a
wernicke	b e . l eu . n i . k e
updike	eo b . d a . i . k eu
despiau	d e . s eu . p i . o
california	k ae l . l i . p o . n i . a
zaire	j a . i . l eu
gilbert	g i l . b eo . t eu
rivlin	l i . b eu l . l i n
ohio	o . h a . i . o
catilina	k a . t i l . l i . n a
lardner	l a . d eu . n eo
freyssinet	p eu . l e . i . s i . n e s
rosetti	l o . s e . t i
medhurst	m e . d eu . h eo . s eu . t eu
dallapiccola	d a l . l a . p i . k o l . l a
jackson	j ae g . s eu n
lamour	l a . m u . l eu
bethlehem	b e . d eu l . l e . h e m
ana	a . n a
hodgson	h o . j i . s eu n
ecker	e . k eo
jacobo	h a . k o . b o
james	j e . i m . s eu
langbein	l ae ng . b a . i n
justin	j eo . s eu . t i n
jim	j i m
servais	s e . l eu . b e
chapsal	s ya . p eu . s a l
claude	k eu l . l a . u . d eu
beets	b e . ch eu
viking	b a . i . k i ng
bourget	b u . l eu . j e
rauschenbusch	l a . u . s yeo n . b u . s i
livius	l i . b i . u . s eu
hasan	h a . s a n
sigrid	s i . g eu . l i . d eu
camara	k a . m a . l a
paddy	p ae . d i
agostino	a . g o . s eu . t i . n o
moreno	m o . l e . n o
uganda	u . g a n . d a
baird	b e . eo . d eu
judith	yu . d i . t eu
pfleiderer	p eu l . l a . i . t e . l eo
santos	s a n . t u . s eu
valadon	b a l . l a . d o ng
berchem	b eo . ch e m
mark	m a . l eu . k eu
ouedraogo	u . e . d eu . l a . o . g o
bonds	b o n . j eu
phillip	p i l . l i b
scheele	s ye l . l e
sabina	s a . b i . n a
ramon	l a . m o n
chaptal	s ya . p eu . t a l
whitman	h wi . t eu . m eo n
baruch	b a . l u . k eu
muris	m yu . l i . s eu
reuchlin	l o . i . h i l . l i n
cope	k o . p eu
gossen	g o . s e n
carmichael	k a . m a . i . k eu l
rudy	l u . d i
darcy	d a . s i
wartburg	b a . l eu . t eu . b u . l eu . k eu
patrice	p a . t eu . l i . s eu
tanguy	t a ng . g i
wenders	b e n . d eo . s eu
yangon	ya ng . g o n
paloma	p a l . l o . m a
pepys	p i . p eu . s eu
tyson	t a . i . s eu n
farley	p a l . l i
ted	t e . d eu
silone	s i l . l o . n e
pushkin	p u . s i . k i n
neruda	n e . l u . d a
grotewohl	g eu . l o . t e . b o l
ricky	l i . k i
morel	m o . l e l
melton	m e l . t o n
harrow	h ae . l o
dube	d u . b e
borgia	b o . l eu . j a
bukharin	b u . h a . l i n
neff	n e . p eu
michael	m i . s we l
windaus	b i n . d a . u . s eu
enders	e n . d eo . s eu
donnie	d o . n i
nukualofa	n u . k u . a l . l o . p a
walter	wo l . t eo
oran	o . l a ng
ion	i . o n
stockhausen	s yu . t o . k eu . h a . u . j e n
ord	o . d eu
hopp	h o . p eu
kamu	k a . m u
kearsley	k i . eo . s eu l . l i
hobart	h o . b a . t eu
ronald	l o . n eo l . d eu
munk	m u ng . k eu
heuss	h o . i . s eu
borchardt	b o . l eu . h a . l eu . t eu
shamir	s ya . m i . l eu
gottlieb	g o . t eu l . l i . b eu
languedoc	l a ng . g eu . d o . k eu
elliott	e l . l i . eo s
crispin	k eu . l i . s eu . p i . n u . s eu
weinheber	b a . i n . h e . b eo
birch	b eo . ch i
pajou	p a . j u
ivanov	i . b a . n o . p eu
picabia	p i . k a . b i . a
pontryagin	p o n . t eu . l ya . g i n
ephraim	e . p eu . l a . i m
beckett	b e . k e . t eu
liebmann	l i . p eu . m a n
wiesbaden	b i . s eu . b a . d e n
donen	d o . n eo n
vivian	b i . b i . a n
sale	s a . l eu
schelling	s ye l . l i ng
carolina	k ae . l o l . l a . i . n a
ignatiev	i . g eu . n a . t i . ye . p eu
georgi	g e . o . l eu . g i
farina	p a . l i . n a
humperdinck	h u m . p eo . d i ng . k eu
napolitano	n a . p o l . l i . t a . n o
buswell	b eo . s eu . we l
biden	b a . i . d eu n
nelly	n e l . l i
lomonosov	l o . m o . n o . s o . p eu
frits	p eu . l i . ch eu
hassel	h a . s e l
caird	k e . eo . d eu
willy	b i l . l i
luke	l u g . k eu
cartagena	k a . l eu . t a . h e . n a
woolley	u l . l i
andrade	a n . d eu . l a . d e
darmstadt	d a . l eu m . s yu . t a . t eu
bangemann	b a ng . g e . m a n
paula	p o l . l a
workman	wo . k eu . m ae n
durham	d eo . l eo m
bendix	b e n . d i g . s eu
kiowa	k a . i . o . wa
queneau	k eu . n o
benedikt	b e . n e . d i g . t eu
maillol	m a . yo l
wight	wa . i . t eu
benedict	b e . n e . d i g . t eu
winifred	wi n . p eu . l e . d eu
angelica	a n . j e l . l i . k a
alberti	a l . b e . l eu . t i
navarro	n a . b a . l o
dia	d i . a
dole	d o l
hales	h e . i l . j eu
mader	m a . d eo
sherriff	s ye . l i . p eu
hargreaves	h a . g eu . l i . b eu . s eu
albin	a l . b i n
ryder	l a . i . d eo
zasulich	j a . s u l . l i . ch i
kemble	k e m . b eu l
sammy	s ae . m i
hench	h e n . ch i
benedetto	b e . n e . d e . t o
esaias	e . s a . i . a . s eu
davisson	d e . i . b i . s eu n
gillian	j i l . l i . eo n
les	l e . s eu
konrad	k o n . l a . t eu
karakhan	k a . l a . h a n
brink	b eu . l i ng . k eu
mercator	m e . l eu . k a . t o . l eu
schweizer	s yu . b a . i . ch eo
jennifer	j e . n i . p eo
pearl	p eo l
fourier	p u . l i . e
aragon	a . l a . g o n
judea	yu . d ae
rietveld	l i . t eu . b e l . t eu
suffolk	s eo . p eo g
gras	g eu . l a . s eu
constance	k o n . s eu . t a n . s eu
orr	o . eo
leonov	l e . o . n o . p eu
kate	k e . i . t eu
jameson	j e . i m . s eu n
benda	b a ng . d a
sydenham	s i . d eu . n eo m
fernandez	p e . l eu . n a n . d e . s eu
hieronymus	h i . e . l o . n i . m u . s eu
riga	l i . g a
olsen	o l . s eu n
antonina	a n . t o . n i . n a
gaskell	g ae . s eu . k e l
gamba	g a m . b a
vane	b e . i n
heim	h a . i m
crean	k eu . l i n
pakistan	p a . k i . s eu . t a n
eduard	e . d u . a . l eu . t eu
modena	m o . d e . n a
amin	a . m i n
newlands	n yu . l ae n . j eu
lino	l i . n o
olson	o l . s eu n
baccelli	b a . s e l . l i
petropavlovsk	p e . t eu . l o . p a . b eu . l o . s eu . k eu
herman	h eo . m eo n
filippo	p i l . l i . p o
seurat	s oe . l a
honecker	h o . n e . k eo
fiji	p i . j i
lyn	l i n
barber	b a . b eo
tippett	t i . p e s
bainbridge	b e . i n . b eu . l i . j i
cueva	k u . e . b a
latvia	l a . t eu . b i . a
abernethy	ae . b eo . n e . s i
seaga	s i . g a
skoda	s eu . k o . d a
pons	p o ng . s eu
heck	h e g
wimbledon	wi m . b eu l . d eo n
scheidemann	s ya . i . d e . m a n
lenormand	l eu . n o . l eu . m a ng
kohler	k o l . l eo
gonzales	g o n . s a l . l e . s eu
samir	s a . m i . l eu
abadan	a . b a . d a n
beyer	b a . i . eo
laughlin	l o . p eu l . l i n
strang	s eu . t eu . l ae ng
habakkuk	h a . b a g . g u g
renn	l e n
renault	l eu . n o
ohana	o . h a . n a
severini	s e . b e . l i . n i
razin	l a . j i n
laban	l a . b a n
baghdad	b a . g eu . d a . d eu
del	d e l
congo	k o ng . g o
dorchester	d o . ch e . s eu . t eo
jarvis	j a . b i . s eu
harnack	h a . l eu . n a . k eu
felice	p e l . l i . s eu
spadolini	s eu . p a . d o l . l i . n i
enver	e n . b e . l eu
holbein	h o l . b a . i n
walden	we l . d eo n
adel	a . d e l
whitaker	h wi . t ae . k eo
wolfram	wo l . p eu . l a m
morelli	m o . l e l . l i
alfonso	a l . p o n . s o
chausson	s yo . s o ng
mexico	m e g . s i . k o
overbeck	o . b eo . b e . k eu
prager	p eu . l a . g eo
patty	p ae . t i
page	p e . i . j i
pamela	p a . m e l . l a
chad	ch a . d eu
grillparzer	g eu . l i l . p a . l eu . ch eo
kundt	k u n . t eu
bayer	b a . i . eo
arizona	ae . l i . j o . n a
ilse	i l . s eu
dominguez	d o . m i ng . g e . j eu
gilbreth	g i l . b eu . l e . s eu
labrador	l ae . b eu . l a . d o
souza	s u . j a
oistrakh	o . i . s eu . t eu . l a . h eu
verhoeven	b eo . h o . b e n
brent	b eu . l e n . t eu
aaron	a . l o n
jonah	yo . n a
bellevue	b e l . l e . b yu
foote	p u . t eu
brett	b eu . l e . t eu
dresden	d eu . l e . s eu . d e n
kann	k a n
angeles	e n . j e l . l e . s eu
villani	b i l . l a . n i
achilles	a . k i l . l e . s eu
sombart	j o m . b a . l eu . t eu
turk	t eo . k i
guillaumin	g i . yo . m ae ng
morena	m o . l e . n a
sloan	s eu . l o n
hitchcock	h i . ch i . k o g
wilhelm	b i l . h e l . l eu m
calder	k o l . d eo
nezval	n e . j eu . b a l
freytag	p eu . l a . i . t a . k eu
lasse	l a . s e
montessori	m o n . t e . s o . l i
poynting	p o . i n . t i ng
ethiopia	e . t i . o . p i . a
tommy	t o . m i
astrakhan	a . s eu . t eu . l a . h a n
bentinck	b e n . t i ng . k eu
annemarie	a . n e . m a . l i
karachi	k a . l a . ch i
pulitzer	p yu l . l i . ch eo
adalbert	a . d a l . b e . l eu . t eu
josh	j o . s i
skopje	s eu . k o . p e
percival	p eo . s i . b eo l
dolce	d o l . ch e
godwin	g o . d eu . wi n
magellan	m a . j e l . l a n
vincent	b i n . s e n . t eu
essex	e . s i g . s eu
mario	m a . l i . o
mano	m a . n o
koster	k o . s eu . t eo
tehran	d e . h e . l a n
lennon	l e . n o n
pufendorf	p u . p e n . d o . l eu . p eu
gregory	g eu . l e . g o . l i
penderecki	p e n . d e . l e . ch eu . k i
filip	p i l . l i . p eu
warden	wa . d eu n
babeuf	b a . b oe . p eu
colombia	k o l . l o m . b i . a
pickford	p i g . p eo . d eu
hawke	h o . k eu
maclaren	m ae . k eu l . l ae . l eo n
borodin	b o . l o . d i n
gossec	g o . s e . k eu
guido	g u . i . d o
pauline	p o l . l i n
kilby	k i l . b i
jascha	ya . s ya
vigeland	b i . g e l . l a n
junker	yu ng . k eo
souter	s u . t eo
shostakovich	s yo . s eu . t a . k o . b i . ch i
kumar	k u . m a . l eu
lynch	l i n . ch i
gilman	g i l . m eo n
atal	a . t a l
elizabethe	e l . l i . j a . b e . s eu
degas	d eu . g a
soupault	s u . p o
jodelle	j o . d e l
kuno	k u . n o
lynne	l i n
koller	k o l . l eo
juliette	j wi l . l i . e . t eu
neverov	n e . b e . l o . p eu
ahmadabad	a . m a . d a . b a . d eu
amon	a . m o n
easton	i . s eu . t eo n
clifford	k eu l . l i . p eo . d eu
gjellerup	g i . e l . l e . l u . p eu
capote	k eo . p o . t i
novak	n o . b a g
berenson	b e . l eo n . s eu n
henle	h e n . l e
elisa	e l . l i . s a
foster	p o . s eu . t eo
kirchner	k i . l eu . h i . n eo
dali	d a l . l i
wilde	wa . i l . d eu
kogan	k o . g a n
philips	p i l . l i b . s eu
dewar	d yu . eo
dev	d e . b eu
charles	ch a l . s eu
reggie	l e . j i
rivas	l i . b a . s eu
marie	m a . l i
fonvizin	p o n . b i . j i n
wolf	b o l . p eu
haley	h a l . l i
monk	m eo ng . k eu
kellogg	k e l . l o . g eu
cardin	k a . d i n
cyrankiewicz	ch i . l a n . k i . e . b i . ch i
fulbright	p u l . b eu . l a . i . t eu
johansson	yo . h a n . s o n
barmen	b a . l eu . m e n
alba	a l . b a
millikan	m i l . l i . k eo n
bonaparte	b o . n a . p a . l eu . t eu
diocletianus	d i . o . k eu l . l e . t i . a . n u . s eu
ochab	o . h a . p eu
macedonia	m a . k e . d o . n i . a
dick	d i g
rasmussen	l a . s eu . m u . s e n
germain	j e . l eu . m ae ng
severin	s e . b eo . l i n
benn	b e n
fisch	p i . s yeo
recorde	l e . k o . d eu
tucci	t u . ch i
spaak	s eu . p a . k eu
gori	g o . l i
quebec	k we . b e g
carson	k a . s eu n
delhi	d e l . l i
gustave	g u . s eu . t a . b eu
morgenthau	m o . g e n . ss o
boden	b o . d e n
jerrold	j e . l eo l . d eu
marcel	m a . l eu . s e l
luca	l u . k a
erbakan	e . l eu . b a . k a n
dnepropetrovsk	d eu . n e . p eu . l o . p e . t eu . l o . p eu . s eu . k eu
bongo	b o ng . g o
arghezi	a . l eu . g e . j i
bunche	b eo n . ch i
achim	a . s i m
heijermans	h a . i . ye . l eu . m a n . s eu
kroner	k eu . l o . n e
auer	a . u . eo
teitelbaum	t a . i . t e l . b a . u m
slovenia	s eu l . l o . b e . n i . a
yvonne	i . b o n . n eu
chic	ch i g
vance	b eo n . s eu
lance	l ae n . s eu
julio	h u l . l i . o
mayo	m e . i . o
moore	m u . eo
gesner	g e . s eu . n eo
tussaud	t eo . s o
hamza	h a m . j a
darius	d a . l i . u . s eu
sor	s o . l eu
nernst	n e . l eu n . s eu . t eu
amalia	a . m a l . l i . a
matisse	m a . t i . s eu
vavilov	b a . b i l . l o . p eu
longford	l o ng . p o . d eu
welles	we l . s eu
roos	l u . s eu
vaga	b a . g a
kuhlau	k u l . l a . u
dunant	d wi . n a ng
elgar	e l . g a
gail	g e . i l
brown	b eu . l a . u n
nicolae	n i . k o l . l a . e
alan	ae l . l eo n
chesterton	ch e . s eu . t eo . t eo n
galsworthy	g o l . j eu . wo . d i
billie	b i l . l i
fuller	p u l . l eo
boucher	b a . u . ch eo
cellini	ch e l . l i . n i
scala	s eu . k a l . l a
mali	m a l . l i
downing	d a . u . n i ng
stefani	s eu . t e . p a . n i
bassett	b a . s e s
alonso	a l . l o n . s o
ramuz	l a . m wi
neill	n i l
wolfers	wo l . p eo . s eu
mengelberg	m e ng . g e l . b e . l eu . k eu
gilmore	g i l . m o . eo
dolphin	d o l . p i n
boll	b o l
molly	m o l . l i
gordimer	g o . d i . m eo
londonderry	l eo n . d eo n . d e . l i
byelorussia	b e l . l o . l u . s i
halma	h ae l . m eo
hume	h yu m
polk	p o . k eu
bluff	b eu l . l eo . p eu
pigalle	p i . g a l
valerie	b a l . l e . l i
locke	l o g
dianne	d a . i . ae n
lander	l ae n . d eo
groom	g eu . l u m
bjorn	b i . yo n
mumford	m eo m . p eo . d eu
gamble	g ae m . b eu l
taussig	t a . u . s i . g eu
mandalay	m a n . d a l . l e . i
garbo	g a . l eu . b o
mignon	m i . n yo ng
nike	n a . i . k i
william	b i l . l i . a m
lytton	l i . t eo n
olander	o l . l ae n . d eo
bose	b o . s eu
brenan	b eu . l e . n eo n
fano	p a . n o
thomsen	t o m . s e n
middleton	m i . d eu l . t eo n
ara	a . l a
dayton	d e . i . t eo n
pete	p i . t eu
khadem	k a . d e m
lily	l i l . l i
pacheco	p a . ch e . k o
gertrude	g eo . t eu . l u . d eu
himmler	h i m . l eo
monika	m o . n i . k a
viotti	b i . o . t i
snowden	s eu . n o . d eu n
hamlet	h ae m . l i s
malden	m o l . d e n
markov	m a . l eu . k o . p eu
ezer	e . j e . l eu
kreisler	k eu . l a . i . s eu l . l eo
kaplan	k ae . p eu l . l a n
algeria	a l . j e . l i
wheatstone	h wi . t eu . s eu . t o n
pitman	p i . t eu . m eo n
merkel	m e . l eu . k e l
kaverin	k a . b e . l i n
dyer	d a . i . eo
litt	l i s
townsend	t a . u n . s e n . d eu
oud	o . d eu
macmillan	m ae g . m i l . l a n
marr	m a . l eu
branco	b eu . l a ng . k o
cassini	k a . s i . n i
eijkman	e . i . k eu . m a n
rauf	l a . u . p eu
gallio	g a l . l i . o
mendoza	m e n . d o . j a
lombardi	l o m . b a . l eu . d i
lewis	l u . i . s eu
gentile	j e n . t i l . l e
cantor	k a n . t o . eo
bandiera	b a n . d i . e . l a
manuel	m a . n u . e l
ferdinand	p e . l eu . d i . n a n . d eu
paine	p e . i n
pullman	p u l . m eo n
elie	e l . l i
sudbury	s eo . d eu . b e . l i
wergeland	b e . l eu . g e l . l a n
carmel	k a . l eu . m e l
chicago	s i . k a . g o
brazil	b eu . l a . j i l
hendrix	h e n . d eu . l i g . s eu
diallo	d i . ae l . l o
cale	k e . i l
vermeer	b e . l eu . m e . l eu
dugan	d yu . g eo n
lum	l eo m
appleton	ae . p eu l . t eo n
evelyn	e . b eo l . l i n
petri	p e . t eu . l i
kummer	k u . m eo
rushdie	l u . s yu . d i
binet	b i . n e
garcia	g a . l eu . s i . a
dreyfus	d eu . l e . p wi . s eu
monet	m o . n e
hogarth	h o . g a . s eu
jacobson	j e . i . k o b . s eu n
bratislava	b eu . l a . t i . s eu l . l a . b a
gomez	g o . m e . j eu
cecil	s e . s i l
adama	a . d a . m a
knox	n o g . s eu
stan	s eu . t ae n
klaus	k eu l . l a . u . s eu
abidjan	a . b i . j a ng
honduras	h o n . d u . l a . s eu
bingham	b i ng . h ae m
sully	s wi l . l i
caputo	k a . p u . t o
farouk	p a . l u . k eu
pechstein	p e . h i . s yu . t a . i n
abel	a . b e l
goethals	g o . s eo l . s eu
russell	l eo . s e l
nicolai	n i . k o l . l a . i
connor	k o . n eo
igor	i . g o . l eu
koepp	k o . p eu
verde	b e . l eu . d e
vader	b e . i . d eo
navarre	n a . b a . l eu
boerner	b oe . l eu . n eo
moira	m o . i . l a
laski	l ae . s eu . k i
appalachia	a . p a . l a . ch i . a
espinoza	e . s eu . p i . n o . j a
vaughan	b o n
thomasius	t o . m a . j i . u . s eu
broch	b eu . l o . h eu
feuchtwanger	p o . i . h i . t eu . b a ng . g eo
steven	s eu . t i . b eu n
ashcroft	ae . s yu . k eu . l o . p eu . t eu
stalin	s eu . t a l . l i n
gatto	g a . t o
judd	j eo . d eu
kaj	k a . i
lima	l i . m a
gundolf	g u n . d o l . p eu
schroeder	s yu . l o . d eo
cates	k e . i . ch eu
palembang	p a l . l e m . b a ng
syria	s i . l i . a
fitch	p i . ch i
eggleston	e . g eu l . s eu . t eo n
tweed	d e . d o
foggia	p o . j i . a
liszt	l i . s eu . t eu
ferdianand	p e . l eu . d i . n a n . d eu
toni	t a . n i
edmund	e . d eu . m eo n . d eu
angelo	a n . j e l . l o
gerhard	g e . l eu . h a . l eu . t eu
kahn	k a n
poiseuille	p o . a . j eu . i . yu
pottinger	p o . t i n . j eo
deniz	d e . n i . j eu
artur	a . t eo
lev	ye . p eu
hartmann	h a . l eu . t eu . m a n
ilya	i l . l i . ya
sousa	s u . j a
rumsey	l eo m . j i
elliot	e l . l i . eo . t eu
stimson	s eu . t i m . s eu n
kayser	k a . i . j eo
rosas	l o . s a . s eu
scharnhorst	s ya . l eu n . h o . l eu . s eu . t eu
davy	d e . i . b i
bob	b a b
kuropatkin	k u . l o . p a s . k i n
gama	g a . m a
bloomington	b eu l . l u . m i ng . t eo n
pate	p e . i . t eu
yul	yu l
doha	d o . h a
cowan	k o . wa n
clara	k eu l . l a . l a
muirhead	m yu . eo . h e . d eu
annika	a . n i . k a
oberon	o . b e . l o n
barrett	b a . l e s
parma	p a . l eu . m a
hilton	h i l . t eo n
luanda	l u . a n . d a
savannah	s eo . b ae . n eo
houdon	u . d o ng
lassus	l a . s u . s eu
faraday	p ae . l eo . d i
turgenev	t u . l eu . g e . n e . p eu
fischer	p i . s yeo
garner	g a . n eo
kitchener	k i . ch i . n eo
mafeking	m a . p e . k i ng
norwich	n o . l i . ch i
jose	j o . j e
gambia	g a m . b i . a
fahim	p a . h i m
gusou	g u . ss eo . u
etienne	e . t i . e n
einthoven	e . i n . t eu . h o . b e n
monroe	m eo n . l o
grass	g eu . l a . s eu
donne	d eo n
pavese	p a . b e . s e
bruckner	b eu . l u . k eu . n eo
kenya	k e . n ya
lawson	l o . s eu n
eugene	yu . j i n
weiyi	we . i . i
ante	a n . t e
griffin	g eu . l i . p i n
rivera	l i . b e . l a
pollock	p o l . l o g
cordelia	k o . d e l . l i . a
bessemer	b e . s e . m eo
marcuse	m a . l eu . k u . j e
casals	k a . s a l . s eu
busoni	b u . s o . n i
kovalenko	k o . b a l . l e n . k o
rous	l a . u . s eu
tatiana	t a . t i . a . n a
maciel	m a . s i . e l
maccoby	m ae . k o . b i
chamai	ch a . m a . i
blackett	b eu l . l ae . k i s
steffens	s yu . t e . p e n . s eu
ethan	i . d eo n
shapley	s yae . p eu l . l i
lloyd	l o . i . d eu
florida	p eu l . l o . l i . d a
krueger	k eu . l u . g eo
paul	b a . u l
mannheim	m a n . h a . i m
nouri	n u . l i
davids	d a . b i . ch eu
wit	b i . t eu
iain	i . eo n
colby	k o l . b i
herrick	h e . l i g
dunn	d eo n
muscat	m u . s eu . k a . t eu
godard	g o . d a . l eu
zamboni	j a m . b o . n i
dixit	d i g . s i . t eu
aron	a . l o ng
kepler	k e . p eu l . l eo
lindberg	l i n . d eu . b eo . g eu
dukas	d wi . k a
linus	l i . n u . s eu
ockham	o . k eo m
ian	i . eo n
arminius	a . l eu . m i . n i . u . s eu
anchorage	ae ng . k eo . l i . j i
todor	t o . d o . l eu
agatha	a . g a . s a
leone	l e . o . n e
serlio	s e . l eu l . l i . o
lamb	l ae m
jeanne	j a n
lesotho	l e . s o . t o
cavaignac	k a . b e . n ya . k eu
fowles	p a . u l . j eu
branting	b eu . l a n . t i ng
saxon	s ae g . s eu n
gros	g eu . l o
cassel	k a . s e l
pretoria	p eu . l i . t o . l i . a
nipkow	n i b . k o
dod	d o . d eu
cech	ch e . k eu
backhaus	b a . k eu . h a . u . s eu
greco	g eu . l e . k o
egorov	ye . g o . l o . p eu
ulrich	u l . l i . h i
everett	e . b eo . l e s
serge	s e . l eu . g e
laussedat	l o . s e . d a
alfa	a l . p a
kentucky	k e n . t eo . k i
abell	a . b e l
celeste	s e l . l e . s eu . t eu
westergaard	we . s eu . t eo . g a . d eu
zoran	j o . l a n
nikolaeva	n i . k o l . l a . e . b a
florian	p eu l . l o . l i . a n
beaverbrook	b i . b eo . b eu . l u g
isherwood	i . s yeo . u . d eu
prescott	p eu . l e . s eu . k eo s
stoney	s eu . t o . n i
gaia	g a . i . a
murat	m u . l a . t eu
bernier	b e . l eu . n i . e
tura	t u . l a
danilo	d a . n i l . l o
capri	k a . p eu . l i
slam	s eu l . l ae m
dino	d i . n o
uribe	u . l i . b e
marin	m a . l ae ng
hoare	h o . eo
gomes	g o . m e . s eu
wand	b a n . t eu
huston	h yu . s eu . t eo n
tom	t o m
haldane	h o l . d e . i n
baekeland	b e . i . k eu l . l ae n . d eu
kathmandu	k a . t eu . m a n . d u
erickson	e . l i g . s eu n
gardner	g a . d eu . n eo
tobias	t o . b i . a . s eu
eisenstadt	a . i . j e n . s yu . t a . t eu
noether	n oe . t eo
dunsany	d eo n . s e . i . n i
giuliani	j u l . l i . a . n i
victor	b i g . t eo
marino	m a . l i . n o
vida	b i . d a
moretti	m o . l e . t i
cassell	k a . s e l
heron	h e . l o n
harte	h a . t eu
manchester	m ae n . ch e . s eu . t eo
regina	l i . j a . i . n a
montes	m o n . t e . s eu
cesarotti	ch e . s a . l o . t i
solovyov	s o l . l o . b i . yo . p eu
klemperer	k eu l . l e m . p e . l eo
beatrice	b e . a . t eu . l i . ch e
khachaturyan	h a . ch a . t u . l i . a n
mueller	m yu l . l eo
westwood	we . s eu . t eu . u . d eu
xenakis	k eu . s e . n a . k i . s eu
carnegie	k a . n e . g i
boussinesq	b u . s eu . n e . s eu . k eu
mahendra	m a . h e n . d eu . l a
lamartine	l a . m a . l eu . t i n
brandon	b eu . l ae n . d eo n
garnier	g a . l eu . n i . e
groethuysen	g eu . l e . t wi . j ae ng
gromyko	g eu . l o . m i . k o
trier	t eu . l i . eo
heseltine	h e . s eu l . t a . i n
summers	s eo . m eo . s eu
maupertuis	m o . p e . l eu . t wi . i
bianchi	b i . a ng . k i
hunt	h eo n . t eu
jaffna	j a . p eu . n a
pott	p o . t eu
goldsmith	g o l . d eu . s eu . m i . s eu
bataille	b a . t a . yu
richardson	l i . ch eo . d eu . s eu n
memphis	m e m . p i . s eu
athanasius	a . t a . n a . s i . u . s eu
kondo	k o n . d o
santana	s a n . t a . n a
serra	s e . l a
kigali	k i . g a l . l i
zambezi	j a m . b e . j i
kautsky	k a . u . ch eu . k i
burney	b eo . n i
leskov	l e . s eu . k o . p eu
hubble	h eo . b eu l
catalonia	k a . t a l . l o . n i . a
laud	l o . d eu
beckenbauer	b e . k e n . b a . u . eo
buxtehude	b u g . s eu . t e . h u . d e
henkel	h e n . k e l
din	d i n
bartlett	b a . t eu l . l i s
maloney	m eo l . l o . n i
maastricht	m a . s eu . t eu . l i . h i . t eu
ferre	p e . l e
ahmad	a . m a . d eu
powys	p o . u . i . s eu
richet	l i . s ye
fortune	p o . ch eo n
isabelle	i . j a . b e l
clapeyron	k eu l . l a . p e . l o ng
pino	p i . n o
richie	l i . ch i
sennett	s e . n e s
basie	b e . i . s i
sanaa	s a . n a
rowan	l o . eo n
jack	j ae g
klimt	k eu l . l i m . t eu
kingston	k i ng . s eu . t eo n
stipe	s eu . t i . p e
magee	m ae . g i
oceania	o . s e . a . n i . a
dart	d a . t eu
ecuador	e . k wa . d o . l eu
sakharov	s a . h a . l o . p eu
nepal	n e . p a l
bert	b e . l eu . t eu
bogota	b o . g o . t a
delibes	d eu l . l i . b eu
gracchus	g eu . l a . k u . s eu
glass	g eu l . l a . s eu
simrock	j i m . l o . k eu
floyd	p eu l . l o . i . d eu
enoch	e . n o g
olyphant	o l . l i . p eo n . t eu
leighton	l e . i . t eu n
forlani	p o l . l a . n i
dutton	d yu . t o n
poulet	p u l . l e
mendel	m e n . d e l
susie	s u . j i
edmundo	e . d eu . m o n . d eu
karim	k a . l i m
matterhorn	m a . t eo . h o . l eu n
vesuvius	b e . s u . b i . o
argento	a . l eu . j e n . t o
cresson	k eu . l e . s o ng
kosygin	k o . s i . g i n
vailland	b a . ya ng
dupleix	d wi . p eu l . l e g . s eu
anatolia	a . n a . t o l . l i . a
kirk	k eo . k eu
chahine	s ya . h i n
mitscherlich	m i . ch eo . l i . h i
aspinall	a . s eu . p i . n a l
ulrike	u l . l i . k eu
dragan	d eu . l a . g a n
moody	m u . d i
dyson	d a . i . s eu n
jobim	j o . b i m
kuznets	k u . j eu . n e . ch eu
bulgaria	b u l . g a . l i . a
elster	e l . s eu . t eo
herzog	h e . eo . ch o . k eu
oakeshott	o . k eu . s yeo . t eu
romer	l o . m eo
filipov	p i l . l i . p o . p eu
mcbride	m ae g . b eu . l a . i . d eu
bourke	b o . k eu
hawn	h o n
dan	d a n
arnhem	a . l eu n . h e m
webb	we . b eu
rwanda	l eu . wa n . d a
heckman	h e . k eu . m eo n
imbert	i m . b e . l eu . t eu
luther	l u . t eo
jessie	j e . s i
ron	l o n
julian	yu l . l i . a . n u . s eu
adolphe	a . d o l . p eu
turkmenistan	t u . l eu . k eu . m e . n i . s eu . t a n
zhdanov	j u . d a . n o . p eu
joaquim	h o . a . k i m
corbin	k o . b i n
cornell	k o . n e l
mauritius	m o . l i . s yeo . s eu
lippmann	l i . p eu . m a n
nestor	n e . s eu . t o . l eu
tashkent	t a . s yu . k e n . t eu
lissajous	l i . s a . j u
kensington	k e n . j i ng . t eo n
cochet	k o . s we
quinn	k wi n
simmons	s i . m o n . j eu
alexander	a l . l e g . s a n . d eu . l eu
kris	k eu . l i . s eu
veneziano	b e . n e . ch i . a . n o
elise	e l . l i . s eu
vouet	b u . e
altenberg	a l . t e n . b e . l eu . k eu
gudrun	g u . d eu . l u n
clouzot	k eu l . l u . j o
yale	ye . i l
alvares	a l . b a . l e . s eu
bradford	b eu . l e . d eu . p o . d eu
stevenson	s eu . t i . b eu n . s eu n
aachen	a . h e n
salzburg	j a l . ch eu . b u . l eu . k eu
ambler	ae m . b eu l . l eo
nachtigal	n a . h eu . t i . g a l
fouquet	p u . k e
neisser	n a . i . s eo
unger	u ng . g eo
orestes	o . l e . s eu . t e . s eu
heinrich	h a . i n . l i . h i
rod	l o . d eu
pavlova	p a . b eu l . l o . b a
claes	k eu l . l a . s eu
timothy	t i . m eo . s i
luisa	l u . i . j a
strauss	s yu . t eu . l a . u . s eu
erica	e . l i . k a
leszek	l e . s ye . k eu
keynes	k e . i n . s eu
reginald	l e . j eo . n eo l . d eu
mesquita	m e . s eu . k i . t a
piaf	p i . a . p eu
santorio	s a n . t o . l i . o
bernardo	b e . l eu . n a . l eu . d o
brigitte	b eu . l i . j i s
cromwell	k eu . l o m . we l
savonarola	s a . b o . n a . l o l . l a
yunis	yu . n i . s eu
annapolis	a . n a . p o l . l i . s eu
eindhoven	e . i n . t eu . h o . b e n
lucas	l u . k a . s eu
moudud	m u . d u . d eu
koen	k o . e n
nicol	n i . k o l
loy	l o . i
ozenfant	o . j a ng . p a ng
knies	k eu . n i . s eu
arkansas	a . k a n . s o
dorothy	d o . l o . s i
webster	we b . s eu . t eo
sylvain	s i l . b ae ng
fredericton	p eu . l e . d eo . l i g . t eo n
huntsman	h eo n . ch eu . m eo n
sayce	s e . i . s eu
mbabane	eu m . b a . b a . n e
bogomolov	b o . g o . m o . l o . p eu
sebastian	s eo . b ae . s eu . ch eo n
allende	a . ye n . d e
halifax	h ae l . l i . p ae g . s eu
hort	h o l . t eu
christchurch	k eu . l a . i . s eu . t eu . ch eo . ch i
peel	p i l
gaumont	g o . m o ng
batyushkov	b a . t yu . s yu . k o . p eu
noronha	n o . l o . n ya
harper	h a . p eo
calderwood	k a l . d eo . u . d eu
arce	a . l eu . s e
constantine	k o ng . s eu . t a ng . t i n
isaiah	i . s a . ya
ahn	a n
therese	t e . l e . j eu
andres	a n . d eu . l e . s eu
heidelberg	h a . i . d e l . b e . l eu . k eu
sickel	j i . k e l
jeremy	j e . l eo . m i
gurley	g eo l . l i
pupin	p u . p i n
stanton	s eu . t ae n . t eo n
ayala	a . ya l . l a
gilson	j i l . s o ng
capra	k ae . p eu . l a
ward	wo . d eu
law	l o
angell	e . i n . j eo l
bulganin	b u l . g a . n i n
montesquieu	m o ng . t e . s eu . k i . oe
perth	p eo . s eu
altissimo	a l . t i . s i . m o
lennart	l e n . n a . l eu . t eu
chandrasekhar	ch a n . d eu . l a . s e . k a . l eu
juliana	j u l . l i . a . n a
cheshire	ch e . s yeo
buber	b u . b eo
trygve	t eu . l wi . g eu . b e
mabel	m a . b e l
leoncavallo	l e . o n . k a . b a l . l o
bangladesh	b a ng . g eu l . l a . d e . s i
nash	n ae . s i
bonnard	b o . n a . l eu
marcus	m a . l eu . k u . s eu
hatton	h ae . t eu n
gregor	g eu . l e . g o . l eu
edelstein	e . d e l . s eu . t e . i n
mistral	m i . s eu . t eu . l a l
giacometti	j a . k o . m e . t i
holzer	h o l . ch eo
wood	u . d eu
sultan	s u l . t a n
odilon	o . d i l . l o ng
sardou	s a . l eu . d u
getty	g e . t i
berkeley	b a . k eu l . l i
meyerhof	m a . i . eo . h o . p eu
xie	s ye
ogburn	o . g eu . b eo n
tavares	t a . b a . l e . s eu
kiss	k i . s i
barnet	b a . n e s
eakins	e . i . k i n . s eu
violet	b a . i . o l . l e s
koch	k o . h eu
furtado	p eo l . t a . d o
bartolommeo	b a . l eu . t o l . l o m . m e . o
hamann	h a . m a n
niki	n i . k i
cheney	ch e . n i
truman	t eu . l u . m eo n
leonard	l e . o . n a . d eu
ling	l i ng
stella	s eu . t e l . l a
khalil	k a l . l i l
bo	b o
pudovkin	p u . d o . p eu . k i n
concord	k o ng . k o . d eu
eyck	e . i . k eu
antonin	a n . t o . n i n
smellie	s eu . m e l . l i
maugham	m o m
beck	b e g
connolly	k o . n eo l . l i
coubertin	k u . b e . l eu . t ae ng
fox	p o g . s eu
knut	k eu . n u . t eu
wyler	wa . i l . l eo
hahn	a n
cheddar	ch e . d eo
papini	p a . p i . n i
iberia	i . b e . l i . a
beernaert	b e . l eu . n a . l eu . t eu
gombrich	g o m . b eu . l i . ch i
sarmiento	s a . l eu . m i . e n . t o
gumplowicz	g u m . p eu l . l o . b i . ch i
suzanne	s u . j a n
ebert	e . b e . l eu . t eu
antony	a n . t o . n i
lasso	l a . s o
philippines	p i l . l i . p i n
gennady	g e n . n a . d i
nader	n e . i . d eo
lech	l e . h eu
gunnar	g u n . n a . l eu
turco	t u . l eu . k o
dines	d a . i n . s eu
ash	ae . s wi
palermo	p a l . l e . l eu . m o
re	l e
ott	o . t eu
betjeman	b e . ch eo . m eo n
nansen	n a n . s e n
hansen	h a n . s e n
tobey	t o . b i
balas	b a l . l a . s eu
ericsson	e . l i g . s eu n
babcock	b ae b . k o g
helmut	t eu
ithaca	i . t a . k a
glaspell	g eu l . l ae . s eu . p e l
giddens	g i . d eu n . s eu
harare	h a . l a . l e
gordon	g o . d eu n
woodward	u . d eu . wo . d eu
lorena	l o . l e . n a
freda	p eu . l e . d a
aden	a . d e n
wiesel	b i . s e l
kirpichnikov	k i . l eu . p i . ch i . n i . k o . p eu
beaver	b i . b eo
peary	p i . eo . l i
zajac	j a . j a . k eu
lacan	l a . k a ng
jaroslav	ya . l o . s eu l . l a . p eu
koirala	k o . i . l a l . l a
jaime	h a . i . m e
beverley	b e . b eo l . l i
itzik	i . ch i . k eu
sparks	s eu . p a g . s eu
aske	a . s eu . k e
milano	m i l . l a . n o
piaget	p i . a . j e
guardi	g wa . l eu . d i
cardenas	k a . l eu . d e . n a . s eu
schumacher	s yu . m a . h eo
kazakhstan	k a . j a . h eu . s eu . t a n
mazowiecki	m a . j o . b i . e . ch eu . k i
bion	b i . o n
henie	h e . n i
tatum	t e . i . t eo m
ibadan	i . b a . d a n
finn	p i n
patagonia	p a . t a . g o . n i . a
colin	k o l . l ae ng
rakhmaninov	l a . h eu . m a . n i . n o . p eu
batman	b ae . t eu . m ae n
commons	k o . m eo n . s eu
longchamp	l o ng . s ya ng
lahti	l a . t i
thaddeus	d a . d ae . o
kathy	k ae . s i
renner	l e . n eo
maurice	m o . l i . s eu
mang	m a ng
altman	o l . t eu . m eo n
danny	d ae . n i
klitzing	k eu l . l i . ch i ng
becky	b e . k i
huizinga	h o . i . j i ng . g a
parker	p a . k eo
arie	a . l i . e
lothian	l o . d i . eo n
mach	m a . h a
albo	ae l . b o
gertrud	g eo . t eu . l u . d eu
cindy	s i n . d i
tait	t a . i . t eu
jana	j a . n a
gallup	g ae l . l eo b
bundy	b eo n . d i
gere	g i . eo
flynn	p eu l . l i n
alec	ae l . l i g
stockholm	s eu . t o g . h o l . l eu m
purcell	p eo . s e l
beveridge	b e . b eo . l i . j i
elias	e l . l i . a . s eu
chevalier	s yu . b a l . l i . e
puente	p u . e n . t e
meitner	m a . i . t eu . n eo
jacek	ya . ch e . k eu
martinson	m a . l eu . t i n . s o n
alfred	a l . p eu . l e . d eu
scarborough	s eu . k a . b o . l o
baden	b a . d e n
lindsay	l i n . j i
temple	t e m . p eu l
praga	p eu . l a . g a
nicholson	n i . k eo l . s eu n
haarlem	h a . l eu l . l e m
emerson	e . m eo . s eu n
walton	wo l . t eo n
haig	h e . i . g eu
granit	g eu . l a . n i . t eu
prague	p eu . l a . g eu
cavendish	k ae . b eo n . d i . s i
onsager	o n . s a . g eo
coral	k o . l o l
diego	d i . e . g o
lenz	l e n . ch eu
kostov	k o . s eu . t o . p eu
silva	s i l . b a
ionesco	i . o . n e . s eu . k o
schuman	s wi . m a ng
carlos	k a . l eu l . l o . s eu
servetus	s e . l eu . b e . t u . s eu
idaho	a . i . d a . h o
hertwig	h e . l eu . t eu . b i . h i
menon	m e . n o n
frankland	p eu . l ae ng . k eu l . l ae n . d eu
skelton	s eu . k e l . t eo n
wren	l e n
baade	b a . d e
pompidou	p o ng . p i . d u
adam	a . d a m
barnaby	b a . l eu . n a . b i
ostade	o . s eu . t a . d e
chopin	s yo . p ae ng
smollett	s eu . m o l . l e s
pretorius	p eu . l e . t o . l i . u . s eu
fay	p e . i
missouri	m i . j u . l i
arias	a . l i . a . s eu
georg	g e . o . l eu . g eu
ceylon	s i l . l o n
capone	k a . p o . n e
chauncey	ch e n . s i
vespucci	b e . s eu . p u . ch i
nathalie	n a . t a l . l i
mahmoud	m a . m u . d eu
volgograd	b o l . g o . g eu . l a . d eu
cox	k o g . s eu
rana	l a . n a
schleiden	s yu l . l a . i . d e n
kroemer	k eu . l o . m eo
asquith	ae . s eu . k wi . s eu
verona	b e . l o . n a
jansky	j ae n . s eu . k i
ingvar	i ng . b a . l eu
aguascalientes	a . g wa . s eu . k a l . l i . e n . t e . s eu
versailles	b e . l eu . s a . yu
begin	b e . g i n
saunders	s eo n . d eo . s eu
issac	a . i . j a g
michelson	m a . i . k eo l . s eu n
maguire	m ae g . g wa . i . eo
nadine	n e . i . d i n
franco	p eu . l a ng . k o
desiderius	d e . s i . d e . l i . u . s eu
joachim	yo . a . k i m
pio	p i . o
busch	b u . s yu
martindale	m a . t i n . d e . i l
philadelpia	p i l . l a . d e l . p i . a
starr	s eu . t a
bosco	b o . s eu . k o
kok	k o . k eu
calvin	k a l . b ae ng
victoria	b i g . t o . l i . a
maga	m a . g a
boris	b o . l i . s eu
butler	b eo . t eu l . l eo
hutchinson	h eo . ch i n . s eu n
emmanuel	e . m a . n wi . e l
hemingway	h e . m i ng . we . i
mandeville	m ae n . d eo . b i l
shirley	s yeo l . l i
middlesex	m i . d eu l . s e g . s eu
jane	j e . i n
klinger	k eu l . l i ng . g eo
spengler	s yu . p e ng . g eu l . l eo
jaipur	j a . i . p u . l eu
blake	b eu l . l e . i . k eu
iacocca	a . i . eo . k o . k a
richelieu	l i . s yu l . l i . oe
thorne	ss o n
tyndale	t i n . d eu l
dorian	d o . l i . a n
nicosia	n i . k o . s i . a
tunis	t wi . n i . s eu
hus	h u . s eu
eccles	e . k eu l . s eu
benedetti	b e . n e . d e . t i
chaplin	ch ae . p eu l . l i n
samantha	s a . m a n . d a
parkes	p a g . s eu
ariel	a . l i . e l
peeters	p e . t eo . s eu
eigen	a . i . g e n
buch	b u . h eu
stanford	s eu . t ae n . p eo . d eu
ancona	a n . k o . n a
forster	p o . s eu . t eo
gaspard	g a . s eu . p a . l eu
meyerbeer	m a . i . eo . b e . eo
bengt	b e ng . t eu
dion	d i . o ng
cohan	k o . h ae n
simi	s i . m i
carrera	k a . l e . l a
coleman	k o l . m ae n
butenandt	b u . t e . n a n . t eu
joe	j o
kazan	k a . j a n
titchener	t i . ch i . n eo
piston	p i . s eu . t eo n
kisangani	k i . s a ng . g a . n i
lubin	l u . b i n
escher	e . s yeo
estrada	e . s eu . t eu . l a . d a
terborch	t e . l eu . b o . l eu . h i
ripley	l i . p eu l . l i
edison	e . d i . s eu n
vivaldi	b i . b a l . d i
wycliffe	wi . k eu l . l i . p eu
sverdrup	s eu . b e . l eu . d eu . l u . p eu
pauli	p a . u l . l i
madeira	m a . d e . i . l a
capuana	k a . p u . a . n a
hessen	h e . s e n
libby	l i . b i
warsaw	b a . l eu . s ya . b a
hayes	h e . i . s eu
swinburne	s eu . wi n . b eo n
sean	s yo n
billy	b i l . l i
monique	m o . n i . k eu
hazard	h ae . j eo . d eu
theresa	t e . l e . s a
randall	l ae n . d a l
todd	t o . d eu
mitra	m i . t eu . l a
aston	ae . s eu . t eo n
joseph	yo . s e b
cattell	k eo . t e l
ferguson	p eo . g eo . s eu n
markowitz	m a . k o . wi . ch eu
simic	s i . m i . ch i
orson	o . s eo n
weinberger	wa . i n . b eo . g eo
verlaine	b e . l eu l . l e n
basel	b a . j e l
kevin	k e . b i n
eckhart	e . k eu . h a . l eu . t eu
roebuck	l o . b eo g
brahm	b eu . l a m
napoleon	n a . p o l . l e . o ng
disney	d i . j eu . n i
judah	yu . d a
gregg	g eu . l e . g eu
devonshire	d e . b eo n . s yeo
brook	b eu . l u g
mindy	m i n . d i
wali	wa . l i
spada	s eu . p a . d a
vernet	b e . l eu . n e
barros	b ae . l o . s eu
offenbach	o . p e n . b a . h eu
bizet	b i . j e
hearn	h o n
honghai	h u ng . h a . i
antoni	a n . t o . n i
keiser	k a . i . j eo
elmer	e l . m eo
lenard	l e . n a . l eu . t eu
bryullov	b eu . l yu l . l o . p eu
colgate	k o l . g e . i . t eu
newton	n yu . t eo n
acs	ae g . s eu
brassens	b eu . l a . s a ng . s eu
sid	s i . d eu
nahum	n a . h u m
ganges	g ae n . j i . s eu
massimo	m a . s i . m o
antananarivo	a n . t a . n a . n a . l i . b o
waley	we . i l . l i
wissler	wi . s eu l . l eo
gisela	j i . j e l . l a
giuseppe	j u . s e . p e
ibsen	i b . s e n
hilty	h i l . t i
dickens	d i . k i n . j eu
barth	b a . l eu . t eu
symonds	s i . m eo n . j eu
everson	e . b eo . s eu n
ljubljana	l yu . b eu l . l ya . n a
handler	h ae n . d eu l . l eo
spranger	s yu . p eu . l a ng . g eo
habermas	h a . b eo . m a . s eu
federico	p e . d e . l i . k o
manuela	m a . n u . e l . l a
krzysztof	k eu . s i . s yu . t o . p eu
ontario	o n . t a . l i . o
katz	k a . ch eu
tiselius	t i . s e l . l i . u . s eu
ring	l i ng
asher	a . s e l
gajdusek	g a . i . d yu . s e g
dubrovnik	d u . b eu . l o . b eu . n i . k eu
flaherty	p eu l . l a . eo . t i
rehnquist	l e n . k wi . s eu . t eu
hidalgo	i . d a l . g o
nowak	n o . wo . k eu
furmanov	p u . l eu . m a . n o . p eu
wisconsin	wi . s eu . k o n . s i n
sarah	s a . l a
tran	t eu . l a n
theodore	t e . o . d o . l eu
sobrero	s o . b eu . l e . l o
foerster	p oe . l eu . s eu . t eo
jung	yu ng
concepcion	k o n . s e b . s i . o n
montenegro	m o n . t e . n e . g eu . l o
manzoni	m a n . ch o . n i
amanda	a . m a n . d a
edinburgh	e . d eu n . b eo . l eo
fromentin	p eu . l o . m a ng . t ae ng
iris	i . l i . s eu
helen	h e l . l e n
kimberley	k i m . b eo l . l i
bojan	b o . ya n
naiman	n a . i . m a n
tansley	t ae n . s eu l . l i
tarawa	t a . l a . wa
aldo	a l . d o
morris	m o . l i . s eu
joost	yo . s eu . t eu
heyerdahl	h e . wi . e . l eu . d a l
jeanette	j i . n e s
wislicenus	b i . s eu l . l i . ch e . n u . s eu
norfolk	n o . p eo g
ryzhkov	l i . s yu . k o . p eu
cicero	k i . k e . l o
pelegrin	p e l . l e . g eu . l i n
brunel	b eu . l u . n e l
joanne	j o . ae n
addington	ae . d i ng . t eo n
hebel	h e . b e l
sandler	s a n . d eu l . l e . l eu
merriman	m e . l i . m eo n
isola	i . s o l . l a
leo	l e . o
vertov	b e . l eu . t o . p eu
ivory	a . i . b o . l i
prior	p eu . l a . i . eo
daniels	d ae . n i . eo l . s eu
hilda	h i l . d a
male	m a l . l i
ballard	b a l . l a . d eu
grandi	g eu . l a n . d i
susan	s u . j a n
mauser	m o . j e . l eu
rosset	l o . s e . t eu
dublin	d eo . b eu l . l i n
pachelbel	p a . h e l . b e l
packard	p ae g . k eo . d eu
lean	l i n
herring	h e . l i ng
picasso	p i . k a . s o
evelyn	i . b e l . l i n
zorn	s o . l eu n
lamprecht	l a m . p eu . l e . h i . t eu
will	wi l
noyce	n o . i . s eu
penrose	p e n . l o . s eu
hunker	h a n . k a
welsh	we l . s wi
jidda	j i . d a
horkheimer	h o . l eu . k eu . h a . i . m eo
norah	n o . l a
laird	l e . eo . d eu
johanna	yo . h a . n a
tonga	t o ng . g a
fibiger	p i . b i . g e . l eu
pandora	p a n . d o . l a
tallis	t ae l . l i . s eu
bron	b eu . l o n
gephardt	g e . p a . t eu
arp	a . l eu . p eu
demeter	d e . m e . t e . l eu
djilas	j i l . l a . s eu
fallopius	p a l . l o . p i . u . s eu
helmholtz	h e l . l eu m . h o l . ch eu
kohlrausch	k o l . l a . u . s yu
cleve	k eu l . l e . b e
rambert	l ae m . b eo . t eu
ovechkin	o . b e . ch i . k i n
downey	d o . n i
rabinowitz	l a . b i . n o . b i . ch eu
bernoulli	b e . l eu . n u . i
anderton	a n . d eo . t o n
beddoes	b e . d o . s eu
donald	d o . n eo l . d eu
gokhale	g o . k a l . l e
boyle	b o . i l
beauchamp	b o . s ya ng
stanley	s eu . t ae n . l i
cassandre	k a . s a ng . d eu . l eu
jacobus	ya . k o . b wi . s eu
sanger	s ae ng . eo
bothe	b o . t e
mondriaan	m o n . d eu . l i . a n
keri	k e . l i
loftus	l o . p eu . t eo . s eu
claxton	k eu l . l e g . s eu . t eo n
persson	p e . l eu . s o n
ramos	l a . m o . s eu
bidwell	b i . d eu . we l
benny	b e . n i
steinbeck	s eu . t a . i n . b e g
ethan	i . s eo n
copernicus	k o . p e . l eu . n i . k u . s eu
ravel	l a . b e l
maksim	m a g . s i m
abuja	a . b u . j a
coolidge	k u l . l i . j i
langland	l ae ng . g eu l . l eo n . d eu
driver	d eu . l a . i . b eo
segni	s e . n i
holmes	h o m . s eu
lacombe	l a . k o m
sabin	s e . i . b i n
joffre	j o . p eu . l eu
quaid	k we . i . d eu
vladimir	b eu l . l a . d i . m i . l eu
thorndike	s o n . d a . i . k eu
kirsch	k i . l eu . s wi
francisco	p eu . l a n . s i . s eu . k o
kay	k e . i
hope	h o . p eu
burbank	b eo . b ae ng . k eu
castlereagh	k ae . s eu l . l e . i
virchow	p i . l eu . h o
arnim	a . l eu . n i m
baffin	b ae . p i n
duvivier	d wi . b i . b i . e
newport	n yu . p o . t eu
schongauer	s yo n . g a . u . eo
meyers	m e . i . eo . s eu
aurelio	a . u . l e l . l i . o
izquierdo	i . s eu . k i . e . l eu . d o
mack	m ae g
martine	m a . l eu . t i n
sienkiewicz	s ye ng . k i . e . b i . ch i
dent	t e n . t eu
gheorghiu	g e . o . l eu . g yu
wallis	wi l . l i . s eu
canetti	k a . n e . t i
espejo	e . s eu . p e . h o
mobile	m o . b a . i l
millet	m i l . l e
acton	ae g . t eu n
engelbert	e ng . g e l . b eo . t eu
viktor	b i g . t o . l eu
dakar	d a . k a . l eu
dover	d o . b eo
byron	b a . i . l eo n
ogilvy	o . g eu l . b i
ellison	e l . l i . s eu n
baltimore	b o l . t i . m o . eo
edith	e . d i . t eu
hasse	h a . s e
yasin	ya . s i n
pilcher	p i . ch eo
ramus	l a . m u . s eu
ravi	l a . b i
morrow	m o . l o
bausch	b a . u . s yu
pomponazzi	p o m . p o . n a . ch i
sigmund	s i . g eu . m eo n . d eu
ochirbat	o . ch i . l eu . b a . t eu
biagio	b i . a . j i . o
schmalenbach	s yu . m a l . l e n . b a . h eu
debs	d e . b eu . s eu
balboa	b a l . b o . a
kassem	k a . s e m
cortona	k o . l eu . t o . n a
cary	k ae . l i
goethe	g oe . t e
garr	g a
italy	i . t a l . l i . a
cologne	k oe l . l eu n
valletta	b a l . l e . t a
ueberweg	yu . b eo . b e g
carrie	k ae . l i
martha	m a . s ya
wells	we l . s eu
posada	p o . s a . d a
somerset	s eo . m eo . s i s
marianne	m a . l i . a n . n eu
odessa	o . d e . s a
ambrose	ae m . b eu . l o . j eu
rojas	l o . h a . s eu
goujon	g u . j o ng
combs	k o m . s eu
georgetown	j o . j i . t a . u n
fontaine	p o ng . t e n
stowe	s eu . t o
varenius	b a . l e . n i . u . s eu
galland	g a l . l a ng
cairnes	k e . eo n . s eu
gogol	g o . g o l . l i
blass	b eu . l e . s eu
evansville	e . b eo n . j eu . b i l
feuerbach	p o . i . eo . b a . h eu
connaught	k o . n eo s
liz	l i . j eu
buffon	b wi . p o ng
duncan	d eo ng . k eo n
britt	b eu . l i s
france	p eu . l a ng . s eu
lanzhan	l a n . j a n
lenoir	l eu . n u . a . l eu
huguette	wi . g e . t eu
molotov	m o l . l o . t o . p eu
frazer	p eu . l e . i . j eo
daniele	d a . n i . e l
draper	d eu . l e . i . p eo
hoffman	h o . p eu . m a n
frey	p eu . l o . i
guggenheim	g u . g e n . h a . i m
amsterdam	a m . s eu . t e . l eu . d a m
harmon	h a . m eo n
rambo	l a m . b o
sharon	s ya . l o n
sofia	s o . p i . a
choiseul	s yo . a . j u l
loos	l u . s eu
mellon	m e l . l eo n
bret	b eu . l e s
nujoma	n u . j o . m a
olbrich	o l . b eu . l i . h i
willem	b i l . l e m
wolfgang	b o l . p eu . g a ng
podolsky	p o . d o l . s eu . k i
schreker	s yu . l e . k eo
dvorak	d eu . b o . l eu . j a g
monteux	m o ng . t oe
puccini	p u . ch i . n i
teague	t i . g eu
antonescu	a n . t o . n e . s eu . k u
glazunov	g eu l . l a . j u . n o . p eu
duer	d yu . eo
oman	o . m a n
rostow	l o . s eu . t o . u
jacobi	ya . k o . b i
lorin	l o . l i n
leonor	l e . o . n o . l eu
nassau	n a . s a . u
bowles	b o l . s eu
jamal	j a . m a l
eduardo	e . d u . a . l eu . d o
buford	b eo . p o . d eu
maud	m o . d eu
niklas	n i . k eu l . l a . s eu
osman	o . s eu . m a n
wackenroder	b a . k e n . l o . d eo
butte	b yu . t eu
ashraf	a . s yu . l a . p eu
feetham	p i . s ae m
steiner	s yu . t a . i . n eo
torquato	t o . l eu . k wa . t o
bojer	b o . ye . l eu
altamira	a l . t a . m i . l a
riddick	l i . d i g
bali	b a l . l i
adolf	a . d o l . p eu
beza	b e . j a
roland	l o l . l a ng
romero	l o . m e . l o
marlene	m a . l eu l . l e . n e
asuncion	a . s u n . s i . o n
werfel	b e . l eu . p e l
rufus	l u . p eo . s eu
mickey	m i . k i
undset	u n . s e . t eu
kale	k e . i l
berlin	b e . l eu l . l i n
tischbein	t i . s yu . b a . i n
felix	p e l . l i g . s eu
granger	g eu . l e . i n . j eo
canterbury	k ae n . t eo . b e . l i
coleridge	k o l . l i . j i
crocker	k eu . l o . k eo
koenigsberger	k wi . n i . s eu . b eo . g eo
lacy	l e . i . s i
burg	b u . l eu . g eu
anson	ae n . s eu n
kursk	k u . l eu . s eu . k eu
sanderson	s ae n . d eo . s eu n
goldstein	g o l . d eu . s eu . t a . i n
bandello	b a n . d e l . l o
switzerland	s eu . wi . s eu
mandel	m ae n . d e l
gerlach	g e . l eu l . l a . h eu
heine	h a . i . n e
morocco	m o . l o . k o
hoyt	h o . i . t eu
hardie	h a . d i
laurens	l o . l a ng . s eu
peli	p e l . l i
volcker	b o l . k eo
connelly	k o . n eo l . l i
huygens	h o . i . g e n . s eu
guthrie	g u . t eu . l i
whymper	h wi m . p eo
oslo	o . s eu l . l o
narciso	n a . l eu . s i . s o
napier	n e . i . p i . eo
kram	k eu . l ae m
terra	t e . l a
guillemin	g i . yu . m ae ng
frankfort	p eu . l ae ng . k eu . p eo . t eu
rule	l a . u l
hoover	h u . b eo
constantin	k o n . s eu . t a n . t i n
staudinger	s yu . t a . u . d i ng . g eo
flemming	p eu l . l e . m i ng
wendy	we n . d i
osler	o . s eu l . l eo
attar	ae . t a
reinhold	l a . i n . h o l . t eu
aurora	a . u . l o . l a
hurt	h eo . t eu
hudson	h eo . d eu . s eu n
maxine	m ae g . s i n
neher	n e . eo
travolta	t eu . l a . b o l . t a
bettino	b e . t i . n o
mosley	m o . j eu l . l i
lilian	l i l . l i . a ng
diaz	d i . a . s eu
mischa	m i . s ya
hutchison	h eo . ch i . s eu n
priestley	p eu . l i . s eu . t eu l . l i
mutter	m u . t eo
whorf	wo . p eu
millay	m i l . l e . i
czerny	ch e . l eu . n i
kraft	k eu . l a . p eu . t eu
spener	s yu . p e . n eo
musil	m u . j i l
tennant	t e . n eo n . t eu
alton	a l . t o n
haskell	h a . s eu . k e l
murray	m a . l e
hector	h e g . t o . l eu
abbas	a . b a . s eu
ira	a . i . l a
heifetz	h a . i . p e . ch eu
albuquerque	ae l . b eo . k eo . k i
mubarak	m u . b a . l a . k eu
niebuhr	n i . b u . eo
reynolds	l e . i . n o l . j eu
valentino	b a l . l e n . t i . n o
cassin	k a . s ae ng
kalinin	k a l . l i . n i n
wyatt	wa . i . eo s
kinnear	k eo . n i . eo
geronimo	j e . l o . n i . m o
greenland	g eu . l i n . l a n . d eu
ronge	l o ng . i
webern	b e . b e . l eu n
brno	b eu . l eu . n o
maior	m a . i . o . l eu
edgar	e . d eu . g a
rourke	l u . k eu
stanislav	s eu . t a . n i . s eu l . l a . p eu
moseley	m o . j eu l . l i
rubinstein	l u . b i n . s yu . t a . i n
schlegel	s yu l . l e . g e l
kees	k i . s eu
sol	s o l
temin	t e . m i n
burger	b eo . g eo
bardeen	b a . d i n
york	yo . k eu
larsen	l a . l eu . s e n
seneca	s e . n e . k a
milan	m i l . l a . n o
skryabin	s eu . k eu . l ya . b i n
francis	p eu . l a ng . s i . s eu
toner	t o . n eo
haugland	h e . u l . l a n
prigogine	p eu . l i . g o . j i n
ingres	ae ng . g eu . l eu
caetano	kk a . e . tt a . n u
nilsson	n i l . s o n
gapon	g a . p o n
holliday	h o l . l i . d e . i
wollaston	u l . l eo . s eu . t eo n
uruguay	u . l u . g wa . i
rodriguez	l o . d eu . l i . g e . s eu
fedin	p e . d i n
fletcher	p eu l . l ae . ch eo
henry	a ng . l i
waikiki	wa . i . k i . k i
senghor	s a ng . g o . l eu
farmington	p a . m i ng . t eo n
toledo	t eo l . l i . d o
east	d o ng . b a ng
shawn	s yo n
atwood	ae . t u . d eu
pergolesi	p e . l eu . g o l . l e . s i
frankfurt	p eu . l a ng . k eu . p u . l eu . t eu
prokhorov	p eu . l o . h o . l o . p eu
brundage	b eu . l eo n . d i . j i
repin	l e . p i n
saint	s ae n . t eu
hobbema	h o . b e . m a
moldova	m o l . d o . b a
rudin	l u . d i n
buisson	b wi . s o ng
silber	s i l . b eo
rubio	l u . b i . o
brighton	b eu . l a . i . t eu n
binoche	b i . n o . s yu
wellesley	we l . j eu l . l i
pregl	p eu . l e . g eu l
fiona	p i . o . n a
jellinek	ye l . l i . n e . k eu
clearwater	k eu l . l i . eo . wo . t eo
chiesa	k i . e . s a
nazareth	n a . s a . l e s
siegel	s i . g e l
nevada	n e . b a . d a
shaginyan	s ya . g i . n ya n
salazar	s a l . l a . j a . l eu
ventura	b e n . ch yu . l a
blanc	b eu l . l a ng
veresaev	b e . l e . s a . ye . p eu
slovakia	s eu l . l o . b a . k i . a
fabry	p a . b eu . l i
arboleda	a . l eu . b o l . l e . d a
sanz	s a n . s eu
groth	g eu . l o . t eu
michelet	m i . s yu l . l e
dave	d e . i . b eu
prishvin	p eu . l i . s yu . b i n
soutine	s u . t i n
lot	l o s
cajori	k a . j o . l i
bessarabia	b e . s a . l a . b i . a
kaiser	k a . i . j eo
anthony	a n . s o . n i
raphael	l a . p a . e l
sinai	s i . n a . i
pinheiro	p i . n e . i . l o
bayreuth	b a . i . l o . i . t eu
pople	p o . p eu l
hamburg	h a m . b u . l eu . k eu
raffles	l ae . p eu l . s eu
mayhew	m e . i . h yu
palladio	p a l . l a . d i . o
moussa	m u . s a
berzelius	b e . l eu . s e l . l i . u . s eu
soros	s o . l o . s eu
cuthbert	k eo . s eu . b eo . t eu
spencer	s eu . p e n . s eo
kaliningrad	k a l . l i . n i n . g eu . l a . d eu
sheppard	s ye . p eo . d eu
nicholas	n i . k o l . l eo . s eu
verhaeren	b e . l eu . h a . l e n
dobriansky	d o . b eu . l i . eo n . s eu . k i
hebron	h e . b eu . l o n
boise	b o . i . s i
comoros	k o . m o . l o
horace	h o . l a . t i . u . s eu
dietzgen	d i . ch eu . g e n
meade	m i . d eu
pekkanen	p e . k a . n e n
barron	b ae . l o n
duarte	d u . a . l eu . t e
tormod	t o . m o . d eu
doherty	d o . h eo . t i
albers	a l . b e . l eu . s eu
vicente	b i . s e n . t e
belloc	b e l . l o g
montemayor	m o n . t e . m a . yo . l eu
maputo	m a . p u . t o
eunice	yu . n i . s eu
gromaire	g eu . l o . m e . l eu
steffi	s yu . t e . p i
nichols	n i . k o l . s eu
gunther	g eo n . s eo
connecticut	k o . n e . t i . k eo s
giovanni	j o . b a n . n i
iverson	a . i . b eo . s eu n
steinheil	s yu . t a . i n . h a . i l
bradley	b eu . l ae . d eu l . l i
ukraine	u . k eu . l a . i . n a
colman	k o l . m eo n
ramo	l a . m o
margaret	m a . g eo . l i s
chianti	k a n . t i
guinea_bissau	g i . n i . b i . s a . u
huff	h eo . p eu
chekhov	ch e . h o . p eu
andrew	ae n . d eu . l yu
shchepkin	s i . ch e b . k i n
stoss	s yu . t o . s eu
mays	m e . i . s eu
moses	m o . s e . s eu
edita	e . d i . t a
pontoppidan	p o n . t o . p i . d a n
cartier	k a . l eu . t i . e
lundberg	l u n . d eu . b e . l i
caruso	k a . l u . s o
estelle	e . s eu . t e l
andropov	a n . d eu . l o . p o . p eu
brooks	b eu . l u g . s eu
marlon	m a l . l o n
hindenburg	h i n . d e n . b u . l eu . k eu
root	l u . t eu
ochoa	o . ch o . a
segal	s i . g a l
cardinale	k a . l eu . d i . n a l . l e
bradbury	b eu . l ae . d eu . b eo . l i
sandburg	s ae n . d eu . b eo . g eu
renan	l eu . n a ng
bayonne	b a . yo n . n eu
pike	p a . i . k eu
herford	h e . eo . p o . t eu
wheelock	h wi l . l a g
lilley	l i l . l i
klein	k eu l . l a . i n
vitoria	b i g . t o . l i . a
wilt	wi l . t eu
qi	ch i
hoskins	h o . s eu . k i n . s eu
troy	t eu . l o . i
cullen	k eo l . l e n
edouard	e . d u . a . l eu
montgomery	m o ng . g o . m e . l i
fizeau	p i . j o
abir	a . b i . l eu
hofmeister	h o . p eu . m a . i . s eu . t eo
martin	m a . l eu . t ae ng
lina	l i . n a
daley	d e . i l . l i
olivia	o l . l i . b i . a
feldman	p e l . d eu . m a n
wyoming	wa . i . o . m i ng
huber	h u . b eo
grey	g eu . l e . i
blythe	b eu l . l i . d eu
amundsen	a . m u n . j e n
piccoli	p i . k o l . l i
karsavina	k a . l eu . s a . b i . n a
croce	k eu . l o . ch e
manet	m a . n e
kennelly	k e . n eo l . l i
gunderson	g eo n . d eo . s eu n
heyden	h e . i . d e n
kalimantan	k a l . l i . m a n . t a n
pagnol	p a . n yo l
douglas	d eo . g eu l . l eo . s eu
frank	p eu . l a ng . k eu
cassidy	k ae . s i . d i
gertrude	g e . l eu . t eu . l u . d eu
prosper	p eu . l o . s eu . p e . l eu
sorokin	s o . l o . k i n
dubinin	d u . b i . n i n
willie	wi l . l i
sadat	s a . d a . t eu
kaufman	k o . p eu . m eo n
ridley	l i . d eu l . l i
dalin	d a l . l i n
flaubert	p eu l . l o . b e . l eu
abraham	a . b eu . l a . h a m
ellesmere	e l . j eu . m i . eo
kidd	k i . d eu
armenia	a . l eu . m e . n i . a
francke	p eu . l a ng . k e
janice	j e . n i . s eu
arrhenius	a . l e . n i . u . s eu
lagos	l a . g o . s eu
kelley	k e l . l i
castries	k ae . s eu . t eu . l i . s eu
perrier	p e . l i . e
francois	p eu . l a ng . s u . a
ryle	l a . i l
principe	p eu . l i n . s i . p e
tosti	t o . s eu . t i
anibal	a . n i . b a l
elvira	e l . b i . l a
frechette	p eu . l e . s ye . t eu
bern	b e . l eu n
kashmir	k a . s yu . m i . l eu
croatia	k eu . l o . a . t i . a
gadamer	g a . d a . m eo
copland	k o . p eu l . l ae n . d eu
neto	n e . t o
irena	i . l e . n a
steel	s eu . t i l
edwards	e . d eu . wo . j eu
montoya	m o n . t o . ya
len	l e n
shane	s we . i n
bouchard	b u . s ya . l eu
bazin	b a . j ae ng
lange	l a ng . e
austerlitz	a . u . s eu . t eo . l i . ch eu
perenlei	p e . l e n . l e . i
lex	l e g . s eu
beatty	b i . t i
meryl	m e . l i l
beaumarchais	b o . m a . l eu . s ye
buck	p eo l
simone	s i . m o . n e
vasconcelos	b a . s eu . k o n . s e l . l o . s eu
roach	l o . ch i
thorpe	s o . p eu
potapenko	p o . t a . p e n . k o
prout	p eu . l a . u . t eu
vaucanson	b o . k a ng . s o ng
hancock	h ae n . k o g
asch	ae . s wi
torsten	t o l . s eu . t eo n
khartoum	h a . l eu . t u m
conakry	k o . n a . k eu . l i
bamber	b ae m . b eo
sheldon	s ye l . d eo n
lenin	l e . n i n
walsingham	wo l . s i ng . eo m
dufour	d u . p o . b o ng
andreu	a n . d eu . l e . u
owens	o . eo n . s eu
virtanen	b i . l eu . t a . n e n
dillon	d i l . l eo n
brad	b eu . l ae . d eu
omsk	o m . s eu . k eu
lyndon	l i n . d eu n
glenda	g eu l . l e n . d a
mercer	m eo . s eo
jain	j e . i n
kelly	k e l . l i
geist	g a . i . s eu . t eu
red	l e . d eu
licht	l i . h i . t eu
beauvoir	b o . b u . a . l eu
george	g e . o . l eu . g eu
greenberg	g eu . l i n . b eo . g eu
barnes	b a . n e . j eu
penzias	p e n . j i . eo . s eu
linares	l i . n a . l e . s eu
mitchell	m i . ch e l
winfried	wi n . p eu . l e . d eu
katherine	k ae . s eo . l i n
melbourne	m e l . b eo . l eu n
orlando	o l . l ae n . d o
somalia	s o . m a l . l i . a
conte	k o ng . t e
woodrow	u . d eu . l o
bonn	b o n
reichenbach	l a . i . h e n . b a . h eu
andri	a n . d eu . l i . ch i
henriquez	e n . l i . k e . s eu
cramer	k eu . l ae . m eo
glauber	g eu l . l a . u . b eo
boyer	b o . i . eo
abdul	a b . d u l
barkley	b a . k eu l . l i
sergi	s e . l eu . h i
ustinov	yu . s eu . t i . n o . p eu
eichendorff	a . i . h e n . d o . l eu . p eu
landry	l a ng . d eu . l i
eberhard	e . b e l . h a . l eu . t eu
blum	b eu l . l eo m
alekseev	a l . l e g . s e . ye . p eu
debbie	d e . b i
gervinus	g e . l eu . b i . n u . s eu
maspero	m a . s eu . p e . l o
johannes	yo . h a . n e . s eu
asia	a . s i . a
freudenthal	p eu . l o . i . d e n . t a l
caroline	k ae . l o l . l a . i n
sinan	s i . n a n
hoxha	h o . j a
bergen	b e . l eu . g e n
capa	k a . p a
ducommun	d wi . k o . m oe ng
trimble	t eu . l i m . b eu l
brussels	b eu . l wi . s e l
madsen	m ae . d eu . s eu n
bara	b a . l a
josef	yo . s e . p eu
candolle	k a ng . d o l
falconet	p a l . k o . n e
lama	l a . m a
bilal	b i l . l a l
atahualpa	a . t a . wa l . p a
herbst	h eo . b eu . s eu . t eu
lenau	l e . n a . u
cesalpino	ch e . s a l . p i . n o
camus	k a . m wi
kee	k i
adrienne	e . i . d eu . l i . e n
pontormo	p o n . t o . l eu . m o
merce	m eo . s eu
sams	s ae m . s eu
thompson	t o m . s eu n
sverdlovsk	s eu . b e . l eu . d eu l . l o . p eu . s eu . k eu
welch	we l . ch i
estremadura	e . s eu . t eu . l e . m a . d u . l a
port	p o . t eu
sonja	s o . n ya
kiefer	k i . p eo
beatrix	b e . a . t eu . l i g . s eu
otis	o . t i . s eu
harding	h a . d i ng
omar	o . m a
eschenbach	e . s ye n . b a . h eu
sumarokov	s u . m a . l o . k o . p eu
kasper	k a . s eu . p eo
davies	d e . i . b i . s eu
alger	a l . j e
sharpe	s ya . p eu
curt	k u . l eu . t eu
freiburg	p eu . l a . i . b u . l eu . k eu
perez	p e . l e . j eu
riley	l a . i l . l i
rutherford	l eo . d eo . p eo . d eu
garry	g e . l i
encke	e ng . k e
cincinnatus	k i n . k i . n a . t u . s eu
jocelyn	j o . s e l . l i n
burnett	b eo . n e s
herbert	h eo . b eo . t eu
andrej	a n . d eu . l e . i
martins	m a . t i n
messier	m e . s i . e
berwick	b e . l i g
rollo	l o l . l o
neve	n e . b eu
harden	h a . d eu n
bernadette	b eo . n a . d e . t eu
aman	a . m a n
wallenstein	b a l . l e n . s yu . t a . i n
perec	p e . l e g
sands	s ae n . j eu
zanetti	s a . n e . t i
diefenbaker	d i . p e n . b e . i . k eo
nicolle	n i . k o l
matute	m a . t u . t e
diderot	d i . d eu . l o
bremer	b eu . l e . m e . l eu
grosse	g eu . l o . s e
hebbel	h e . b e l
fanning	p ae . n i ng
mironov	m i . l o . n o . p eu
wangchuck	wa ng . ch u . k eu
mart	m a . l eu . t eu
karelia	k a . l e l . l i . a
feldstein	p e l . d eu . s eu . t a . i n
kantor	k ae n . t eo
melo	m e l . l o
martin	m a . l eu . t i n
bates	b e . i . ch eu
merritt	m e . l i . t eu
marett	m ae . l eo s
withers	wi . d eo . s eu
janet	j a . n e
qingxian	ch i ng . s ye n
peck	p e g
dayan	d a . ya n
paraguay	p a . l a . g wa . i
tegucigalpa	t e . g u . s i . g a l . p a
mancini	m ae n . s i . n i
shearer	s i . eo . l eo
stolypin	s eu . t o l . l i . p i n
quant	k wo n . t eu
kingsley	k i ng . j eu l . l i
helge	h e l . g e
breton	b eu . l e . t eu n
maxime	m a g . s i m
bury	b eo . l i
flanders	p eu l . l ae n . d eo . s eu
mainz	m a . i n . ch eu
harald	h a . l a l . t eu
coburn	k o . b eo n
villa	b i l . l a
livingstone	l i . b i ng . s eu . t eo n
basque	b a . s eu . k eu
sutter	s u . t eo
semper	j e m . p eo
magdalena	m a g . d a l . l e . n a
anzengruber	a n . ch e n . g eu . l u . b eo
medford	m ae . d eu . p o . d eu
sander	s ae n . d eo
salvador	s a l . b a . d o . l eu
vives	b i . b e . s eu
mayflower	m e . i . p eu l . l a . wo
shufeldt	s yu . p e l . t eu
varela	b a . l e . l a
cass	k ae . s eu
dmitri	d eu . m i . t eu . l i
durante	d yu . l a n . t e
galloni	g ae l . l o . n i
tajikistan	t a . j i . k i . s eu . t a n
isabel	i . s a . b e l
delano	d i l . l a . n o
pankhurst	p ae ng . k eu . h eo . s eu . t eu
reykjavik	l e . i . k ya . b i . k eu
elmo	e l . m o
davide	d a . b i . d e
richer	l i . ch eo
ogden	o . g eu . d eo n
trautmann	t eu . l o . t eu . m a n
nottingham	n o . t i ng . eo m
reiner	l a . i . n eo
brock	b eu . l o g
goldberg	g o l . d eu . b eo . g eu
belli	b e l . l i
primakov	p eu . l i . m a . k o . p eu
karl	k a . l eu l
meindert	m a . i n . d e . l eu . t eu
jones	j o n . s eu
snowdon	s eu . n o . d eu n
artsybashev	a . l eu . ch i . b a . s ye . p eu
mommsen	m o m . j e n
houghton	h o . t eu n
lund	l u n . d eu
hulse	h eo l . s eu
burstein	b eo . s eu . t a . i n
norbert	n o . l eu . b e . l eu . t eu
glasgow	g eu l . l ae . s eu . g o
schwarz	s yu . wa l . ch eu
freddie	p eu . l e . d i
mitropoulos	m i . t eu . l o . p o l . l o . s eu
gironde	j i . l o ng . d eu
guerrero	g e . l e . l o
iliev	i l . l i . ye . p eu
nouvel	n u . b e l
ellington	e l . l i ng . t eo n
gielgud	g i l . g u . d eu
owen	o . we n
dario	d a . l i . o
philip	b i l . l i b
errol	e . l eo l
exeter	e g . s eo . t eo
brodsky	b eu . l o . d eu . s eu . k i
galpin	g a l . p i n
brian	b eu . l a . i . eo n
starling	s eu . t a l . l i ng
santayana	s a n . t a . ya . n a
heyman	h e . i . m eo n
hodgkin	h o . j i . k i n
pellegrini	p e l . l e . g eu . l i . n i
deaver	d i . b eo
bruant	b eu . l wi . a ng
ives	a . i . b eu . j eu
kaganovich	k a . g a . n o . b i . ch i
gary	g e . l i
silvestre	s i l . b e . s eu . t eu . l eu
marchais	m a . l eu . s ye
solomon	s o l . l o . m o n
brahms	b eu . l a m . s eu
frunze	p eu . l u n . j e
bouvet	b o . b i s
nicola	n i . k o l . l a
chomsky	ch o m . s eu . k i
ingenhousz	i ng . g e n . h o . u . s eu
bridgetown	b eu . l i . j i . t a . u n
punsalmaagiyn	p u n . s a l . m a . g i n
shadwell	s yae . d eu . we l
cairns	k e . i n . j eu
rathenau	l a . t e . n a . u
chaim	k a . i m
bergman	b eo . g eu . m eo n
mitch	m i . ch i
marvin	m a . b i n
mcguire	m ae g . g wa . i . eo
dunham	d eo n . h ae m
shakespeare	s ye . i g . s eu . p i . eo
lavoisier	l a . b u . a . j i . e
elsa	e l . j a
guy	g a . i
gibbs	g i . b eu . s eu
benjamin	b e n . j a . m i n
aleksander	a l . l e g . s a n . d eo
vinay	b i . n a . i
kivi	k i . b i
haydn	h a . i . d eu n
amir	a . m i . l eu
sim	s i m
isadora	i . s a . d o . l a
jenner	j e . n eo
thomas	d o . m a
kuhn	k u n
ken	k e n
hal	h ae l
marsden	m a . s eu . d eu n
trenton	t eu . l e n . t eo n
lini	l i . n i
amy	e . i . m i
jordan	yo . l eu . d a n
marek	m a . l e g
oscar	o . s eu . k a
petrograd	p e . t eu . l o . g eu . l a . d eu
briggs	b eu . l i . g eu . s eu
gentz	g e n . ch eu
hellman	h e l . m eo n
valery	b a l . l e . l i
benares	b e . n a . l e . s eu
brzezinski	b eu . l e . j i n . s eu . k i
worthington	wo . s i ng . t eo n
thailand	t a . i
andreas	a n . d eu . l e . a . s eu
maeterlinck	m e . i . t eo . l i ng . k eu
artigas	a . l eu . t i . g a . s eu
horacio	h o . l a . s i . o
wilson	wi l . s eu n
pettenkofer	p e . t e n . k o . p eo
visconti	b i . s eu . k o n . t i
haworth	h a . s eu
alfieri	a l . p i . e . l i
heym	h a . i m
quiroga	k i . l o . g a
huntsville	h eo n . ch eu . b i l
ince	i n . s eu
neil	n i l
duchamp	d wi . s ya ng
nigeria	n a . i . j i . l i . a
haidar	h a . i . d a . l eu
penck	p e ng . k eu
cranach	k eu . l a . n a . h eu
lister	l i . s eu . t eo
rein	l e . i n
levin	l e . b i n
esposito	e . s eu . p o . s i . t o
gomulka	g o . m u . u . k a
malherbe	m a l . l e . l eu . b eu
nielsen	n i l . s e n
ram	l ae m
barrie	b ae . l i
rostov	l o . s eu . t o . p eu
ficino	p i . ch i . n o
list	l i . s eu . t eu
dara	d ae . l a
castillo	k a . s eu . t i l . l o
reiners	l a . i . n eo . j eu
geneva	j e . n e . b a
bangalore	b a ng . g a l . l o . l eu
marot	m a . l o
lois	l u . i . s eu
junqueiro	j u n . k e . i . l u
jam	j ae m
masa	m a . s a
meri	m e . l i
dawkins	d o . k i n . s eu
forman	p o . l eu . m a n
camilo	k a . m i l . l o
breuer	b eu . l o . i . eo
nimu	n i . m u
hawks	h o . k eu . s eu
grossman	g eu . l o . s eu . m eo n
engel	e ng . g e l
bahar	b a . h a . l eu
carney	k a . n i
hooch	h o . h eu
castello	k a . s eu . t e l . l o
bianco	b i . a n . k o
honolulu	h o . n o l . l u l . l u
foreman	p o . m eo n
eva	e . b a
jacksonville	j ae g . s eu n . b i l
brandes	b eu . l a . d e . s eu
crisp	k eu . l i . s eu . p eu
rama	l a . m a
ehrlich	e . l eu l . l i . h i
meir	m e . i . l eu
sosa	s o . s a
gartner	g a . t eu . n eo
darwin	d a . wi n
ingrid	i ng . g eu . l i . d eu
rowling	l o l . l i ng
judy	j u . d i
schmitz	s yu . m i . ch eu
georgette	j o . j e s
byrd	b eo . d eu
ritz	l i . ch eu
landes	l ae n . j eu
sandi	s ae n . d i
harry	h ae . l i
nehru	n e . l u
robson	l o b . s eu n
aitken	e . i . k i n
petroni	p e . t eu . l o . n i
erwin	eo . wi n
doolittle	d u l . l i . t eu l
utrecht	wi . t eu . l e . h eu . t eu
bliss	b eu l . l i . s eu
hanover	h a . n o . b eo
cara	k a . l a
metz	m e . s eu
bass	b ae . s eu
zhaozhen	j a . o . j eo n
mosca	m o . s eu . k a
lutoslawski	l u . t o . s eu l . l a . p eu . s eu . k i
elba	e l . b a
collett	k o l . l e . t eu
weidenreich	b a . i . d e n . l a . i . h i
krause	k eu . l a . u . j e
cowper	k u . p eo
anton	a n . t o n
mille	m i l
pattison	p a . t i . s eu n
dov	d o . b eu
durant	d yu . l ae n . t eu
manhattan	m ae n . h ae . t eu n
malin	m a l . l i n
zetkin	ch e . t eu . k i n
jordaens	yo . l eu . d a n . s eu
kent	k e n . t eu
hungary	h eo ng . g a . l i
haren	h a . l e n
dam	d a m
hammer	h a . m eo
lu	l u
stumpf	s yu . t u m . p eu
singer	s i ng . eo
elzevir	e l . j e . b i . eo
buhari	b u . h a . l i
