stacey	s eu . t e . i . s i
lombardi	l o m . b a . l eu . d i
carmichael	k a . m a . i . k eu l
groth	g eu . l o . t eu
fisch	p i . s yeo
topelius	t o . p e l . l i . u . s eu
canetti	k a . n e . t i
maguire	m ae g . g wa . i . eo
alvarez	ae l . b eo . l e . j eu
garcia	g a . l eu . s i . a
berti	b e . l eu . d i
reiners	l a . i . n eo . j eu
lamartine	l a . m a . l eu . t i n
morgenstern	m o . l eu . g e n . s yu . t e . l eu n
landsteiner	l a n . t eu . s yu . t a . i . n eo
accra	a . k eu . l a
rumsfeld	l eo m . j eu . p e l . d eu
kris	k eu . l i . s eu
scheele	s ye l . l e
haley	h a l . l i
louise	l u . i . j eu
cochrane	k o . k eu . l eo n
margolis	m a . g o l . l i . s eu
patrick	p a . t eu . l i . k eu
pajou	p a . j u
polly	p o l . l i
magnani	m a . n ya . n i
ochab	o . h a . p eu
villanueva	b i l . l a . n u . e . b a
roma	l o . m a
clapeyron	k eu l . l a . p e . l o ng
pottinger	p o . t i n . j eo
driesch	d eu . l i . s yu
boston	b o . s eu . t eo n
dunham	d eo n . h ae m
caen	k a ng
merton	m eo . t eu n
angola	a ng . g o l . l a
anton	a n . t o n
kerr	k eo
gandhi	g a n . d i
reed	l i . d eu
mraz	m eu . l a . j eu
goldwyn	g o l . d eu . wi n
taft	t ae . p eu . t eu
camara	k a . m a . l a
praetorius	p eu . l e . t o . l i . u . s eu
maurus	m o . l wi . s eu
mathewson	m ae . t yu . s eu n
buffalo	b eo . p eo l . l o
spranger	s yu . p eu . l a ng . g eo
indianapolis	i n . d i . ae . n a . p o l . l i . s eu
buckle	b eo . k eu l
kathleen	k ae . s eo . l i n
ahn	a n
gore	g o . eo
phoebe	p o . i . b e
russel	l eo . s e l
marconi	m a . l eu . k o . n i
seymour	s e . i . m u . eo
hellen	h e l . l e n
gaza	g a . j a
boethius	b o . i . t i . u . s eu
ellington	e l . l i ng . t eo n
wend	we n . d eu
glass	g eu l . l a . s eu
cournot	k u . l eu . n o
dodoma	d o . d o . m a
pride	p eu . l a . i . d eu
florida	p eu l . l o . l i . d a
mircea	m i . l eu . ch e . a
long	l o ng
herzl	h e . l eu . ch eu l
raffles	l ae . p eu l . s eu
billy	b i l . l i
dayan	d a . ya n
magnitogorsk	m a . g eu . n i . t o . g o . l eu . s eu . k eu
matthews	m ae . s yu . s eu
gleim	g eu l . l a . i m
quaid	k we . i . d eu
lancashire	l ae ng . k eo . s yeo
gironde	j i . l o ng . d eu
couperin	k u . p eu . l ae ng
bevan	b e . b eo n
falk	p o . k eu
anson	ae n . s eu n
juglar	j wi . g eu l . l a
vatican	b a . t i . k a n
roach	l o . ch i
renn	l e n
guzman	g u . j eu . m eo n
wertheimer	b e . l eu . t eu . h a . i . m eo
gabriel	g a . b eu . l i . e l
blok	b eu l . l o . k eu
jolivet	j o l . l i . b e
hess	h e . s eu
pufendorf	p u . p e n . d o . l eu . p eu
haworth	h a . s eu
beatrice	b e . a . t eu . l i . s eu
mercouri	m e . l eu . k u . l i
hofer	h o . p eo
zaire	j a . i . l eu
cassandra	k a . s a n . d eu . l a
penny	p e . n i
irene	i . l e . i n
andorra	a n . d o . l a
lent	l e n . t eu
hatton	h ae . t eu n
onegin	o . n e . g i n
phyllis	p i l . l i . s eu
priestley	p eu . l i . s eu . t eu l . l i
benson	b e n . s eu n
bateson	b e . i . t eu . s eu n
braga	b eu . l a . g a
serafin	s e . l a . p i n
mulliken	m eo l . l i . k eo n
vincent	b ae ng . s a ng
vega	b e . g a
michie	m i . ch i . e
oliveira	o l . l i . b e . i . l a
roth	l o . t eu
schmid	s yu . m i . d eu
susanna	s u . s a n . n a
connecticut	k o . n e . t i . k eo s
belize	b e l . l i . j eu
sheldon	s ye l . d eo n
buisson	b wi . s o ng
laughton	l o . t eu n
fernand	p e . l eu . n a ng
java	j a . b a
robin	l o . b i n
staudinger	s yu . t a . u . d i ng . g eo
orenburg	o . l e n . b u . l eu . k eu
mitchell	m i . ch e l
bell	b e l
borchardt	b o . l eu . h a . l eu . t eu
seaborg	s i . b o . g eu
riva	l i . b a
kaj	k a . i
pfleiderer	p eu l . l a . i . t e . l eo
sommaruga	s o . m a . l u . g a
nobile	n o . b i l . l e
ulrich	u l . l i . h i
brown	b eu . l a . u n
melinda	m e l . l i n . d a
cuba	k u . b a
kate	k e . i . t eu
stonehenge	s eu . t o n . h e n . j i
sutter	s u . t eo
albinoni	a l . b i . n o . n i
spadolini	s eu . p a . d o l . l i . n i
griffin	g eu . l i . p i n
tijuana	t i . h u . a . n a
vaga	b a . g a
summer	s a . m a
georg	g e . o . l eu . g eu
ogilvy	o . g eu l . b i
cervantes	s e . l eu . b a n . t e . s eu
moreau	m o . l o
moniz	m o . n i . j eu
florey	p eu l . l o . l i
sweet	s eu . wi . t eu
nash	n ae . s i
aranda	a . l a n . d a
roald	l o . a l
dines	d a . i n . s eu
gutenberg	g u . t e n . b e . l eu . k eu
auckland	o . k eu l . l ae n . d eu
rydberg	l wi . d eu . b e . l i
dessau	d e . s a . u
alam	a l . eo m
maxim	m ae g . s i m
carolina	k ae . l o l . l a . i . n a
gregorius	g eu . l e . g o . l i . u . s eu
windhoek	b i n . t eu . h u . k eu
deirdre	d e . eo . d eu . l eu
dodson	d a s . s eu n
gascoigne	g ae . s eu . k o . i n
hekmatyar	h e . k eu . m a . t i . a . l eu
bradbury	b eu . l ae . d eu . b eo . l i
hamm	h a m
hynninen	h a . i n . n i . n e n
philipp	p i l . l i . p eu
grafton	g eu . l a . p eu . t eu n
holst	h o l . s eu . t eu
balch	b o l . ch i
mubarak	m u . b a . l a . k eu
khomeini	h o . m e . i . n i
praga	p eu . l a . g a
schaeffer	s we . p eo
astrakhan	a . s eu . t eu . l a . h a n
sydenham	s i . d eu . n eo m
buddy	b eo . d i
ferry	p e . l i
dollar	d a l . l eo
ezer	e . j e . l eu
frazer	p eu . l e . i . j eo
hartford	h a . t eu . p eo . d eu
weingartner	b a . i n . g a . l eu . t eu . n eo
gavin	g ae . b i n
montesquieu	m o ng . t e . s eu . k i . oe
trieste	t eu . l i . e . s eu . t e
jaipur	j a . i . p u . l eu
ara	a . l a
osbourne	o . s eu . b o n
bui	b u . i
sherriff	s ye . l i . p eu
oppenheimer	o . p e n . h a . i . m eo
buswell	b eo . s eu . we l
rosebery	l o . j eu . b eo . l i
dunsany	d eo n . s e . i . n i
vivien	b i . b i . eo n
matilda	m a . t i l . d a
devon	d e . b eo n
castlereagh	k ae . s eu l . l e . i
theresa	t e . l e . s a
wolfgang	b o l . p eu . g a ng
algren	o l . g eu . l eo n
gregg	g eu . l e . g eu
gerd	g e . l eu . t eu
browning	b eu . l a . u . n i ng
nezval	n e . j eu . b a l
ivanov	i . b a . n o . p eu
barrera	b a . l e . l a
pym	p i m
beauchamp	b o . s ya ng
gyula	j u l . l eo
tansley	t ae n . s eu l . l i
haifa	h a . i . p a
madge	m e . j wi
ahmad	a . m a . d eu
alston	e l . s eu . t o n
durante	d yu . l a n . t e
koneski	k o . n e . s eu . k i
cincinnatus	k i n . k i . n a . t u . s eu
barker	b a . k eo
vaughan	b o n
gaia	g a . i . a
prebisch	p eu . l e . b i . s i
bedford	b e . d eu . p eo . d eu
angelo	a n . j e l . l o
stigler	s eu . t i . g eu l . l eo
stockton	s eu . t o g . t eo n
loschmidt	l o . s yu . m i . t eu
foley	p o l . l i
hebra	h e . b eu . l a
monrovia	m o n . l o . b i . a
burnett	b eo . n e s
poulenc	p u l . l a ng . k eu
guadalajara	g wa . d a l . l a . h a . l a
waters	wo . t eo . s eu
curtis	k eo . t i . s eu
paganini	p a . g a . n i . n i
frederic	p eu . l e . d eo . l i g
cheddar	ch e . d eo
sweden	s eu . we . d e n
zwingli	ch eu . b i ng . g eu l . l i
rose	l o . j eu
madagascar	m a . d a . g a . s eu . k a . l eu
booth	b u . d eu
jim	j i m
sanderson	s ae n . d eo . s eu n
poli	p o l . l i
masaccio	m a . s a . ch o
aleksander	a l . l e g . s a n . d eo
kenton	k e n . t eo n
roche	l o . ch e
maillol	m a . yo l
rein	l e . i n
antonia	a n . t o . n i . a
managua	m a . n a . g wa
nichols	n i . k o l . s eu
siegel	s i . g e l
bass	b ae . s eu
fizeau	p i . j o
azerbaijan	a . j e . l eu . b a . i . j a n
torre	t o . l e
sinowatz	j i . n o . b a . ch eu
garner	g a . n eo
vesuvius	b e . s u . b i . o
wilma	wi l . m a
dragan	d eu . l a . g a n
eder	e . d eo
ems	e m . s eu
richer	l i . ch eo
isaiah	i . s a . ya
tolkien	t o l . k i n
savinkov	s a . b i n . k o . p eu
pavlova	p a . b eu l . l o . b a
daumier	d o . m i . e
kipling	k i . p eu l . l i ng
gleysteen	g eu l . l a . i . s eu . t i n
williamson	wi l . l i . eo m . s eu n
audubon	o . d yu . b o n
honolulu	h o . n o l . l u l . l u
wilson	wi l . s eu n
burns	b eo n . s eu
peper	p e . p e . l eu
avogadro	a . b o . g a . d eu . l o
ariel	a . l i . e l
leonov	l e . o . n o . p eu
harris	h ae . l i . s eu
twardowski	t eu . wa . l eu . d o . p eu . s eu . k i
shevchenko	s ye . p eu . ch e n . k o
mello	m e l . l o
robbins	l o . b i n . s eu
lion	l i . o n
asa	a . s a
jepsen	j e . p eu . s eu n
welles	we l . s eu
beaumarchais	b o . m a . l eu . s ye
gerrit	h e . l i . t eu
honig	h o . n i . g eu
buridan	b wi . l i . d a ng
diallo	d i . ae l . l o
rod	l o . d eu
gertrud	g eo . t eu . l u . d eu
jocelyn	j o . s e l . l i n
hofstadter	h o . p eu . s eu . t ae . t eo
chevalier	s yu . b a l . l i . e
husserl	h u . s eo l
ari	ae . l i
kantor	k ae n . t eo
beck	b e g
ingraham	i ng . g eu . l eo . h ae m
lebanon	l e . b a . n o n
bonner	b o . n eo
dovzhenko	d o . p eu . j e n . k o
brussels	b eu . l wi . s e l
wassermann	b a . s e . l eu . m a n
matthew	m a . t ae
brookes	b eu . l u g . s eu
kohl	k o l
guardini	g wa . l eu . d i . n i
wheatley	wi . t eu l . l i
angelika	a ng . g e l . l i . k a
berkshire	b a . k eu . s yeo
billings	b i l . l i ng . s eu
nebojsa	n e . b o . i . s a
bayley	b e . i . l e . i
newman	n yu . m eo n
hopper	h o . p eo
virtanen	b i . l eu . t a . n e n
wole	wo l . l e
edna	e . d eu . n a
piscator	p i . s eu . k a . t o . l eu
mitscherlich	m i . ch eo . l i . h i
soto	s o . t o
weston	we . s eu . t eo n
gauss	g a . u . s eu
ferdianand	p e . l eu . d i . n a n . d eu
sydow	s i . d o
beard	b i . eo . d eu
hogg	h o . g eu
leoncavallo	l e . o n . k a . b a l . l o
giddens	g i . d eu n . s eu
khadem	k a . d e m
antananarivo	a n . t a . n a . n a . l i . b o
goncharov	g o n . ch a . l o . p eu
edith	e . d i . t eu
limburg	l i m . b u . l eu . h eu
colonna	k o l . l o n . n a
sampson	s ae m . s eu n
vivaldi	b i . b a l . d i
malherbe	m a l . l e . l eu . b eu
milovan	m i l . l o . b a n
svend	s eu . b e n
busia	b u . s i . a
lyell	l a . i . e l
richelieu	l i . s yu l . l i . oe
peter	p i . t eo
pacher	p a . h eo
beets	b e . ch eu
como	k o . m o
riga	l i . g a
carry	k e . eo . l i
caprivi	k a . p eu . l i . b i
hawks	h o . k eu . s eu
madsen	m ae . d eu . s eu n
sweelinck	s eu . b e l . l i ng . k eu
missouri	m i . j u . l i
bertie	b eo . t i
hotchkiss	h o . ch i . k i . s eu
cathy	k ae . s i
fet	p e . t eu
stephane	s eu . t e . p a n
herz	h e . l eu . ch eu
schumann	s yu . m a n
briscoe	b eu . l i . s eu . k o
bevin	b e . b i n
pilcher	p i . ch eo
martino	m a . l eu . t i . n o
woodworth	u . d eu . wo . s eu
bordeaux	b o . l eu . d o
hazard	h ae . j eo . d eu
mahmood	m a . h eu . m u . d eu
lasker	l ae . s eu . k eo
chopra	ch o . p eu . l a
sandburg	s ae n . d eu . b eo . g eu
ugo	u . g o
filchner	p i l . h i . n eo
karl	k a . l eu l
winifred	wi n . p eu . l e . d eu
veronica	b e . l o . n i . k a
re	l e
massa	m a . s a
lorraine	l o . l e n
daisy	d a . i . s i
lemaire	l eu . m e . l eu
bowyer	b a . u . eo
california	k ae l . l i . p o . n i . a
biagio	b i . a . j i . o
wheelock	h wi l . l a g
aslan	a . s eu l . l a n
busoni	b u . s o . n i
kabul	k a . b u l
walker	wo . k eo
salt	s o l . t eu
garrison	g ae . l i . s eu n
julianus	yu l . l i . a . n u . s eu
bergson	b e . l eu . g eu . s o ng
bossuet	b o . s wi . e
sander	s ae n . d eo
moller	m o l . l eo
amiens	a . m i . ae ng
reynaud	l e . n o
maga	m a . g a
chapsal	s ya . p eu . s a l
esteban	e . s eu . t e . b a n
bassett	b a . s e s
ethiopia	e . t i . o . p i . a
kroner	k eu . l o . n e
segura	s e . g u . l a
wharton	wa . t eu n
eriksson	e . l i g . s o n
arroyo	a . l o . yo
hennebique	e n . b i . k eu
fay	p e . i
walsingham	wo l . s i ng . eo m
uccello	u . ch e l . l o
saillant	s a . ya ng
albany	o l . b eo . n i
ducommun	d wi . k o . m oe ng
addams	ae . d eo m . s eu
daniell	d a . n i . e l
abraham	a . b eu . l a . h a m
nowak	n o . wo . k eu
mohamad	m o . h a . m a . d eu
schiaparelli	s eu . k i . a . p a . l e l . l i
ferrero	p e . l e . l o
mordecai	m o . l eu . d eu . g ae
sarajevo	s a . l a . ye . b o
kovalenko	k o . b a l . l e n . k o
cesalpino	ch e . s a l . p i . n o
nerva	n e . l eu . b a
haskell	h a . s eu . k e l
stowe	s eu . t o
schilling	s i l . l i ng
pina	p i . n a
casanova	k a . s a . n o . b a
putnam	p eo . t eu . n eo m
griffith	g eu . l i . p i . s eu
dutton	d yu . t o n
johnstown	j o n . s eu . t a . u n
welch	we l . ch i
curie	k wi . l i
leighton	l e . i . t eu n
laptev	l a b . t e . p eu
trimble	t eu . l i m . b eu l
bednorz	b e . d eu . n o . l eu . ch eu
arjun	a . j u n
burney	b eo . n i
granet	g eu . l a . n e
savoie	s a . b u . a
ellesmere	e l . j eu . m i . eo
mora	m o . l a
erickson	e . l i g . s eu n
rice	l a . i . s eu
ulf	u l . p eu
baum	b a . u m
rio	l i . u
gros	g eu . l o
lasso	l a . s o
cornelius	k o . l eu . n e l . l i . u . s eu
kaunda	k a . u n . d a
cruyff	k eu . l u . i . p eu
blackpool	b eu l . l ae g . p u l
corneille	k o . l eu . n e . yu
crompton	k eu . l eo m . p eu . t eo n
simmonds	s i . m eo n . j eu
veronese	b e . l o . n e . s e
trautmann	t eu . l o . t eu . m a n
allende	a . ye n . d e
palmerston	p a l . m eo . s eu . t o n
scalapino	s eu . k a l . l a . p i . n o
holbrooke	h o l . b eu . l u g
jussieu	j wi . s i . oe
danforth	d ae n . p o . s eu
zeiss	ch a . i . s eu
abdus	a b . d u . s eu
jue	j we
banjul	b a n . j u l
pirie	p a . i . l i
idaho	a . i . d a . h o
amazon	a . m a . j o n
pakistan	p a . k i . s eu . t a n
ohana	o . h a . n a
varga	b a . l eu . g a
piston	p i . s eu . t eo n
oparin	o . p a . l i n
athanasius	a . t a . n a . s i . u . s eu
anand	a . n a n . d eu
voss	p o . s eu
frank	p eu . l a ng . k eu
waksman	wa g . s eu . m eo n
luba	l u . b a
rous	l a . u . s eu
bridgetown	b eu . l i . j i . t a . u n
gerber	g eo . b eo
ferre	p e . l e
ober	o . b eo
austin	o . s eu . t i n
serao	s e . l a . o
kenyatta	k e . n ya . t a
mayer	m a . i . eo
latham	l e . i . d a m
frobenius	p eu . l o . b e . n i . u . s eu
hein	h e . i n
sanders	s ae n . d eo . s eu
maseru	m a . s e . l u
mark	m a . l eu . k eu
sylvester	s i l . b e . s eu . t eo
huggins	h eo . g i n . s eu
langland	l ae ng . g eu l . l eo n . d eu
paisiello	p a . i . s i . e l . l o
erich	e . l i . h i
northumberland	n o . s eo m . b eo l . l ae n . d eu
avery	e . b eo . l i
rohrer	l o . l eo
weiner	wa . i . n eo
kolmogorov	k o l . m o . g o . l o . p eu
saussure	s o . s wi . l eu
peron	p e . l o n
ryszard	l i . s eu . j a . d eu
kronecker	k eu . l o . n e . k eo
manuela	m a . n u . e l . l a
kirkland	k eo . k eu l . l eo n . d eu
luigi	l u . i . j i
herrera	h e . l e . l a
glemp	g eu l . l e m . p eu
nord	n o . d eu
toller	t o l . l eo
kaliningrad	k a l . l i . n i n . g eu . l a . d eu
bernstein	b eo n . s eu . t a . i n
sams	s ae m . s eu
tora	t o . l a
molnar	m o l . n a
pere	p e . l eu
karlfeldt	k a l . p e l . t eu
aretino	a . l e . t i . n o
owen	o . we n
biya	b i . ya
ivan	i . b a n
nurmi	n u . l eu . m i
feinberg	p a . i n . b eo . g eu
goldbeck	g o l . d eu . b e g
epirus	e . p i . l u . s eu
alan	ae l . l eo n
chess	ch e . s eu
zion	s i . o n
arndt	a . l eu n . t eu
pittsburgh	p i . ch i . b eo . g eu
copenhagen	k o . p e n . h a . g e n
chippendale	ch i . p e n . d e . i l
giusti	j u . s eu . t i
martha	m a . s a
koopmans	k u . p eu . m eo n . s eu
tiselius	t i . s e l . l i . u . s eu
franz	p eu . l a n . ch eu
parry	p e . l i
flagstad	p eu l . l a . g eu . s eu . t a
schlaf	s yu l . l a . p eu
sammy	s ae . m i
heckel	h e . k e l
joyce	j o . i . s eu
rodenbach	l o . d e n . b a . h eu
egbert	e . g eu . b eo . t eu
gianfranco	j a n . p eu . l a ng . k o
dunn	d eo n
freytag	p eu . l a . i . t a . k eu
rudenko	l u . d e n . k o
klimt	k eu l . l i m . t eu
sexton	s e g . s eu . t eo n
kline	k eu l . l a . i n
noether	n oe . t eo
aspinall	a . s eu . p i . n a l
alfons	a l . p o n . s eu
lauren	l o . l e n
macy	m e . i . s i
greenberg	g eu . l i n . b eo . g eu
kiss	k i . s i
rathenau	l a . t e . n a . u
castiglione	k a . s eu . t i l . l i . o . n e
rachel	l a . h e l
byron	b a . i . l eo n
neilson	n i l . s eu n
house	h a . u . s eu
wolsey	u l . j i
fresnel	p eu . l e . n e l
queens	k wi n . j eu
sunday	s eo n . d e . i
curtius	k u . l eu . t i . u . s eu
avellaneda	a . b e . ya . n e . d a
hilty	h i l . t i
kennan	k e . n eo n
godfrey	g o . d eu . p eu . l i
montpellier	m o ng . p e l . l i . e
robertson	l o . b eo . t eu . s eu n
amritsar	a m . l i . ch a . l eu
brangwyn	b eu . l ae ng . g wi n
curel	k wi . l e l
lassus	l a . s u . s eu
collin	k o l . l i n
summers	s eo . m eo . s eu
rotterdam	l o . t e . l eu . d a m
boas	b o . ae . s eu
mazowiecki	m a . j o . b i . e . ch eu . k i
akron	ae . k eu . l eo n
pierluigi	p i . e . l eu l . l u . i . j i
sears	ss i . eo . s eu
kisangani	k i . s a ng . g a . n i
freeman	p eu . l i . m eo n
fremont	p eu . l e . m o n . t eu
wald	wo l . d eu
ficino	p i . ch i . n o
kocher	k o . h eo
neumann	n o . i . m a n
pasto	p a . s eu . t o
benedikt	b e . n e . d i g . t eu
amman	a m . m a n
gibbon	g i . b eo n
caro	k a . l o
beust	b o . i . s eu . t eu
paul	p o l
mcbride	m ae g . b eu . l a . i . d eu
houssay	u . s a . i
mahmoud	m a . m u . d eu
elam	e l . l a m
rockingham	l a g . k i ng . h ae m
edith	e . d i . s eu
acapulco	a . k a . p u l . k o
schneider	s yu . n a . i . d eo
jongkind	yo ng . k i n . t eu
peacock	p i . k o g
husseini	h u . s e . i . n i
cary	k ae . l i
rabelais	l a . b eu l . l e
hedge	h e . j i
larsen	l a . l eu . s e n
daniele	d a . n i . e l
mole	m o l
colombia	k o l . l o m . b i . a
ransom	l ae n . s eo m
urbain	wi . l eu . b ae ng
backhaus	b a . k eu . h a . u . s eu
camper	k a m . p e . l eu
massachusetts	m ae . s a . ch u . s e . ch eu
anderson	ae n . d eo . s eu n
mann	m a n
barber	b a . b eo
bethlehem	b e . d eu l . l e . h e m
heyden	h e . i . d e n
heath	h i . s eu
lamb	l ae m
rollo	l o l . l o
clearwater	k eu l . l i . eo . wo . t eo
torres	t o . l e . s eu
ruben	l u . b e n
sewell	s yu . eo l
wycherley	wi . ch eo l . l i
cohan	k o . h ae n
yahya	ya . h i . a
fowler	p a . u l . l eo
issac	a . i . j a g
rudiger	l u . d i . g eo
wackenroder	b a . k e n . l o . d eo
hale	h e . i l
biel	b i . e l
pons	p o ng . s eu
lipps	l i b . s eu
strafford	s eu . t eu . l ae . p eo . d eu
alison	ae l . l i . s eu n
meunier	m oe . n i . e
bonneville	b o . n e . b i l
hobsbawm	h o b . s eu . b o m
dale	d e . i l
tallis	t ae l . l i . s eu
estrada	e . s eu . t eu . l a . d a
melvin	m e l . b i n
einthoven	e . i n . t eu . h o . b e n
schwitters	s yu . b i . t eo . s eu
louis	l u . i
sneh	s eu . n e
olena	o l . n e . n a
william	b i l . l i . a m
ziegler	ch i . g eu l . l eo
honegger	o . n e . g e . l eu
lim	l i m
matheson	m a . t e . j o n
lutz	l u . ch eu
fiorentino	p i . o . l e n . t i . n o
more	m o . eo
bridget	b eu . l i . j i . t eu
pott	p o . t eu
anthony	a n . s o . n i
hobson	h o b . s eu n
loy	l o . i
baty	b a . t i
bendix	b e n . d i g . s eu
patricia	p ae . t eu . l i . s ya
lindsey	l i n . j i
sholes	s yo l . s eu
layton	l e . i . t eu n
habib	h a . b i . b eu
idris	i . d eu . l i . s eu
harriman	h ae . l i . m eo n
pomponazzi	p o m . p o . n a . ch i
bitter	b i . t eo
dicey	d a . i . s i
parma	p a . l eu . m a
nestor	n e . s eu . t o . l eu
temin	t e . m i n
bethel	b e . d e l
wenders	b e n . d eo . s eu
bautista	b a . t i . s eu . t a
kenneth	k e . n e . s eu
riemenschneider	l i . m e n . s yu . n a . i . d eo
bonnici	b o . n i . ch i
peyton	p e . i . t eu n
purdy	p eo . d i
tarkington	t a . k i ng . t eo n
barmen	b a . l eu . m e n
hauser	h a . u . j eo
cano	k a . n o
martin	m a . l eu . t ae ng
lynda	l i n . d a
michelson	m a . i . k eo l . s eu n
hardy	h a . d i
kreutzer	k eu . l o . i . ch eo
vanuatu	b a . n u . a . t u
verdi	b e . l eu . d i
waltham	wo l . s eo m
thorndike	s o n . d a . i . k eu
lini	l i . n i
mesopotamia	m e . s o . p o . t a . m i . a
tegucigalpa	t e . g u . s i . g a l . p a
ilse	i l . s eu
kerrigan	k e . l i . g eo n
ripley	l i . p eu l . l i
charleston	ch a l . s eu . t eo n
fini	p i . n i
carver	k a . b eo
rowell	l o . we l
jensen	ye n . s e n
jamieson	j e . m i . s eu n
compton	k o m . p eu . t eo n
wangchuck	wa ng . ch u . k eu
sydney	s i . d eu . n i
paul	b a . u l
dillon	d i l . l eo n
lyly	l i l . l i
budapest	b u . d a . p e . s eu . t eu
lill	l i l
silvia	s i l . b i . a
negro	n i . g eu . l o
spinoza	s eu . p i . n o . j a
bethell	b e . d e l
roland	l o l . l a ng
ephesus	e . p e . s u . s eu
castillo	k a . s eu . t i l . l o
bayard	b a . ya . l eu
venter	b e n . t eo
celeste	s e l . l e . s eu . t eu
antwerp	ae n . t eu . wo . p eu
emmerich	e . m eo . l i . h i
kanin	k a . n i n
buffon	b wi . p o ng
dina	d i . n a
dowling	d a . u l . l i ng
jouhaux	j u . o
desmoulins	d e . m u l . l ae ng
secchi	s e . k i
dufy	d wi . p i
franck	p eu . l a ng . k eu
gemma	j e . m a
henryk	h e n . l i . k eu
kuznets	k u . j eu . n e . ch eu
horst	h o . l eu . s eu . t eu
michael	m i . s we l
halstead	h a l . s eu . t ae . d eu
gorbachev	g o . l eu . b a . ch o . p eu
sid	s i . d eu
vos	b o . s eu
sonya	s o . n ya
krishna	k eu . l i . s yu . n a
astana	a . s eu . t a . n a
capa	k a . p a
ratzinger	l a . ch i ng . g eo
planck	p eu l . l a ng . k eu
dias	d i . eo . s eu
dod	d o . d eu
seneca	s e . n e . k a
dacca	d a . k a
szell	s e l
spontini	s eu . p o n . t i . n i
jarre	j a . l eu
petri	p e . t eu . l i
sorel	s o . l e l
barroso	b a . l o . s u
addington	ae . d i ng . t eo n
gobineau	g o . b i . n o
lefebvre	l eu . p e . b eu . l eu
ronan	l o . n a n
grote	g eu . l o . t eu
anatolia	a . n a . t o l . l i . a
amy	e . i . m i
wagner	b a . g eu . n eo
bocage	b o . k a . j e
ukraine	u . k eu . l a . i . n a
horowitz	h o . l o . b i . ch eu
roos	l u . s eu
zdenek	j eu . d e . n e g
arenas	a . l e . n a . s eu
sparks	s eu . p a g . s eu
southampton	s a . u . s ae m . p eu . t eo n
mottelson	m o . t e l . s o n
etcheverry	e . ch wi . b e . l i
isaac	i . s a g
kinshasa	k i n . s ya . s a
galtung	g a l . t u ng
donat	d o . n a . t eu
eduard	e . d u . a . l eu . t eu
greenspan	g eu . l i n . s eu . p eo n
arab	a . l a b
karol	k a . l o l
batoni	b a . t o . n i
baku	b a . k u
asquith	ae . s eu . k wi . s eu
fabry	p a . b eu . l i
solana	s o l . l a . n a
jaspers	ya . s eu . p eo . s eu
colin	k o l . l ae ng
bieber	b i . b eo
monroy	m o n . l o . i
reich	l a . i . h i
winnie	wi . n i
dorothy	d o . l o . s i
ruby	l u . b i
ulaanbaatar	u l . l a n . b a . t o . l eu
philip	b i l . l i b
hawkins	h o . k i n . s eu
scheffel	s ye . p e l
henderson	h e n . d eo . s eu n
gower	g a . wo
dyson	d a . i . s eu n
heitor	h e . i . t o . l eu
farley	p a l . l i
bruch	b eu . l u . h eu
annapolis	a . n a . p o l . l i . s eu
bianco	b i . a n . k o
lange	l a ng . e
colby	k o l . b i
benacerraf	b e . n a . s e . l a . p eu
matamoros	m a . tt a . m o . l o . s eu
romero	l o . m e . l o
mommsen	m o m . j e n
cash	k ae . s i
empson	e m . p eu . s eu n
ciano	ch i . a . n o
pieter	p i . t eo
tiberius	t i . b e . l i . u . s eu
segal	s i . g a l
dee	d i
davidson	d e . i . b i . s eu n
lloyd	l o . i . d eu
colgate	k o l . g e . i . t eu
westerberg	b e . s eu . t e . l eu . b e . l i
haggard	h ae . g eo . d eu
rosalyn	l o . j eo l . l i n
lodge	l o . j i
grotewohl	g eu . l o . t e . b o l
eckermann	e . k eo . m a n
azevedo	a . j e . b e . d o
bothe	b o . t e
vailland	b a . ya ng
augustin	o . g u . s eu . t i n
perutz	p eo . l u . ch eu
hugh	h yu
naumann	n a . u . m a n
bergman	b eo . g eu . m eo n
kirov	k i . l o . p eu
greta	g eu . l e . t a
galpin	g a l . p i n
robles	l o . b eu l . l e . s eu
fidel	p i . d e l
fernando	p e . l eu . n a n . d o
perm	p e . l eu m
commons	k o . m eo n . s eu
pope	p o . p eu
warburg	b a . l eu . b u . l eu . k eu
tito	t i . t o
beauvoir	b o . b u . a . l eu
stanford	s eu . t ae n . p eo . d eu
steffi	s yu . t e . p i
gerald	j e . l eo l . d eu
lesser	l e . s eo
gettysburg	g e . t i . j eu . b eo . g eu
malden	m o l . d e n
gambier	g ae m . b i . eo
blanche	b eu l . l a ng . s wi
pasternak	p a . s eu . t e . l eu . n a . k eu
houghton	h o . t eu n
pretoria	p eu . l i . t o . l i . a
mead	m i . d eu
nureyev	n u . l e . ye . p eu
sadat	s a . d a . t eu
sen	s e n
pavel	p a . b e l
burckhardt	b u . l eu . k eu . h a . l eu . t eu
terborch	t e . l eu . b o . l eu . h i
bryan	b eu . l a . i . eo n
bellevue	b e l . l e . b yu
kuropatkin	k u . l o . p a s . k i n
dornier	d o . l eu . n i . e
kraepelin	k eu . l e . p e l . l i n
stephens	s eu . t i . b eu n . s eu
thyssen	t i . s e n
muir	m yu . eo
shapley	s yae . p eu l . l i
birkhoff	b eo . k o . p eu
steinmetz	s eu . t a . i n . m e . ch eu
madeira	m a . d e . i . l a
bebel	b e . b e l
boccherini	b o . k e . l i . n i
ruska	l u . s eu . k a
ely	i l . l i
kamil	k a . m i l
lafontaine	l a . p o ng . t e n
buonarroti	b u . o . n a . l o . t i
hertz	h e . l eu . jj eu
gozzi	g o . ch i
weiss	b a . i . s eu
bruin	b eu . l wi n
pietro	p i . e . t eu . l o
nick	n i g
wiener	wi . n eo
hayek	h a . i . e . k eu
mecklenburg	m e . k eu l . l e n . b u . l eu . k eu
cumberland	k eo m . b eo l . l ae n . d eu
shoup	s yu . p eu
esaias	e . s a . i . a . s eu
hinds	h a . i n . j eu
freiburg	p eu . l a . i . b u . l eu . k eu
moniuszko	m o . n i . u . s yu . k o
craven	k eu . l e . i . b eu n
yvonne	i . b o n . n eu
nipkow	n i b . k o
agrippina	a . g eu . l i . p i . n a
lott	l o s
koror	k o . l o . l eu
hewitt	h yu . i s
radcliffe	l ae . d eu . k eu l . l i . p eu
massinger	m ae . s i n . j eo
gwyn	g eu . wi n
nikolaev	n i . k o l . l a . ye . p eu
grasse	g eu . l ae . s eu
maddox	m ae . d o g . s eu
saxon	s ae g . s eu n
jennings	j e . n i ng . s eu
brenda	b eu . l e n . d a
lachmann	l a . h eu . m a n
tallahassee	t ae l . l eo . h ae . s i
kimberley	k i m . b eo l . l i
august	a . u . g u . s eu . t eu
villa	b i l . l a
butenandt	b u . t e . n a n . t eu
nasser	n a . s e . l eu
newcomen	n yu . k eo . m eo n
jimmy	j i . m i
oldham	o l . d eu . h ae m
dietzgen	d i . ch eu . g e n
cromer	k eu . l o . m eo
claes	k eu l . l a . s eu
coleman	k o l . m ae n
angora	a ng . g o . l a
smit	s eu . m i . t eu
rossini	l o . s i . n i
ramsey	l ae m . j i
guinea	g i . n i
mai	m a . i
ricky	l i . k i
lewis	l u . i . s eu
boult	b o . u l . t eu
doris	d o . l i . s eu
charlottetown	s ya l . l eo s . t a . u n
lanier	l eo . n i . eo
cronaca	k eu . l o . n a . k a
aragon	a . l a . g o n
langbein	l ae ng . b a . i n
gogarten	g o . g a . l eu . t e n
everett	e . b eo . l e s
mahendra	m a . h e n . d eu . l a
sinai	s i . n a . i
toni	t a . n i
ankara	a ng . k a . l a
montessori	m o n . t e . s o . l i
ginsburg	g i n . j eu . b eo . g eu
jarry	j a . l i
lujo	l u . j o
elba	e l . b a
valentine	b a l . l e n . t a . i n
ashton	ae . s yu . t eo n
gustaf	g u . s eu . t a . p eu
colette	k o l . l e . t eu
gascoyne	g ae . s eu . k o . i n
nujoma	n u . j o . m a
arp	a . l eu . p eu
allon	a l . l o n
guillaumin	g i . yo . m ae ng
margarete	m a . l eu . g a . l e . t e
braine	b eu . l e . i n
clifton	k eu l . l i . p eu . t eo n
capuana	k a . p u . a . n a
persson	p e . l eu . s o n
cleveland	k eu l . l i . b eu l . l ae n . d eu
riverside	l i . b eo . s a . i . d eu
vidor	b i . d eo
fajans	p a . ya n . s eu
natta	n a . t a
bowring	b o . u . l i ng
navarre	n a . b a . l eu
feldstein	p e l . d eu . s eu . t a . i n
patterson	p ae . t eo . s eu n
newlands	n yu . l ae n . j eu
quito	k i . t o
austria	o . s eu . t eu . l i . a
dave	d e . i . b eu
paula	p o l . l a
burnham	b eo n . h ae m
agarwal	a . g a . l eu . wa l
grew	g eu . l u
hettner	h e . t eu . n eo
gal	g a l
geneva	j e . n e . b a
georges	j e . o . l eu . j e . s eu
beuys	b o . i . s eu
bradford	b eu . l e . d eu . p o . d eu
halle	h a l . l e
poulet	p u l . l e
vondel	p o n . d e l
hearst	h eo . s eu . t eu
voroshilov	b o . l o . s i l . l o . p eu
khrushchev	h eu . l u . s i . ch o . p eu
havana	a . b a . n a
labuan	l a . b u . a n
karlsruhe	k a . l eu l . s eu . l u . e
lobe	l o . b e
kant	k a n . t eu
ghana	g a . n a
willem	b i l . l e m
sigmund	s i . g eu . m eo n . d eu
eames	i m . s eu
harare	h a . l a . l e
moss	m o . s eu
welsh	we l . s wi
john	j o n
panama	p a . n a . m a
hibernia	h a . i . b eo . n i . a
gibson	g i . b eu . s eu n
taglioni	t a l . l i . o . n i
bern	b e . l eu n
cudworth	k eo . d eu . wo . s eu
hepworth	h e b . wo . s eu
lewes	l u . i . s eu
conrad	k o n . l a . d eu
magyar	m a . j a . l eu
guayaquil	g wa . ya . k i l
lorenzo	l o . l e n . ch o
ewald	e . b a l
ellsworth	e l . j eu . wo . s eu
camerarius	k a . m e . l a . l i . u . s eu
gaul	g o l
tanzania	t a n . j a . n i . a
jens	ye n . s eu
pea	p e . n ya
wynn	wi n
teasdale	t i . j eu . d e . i l
joachim	yo . a . k i m
bolzano	b o l . ch a . n o
galli	g a l . l i
desiderius	d e . s i . d e . l i . u . s eu
zeyer	jj eo . ye . eo l
suffolk	s eo . p eo g
golding	g o l . d i ng
philippi	b i l . l i b . b o
caplet	k ae . p eu l . l i s
lacan	l a . k a ng
falconet	p a l . k o . n e
yannick	ya . n i g
goldberg	g o l . d eu . b eo . g eu
soledad	s o l . l i . d a . d eu
mano	m a . n o
both	b o . s eu
ceylon	s i l . l o n
agassi	ae . g eo . s i
luxemburg	l u g . s e m . b u . l eu . k eu
maggie	m ae . g i
edgeworth	e . j i . wo . s eu
guy	g a . i
sherrington	s ye . l i ng . t eo n
wanda	wa n . d a
lucien	l wi . s i . ae ng
ouagadougou	wa . g a . d u . g u
mesquita	m e . s eu . k i . t a
laban	l a . b a n
allan	ae l . l eo n
norton	n o . t eo n
vancouver	b ae n . k u . b eo
gonzalo	g o n . s a l . l o
rohmer	l o . m e . l eu
vertov	b e . l eu . t o . p eu
sally	s ae l . l i
rosemary	l o . j eu . m e . l i
hank	h ae ng . k eu
dodge	d a . j i
ericson	e . l i g . s eu n
brassens	b eu . l a . s a ng . s eu
salas	s a l . l a . s eu
wilton	wi l . t eo n
mogens	m o . g e n . s eu
burnley	b eo n . l i
tiso	t i . s o
sternberg	s eu . t eo n . b eo . g eu
burstein	b eo . s eu . t a . i n
pasternack	p a . s eu . t eo . n e g
hooper	h u . p eo
wheatstone	h wi . t eu . s eu . t o n
monet	m o . n e
hubel	h eo . b eu l
boden	b o . d e n
graf	g eu . l a . p eu
winfried	wi n . p eu . l e . d eu
deaver	d i . b eo
earl	eo l
lana	l a . n a
jonson	j o n . s eu n
ord	o . d eu
franks	p eu . l ae ng . k eu . s eu
ormandy	o . l eu . m eo n . d i
yunis	yu . n i . s eu
eckert	e . k e . l eu . t eu
reinach	l a . i . n a . h eu
luca	l u . k a
eriksen	e . l i g . s e n
minot	m a . i . n eo s
black	b eu l . l ae g
xenakis	k eu . s e . n a . k i . s eu
lasse	l a . s e
cairnes	k e . eo n . s eu
inglis	i ng . g eu l . l i . s eu
schwann	s yu . b a n
schweizer	s yu . b a . i . ch eo
wohlgemut	b o l . g e . m u . t eu
thorez	t o . l e . j eu
prosper	p eu . l o . s eu . p e . l eu
rainwater	l e . i n . wo . t eo
vigo	b i . g o
lambeth	l ae m . b eo . s eu
stolypin	s eu . t o l . l i . p i n
bishkek	b i . s yu . k e . k eu
king	k i ng
euclid	yu . k eu l . l i . d eu
sisley	s i . s eu l . l e
childe	ch a . i l . d eu
menzel	m e n . j e l
laurencin	l o . l a ng . s ae ng
freiligrath	p eu . l a . i l . l i . g eu . l a . t eu
kiribati	k i . l i . b a . s i
hamsun	h a m . s u n
bainbridge	b e . i n . b eu . l i . j i
hahnemann	h a . n e . m a n
lake	l e . i . k eu
karlgren	k a l . g eu . l e n
myron	m i . l o n
gibb	g i b
guyon	g wi . yo ng
greene	g eu . l i n
gunter	g eo n . t eo
urban	u . l eu . b a n
zakaria	j a . k a . l i . a
lasswell	l a . s eu . we l
mistral	m i . s eu . t eu . l a l
hardie	h a . d i
ryan	l a . i . eo n
britten	b eu . l i . t eu n
caird	k e . eo . d eu
medhurst	m e . d eu . h eo . s eu . t eu
ferguson	p eo . g eo . s eu n
hannah	h ae . n a
galilei	g a l . l i l . l e . i
davidoff	d ae . b i . d o . p eu
frost	p eu . l o . s eu . t eu
olander	o l . l ae n . d eo
olga	o l . g a
mart	m a . l eu . t eu
bergen	b e . l eu . g e n
torrens	t o . l eo n . s eu
verlaine	b e . l eu l . l e n
paris	p a . l i
etienne	e . t i . e n
miriam	m i . l i . eo m
magnus	m a . g eu . n u . s eu
edward	e . d eu . wo . d eu
berenson	b e . l eo n . s eu n
rodrigo	l o . d eu . l i . g o
lise	l i . j e
lowell	l o . we l
bakan	b a . k a n
kaye	k e . i
nukualofa	n u . k u . a l . l o . p a
madison	m ae . d i . s eu n
hus	h u . s eu
dowdeswell	d o . d e . s eu . b e l
asuncion	a . s u n . s i . o n
stoyanov	s eu . t o . ya . n o . p eu
frankfurt	p eu . l a ng . k eu . p u . l eu . t eu
bloch	b eu l . l o . k eu
cremona	k eu . l e . m o . n a
schulze	s yu l . ch e
caxias	k a . s i . a . s eu
procter	p eu . l o g . t eo
montemayor	m o n . t e . m a . yo . l eu
schickele	s i . k e l . l e
flavius	p eu l . l a . b i . u . s eu
wendy	we n . d i
canterbury	k ae n . t eo . b e . l i
nimitz	n i . m i . ch eu
perry	p e . l i
tomas	t o . m a . s eu
mckenzie	m ae g . k e n . j i
olson	o l . s eu n
lully	l wi l . l i
kanpur	k a n . p u . l eu
cali	k a l . l i
alice	e l . l i . s eu
modena	m o . d e . n a
brundtland	b eu . l u n . t eu l . l a n
agnelli	a . n ye l . l i
bonnet	b o . n e
workman	wo . k eu . m ae n
gerasimov	g e . l a . s i . m o . p eu
proust	p eu . l u . s eu . t eu
armenia	a . l eu . m e . n i . a
salten	j a l . t e n
portman	p o . t eu . m a n
flemming	p eu l . l e . m i ng
hankel	h a ng . k e l
bernardino	b e . l eu . n a . l eu . d i . n o
harwood	h a . u . d eu
cairo	k a . i . l o
rasa	l a . s a
gramme	g eu . l a m
cuvier	k wi . b i . e
dimitrov	d i . m i . t eu . l o . p eu
ambrosius	a m . b eu . l o . s i . u . s eu
claude	k eu l . l a . u . d eu
molotov	m o l . l o . t o . p eu
payne	p e n
curzon	k eo . j eu n
cope	k o . p eu
lacombe	l a . k o m
khalid	k a l . l i . d eu
alicia	ae l . l i . s ya
irwin	eo . wi n
licht	l i . h i . t eu
witherspoon	wi . d eo . s eu . p u n
ochirbat	o . ch i . l eu . b a . t eu
munro	m eo n . l o
hearn	h o n
svensson	s eu . b e n . s o n
emeric	i . m e . l i g
memphis	m e m . p i . s eu
hesse	h e . s e
bly	b eu l . l a . i
stevens	s eu . t i . b eu n . s eu
jaruzelski	ya . l u . j e l . s eu . k i
neander	n e . a n . d eo
makarov	m a . k a . l o . p eu
johannes	yo . h a . n e . s eu
senna	s e . n a
mandeville	m ae n . d eo . b i l
murnau	m u . l eu . n a . u
chao	ch a . o
webern	b e . b e . l eu n
narciso	n a . l eu . s i . s o
bridgeport	b eu . l i . j i . p o . t eu
loeb	l eo . b eu
eusebio	e . u . s e . b i . u
bow	b o . u
artsybashev	a . l eu . ch i . b a . s ye . p eu
carlin	k a l . l i n
jordaens	yo . l eu . d a n . s eu
mutter	m u . t eo
frey	p eu . l o . i
barr	b a
hindustan	h i n . d u . s eu . t a n
magdalena	m a g . d a l . l e . n a
elaine	i l . l e . i n
liebmann	l i . p eu . m a n
pellegrini	p e l . l e . g eu . l i . n i
hunter	h eo n . t eo
mauriac	m o . l i . a g
banda	b a n . d a
massimo	m a . s i . m o
ferrante	p e . l a n . t eu
portinari	p o . l eu . t i . n a . l i
ireland	a . i l . l ae n . d eu
poisson	p u . a . s o ng
tarawa	t a . l a . wa
appel	a . p e l
achilles	a . k i l . l e . s eu
risa	l i . s a
donaldson	d o . n a l . d eu . s eu n
adonis	a . d o . n i . s eu
peary	p i . eo . l i
potsdam	p o . s eu . d a m
mbabane	eu m . b a . b a . n e
beza	b e . j a
glover	g eu l . l o . b eo
lubin	l u . b i n
rosetta	l o . j e . t a
jagger	j ae . g eo
jenny	j e . n i
linde	l i n . d e
valadon	b a l . l a . d o ng
cohen	k o . eo n
mathis	m ae . t i . s eu
nyers	n e . l eu . s i
benin	b e . n ae ng
schally	s ya l . l i
sutton	s eo . t eo n
reykjavik	l e . i . k ya . b i . k eu
quant	k wo n . t eu
schubert	s yu . b e . l eu . t eu
schlick	s yu l . l i . k eu
yvon	i . b o ng
noto	n o . t o
cabot	k ae . b eo s
marton	m a . l eu . t o n
dubinin	d u . b i . n i n
speth	s eu . p e . s eu
esther	e . s eu . d eo
dietrich	d i . t eu . l i . s i
hamlet	h ae m . l i s
vaduz	p a . d u . ch eu
sardou	s a . l eu . d u
baumann	b a . u . m a n
macon	m a . k o ng
phillpotts	p i l . p o . ch eu
cellini	ch e l . l i . n i
gadamer	g a . d a . m eo
guillemin	g i . yu . m ae ng
gloria	g eu l . l o . l i . a
ecevit	e . j e . b i . t eu
buono	b o . n o
gaston	g a . s eu . t o ng
renard	l eu . n a . l eu
sokoloff	s o . k o l . l o . p eu
evansville	e . b eo n . j eu . b i l
drozdova	d eu . l o . j eu . d o . b a
branting	b eu . l a n . t i ng
witz	b i . ch eu
kaminski	k a . m i n . s eu . k i
crabbe	k eu . l ae . b eu
nizan	n i . j a ng
eyring	a . i . l i ng
rudi	l u . d i
salvatore	s a l . b a . t o . l e
gogol	g o . g o l . l i
rios	l i . o . s eu
duclos	d wi . k eu l . l o
ajaccio	a . j a g . s i . o
hazlitt	h ae . j eu l . l i s
tippett	t i . p e s
goth	g o . t eu
crosby	k eu . l o . s eu . b i
krupskaya	k eu . l u . p eu . s eu . k a . ya
kearsley	k i . eo . s eu l . l i
sim	s i m
mercier	m e . l eu . s i . e
fick	p i . k eu
wien	b i n
auriol	o . l i . o l
sorge	s o . l eu . j u
wallace	wo l . l i . s eu
munich	m wi n . h e n
houdon	u . d o ng
schwarz	s yu . wa l . ch eu
domingo	d o . m i ng . g o
geist	g a . i . s eu . t eu
davids	d a . b i . ch eu
inez	a . i . n e . j eu
gamba	g a m . b a
lamarr	l a . m a
grenville	g eu . l e n . b i l
crane	k eu . l e . i n
busch	b u . s yu
esposito	e . s eu . p o . s i . t o
vinci	b i n . ch i
kaschnitz	k a . s yu . n i . ch eu
geibel	g a . i . b e l
baden	b a . d e n
beveridge	b e . b eo . l i . j i
navarro	n a . b a . l o
jaroslav	ya . l o . s eu l . l a . p eu
johnston	j o n . s eu . t o n
humphrey	h eo m . p eu . l i
nascimento	n a . s i . m e n . t u
jessie	j e . s i
penck	p e ng . k eu
eliot	e l . l i . eo . t eu
mate	m e . i . t eu
doha	d o . h a
hedtoft	h e . d eu . t o . p eu . t eu
carnarvon	k a . n a . b o n
waterbury	wo . t eo . b e . l i
herford	h e . eo . p o . t eu
indonesia	i n . d o . n e . s i . a
sienkiewicz	s ye ng . k i . e . b i . ch i
euler	o . i l . l eo
carpaccio	k a . l eu . p a . ch o
harlow	h a l . l o
zweig	ch eu . b a . i . k eu
pablo	p a . b eu l . l o
bonaparte	b o . n a . p a . l eu . t eu
erica	e . l i . k a
castro	k a . s eu . t eu . l o
nubia	n u . b i . a
crommelynck	k eu . l o m . l ae ng . k eu
jefferson	j e . p eo . s eu n
xie	s ye
bergeron	b e . l eu . ye . l o n
allen	ae l . l eo n
acs	ae g . s eu
gaj	g a . i
gonsalves	g o n . s a l . b e . s eu
blackburn	b eu l . l ae g . b eo n
coolidge	k u l . l i . j i
tunis	t wi . n i . s eu
honeywell	h a . n i . we l
kapitsa	k a . p i . ch a
georgina	j o . l eu . j i . n a
trinidad	t eu . l i . n i . d a . d eu
shields	s wi l . d eu
hanslick	h a n . s eu l . l i . k eu
duluth	d eo l . l u . s eu
allison	ae l . l i . s eu n
bratislava	b eu . l a . t i . s eu l . l a . b a
erdmann	e . l eu . d eu . m a n
binding	b i n . d i ng
bouchard	b u . s ya . l eu
mott	m o . t eu
antoni	a n . t o . n i
charlton	ch a l . t eo n
brenner	b eu . l e . n eo
cassou	k a . s u
america	a . m e . l i . k a
brodsky	b eu . l o . d eu . s eu . k i
heiberg	h e . i . b e . l eu . g eu
eigen	a . i . g e n
fitch	p i . ch i
jerusalem	ye . l u . s a l . l e m
hoffmann	h o . p eu . m a n
theo	t e . o
endre	e n . d eu . l e
baier	b a . i . eo
camdessus	k a ng . d eu . s wi
trujillo	t eu . l u . h i . yo
gluck	g eu l . l u . k eu
reischauer	l a . i . s ya . wo
somalia	s o . m a l . l i . a
landau	l a n . d a . u
ramus	l a . m u . s eu
gracchus	g eu . l a . k u . s eu
blumberg	b eu l . l eo m . b eo . g eu
katherine	k ae . s eo . l i n
abell	a . b e l
uzbekistan	u . j eu . b e . k i . s eu . t a n
pole	p o l
ted	t e . d eu
sylvain	s i l . b ae ng
warsaw	b a . l eu . s ya . b a
dallas	d ae l . l eo . s eu
santer	s a ng . t e . l eu
essen	e . s e n
wolcott	wo l . k o . t eu
espinosa	e . s eu . p i . n o . j a
braham	b eu . l ae . h eo m
reiner	l a . i . n eo
springsteen	s eu . p eu . l i ng . s eu . t i n
reilly	l a . i l . l i
aberdeen	ae . b eo . d i n
prager	p eu . l a . g eo
stern	s yu . t e . l eu n
richard	l i . ch a . d eu
holger	h o l . g e . l eu
reid	l i . d eu
pascoli	p a . s eu . k o l . l i
storm	s yu . t o . l eu m
rowe	l o . we
erhard	e . l eu . h a . l eu . t eu
matthias	m a . t i . a . s eu
gama	g a . m a
enrique	e n . l i . k e
hendrickson	h e n . d eu . l i g . s eu n
lexington	l e g . s i ng . t eo n
mou	m eo . u
rolls	l o l . s eu
kaufmann	k a . u . p eu . m a n
gauguin	g o . g ae ng
teitelbaum	t a . i . t e l . b a . u m
ferro	p e . l o
bryullov	b eu . l yu l . l o . p eu
brook	b eu . l u g
dionysius	d i . o . n i . s i
zeeman	j e . m a n
penderecki	p e n . d e . l e . ch eu . k i
gayle	g e . i l
schaap	s eu . k a b
oren	o . l e n
hofmann	h o . p eu . m a n
linz	l i n . ch eu
renata	l e . n a . t a
nilson	n i l . s o n
cassini	k a . s i . n i
chateaubriand	s ya . t o . b eu . l i . a ng
mackinder	m ae . k i n . d eo
sidgwick	s i . j i . wi g
blakeslee	b eu l . l e . i . k eu . s eu l . l i
hill	h i l
erick	e . l i g
nodier	n o . d i . e
johann	yo . h a n
pushkin	p u . s i . k i n
walsh	wa l . s i
shackleton	s yae . k eu l . t eo n
respighi	l e . s eu . p i . g i
delia	d e l . l i . a
busby	b eo . s eu . b i
aldington	o l . d i ng . t eo n
vernon	b eo . n o n
ellen	e l . l e n
ruggiero	l u . j i . e . l o
kirsch	k i . l eu . s wi
scheidemann	s ya . i . d e . m a n
kolar	k o l . l a . l eu
aden	a . d e n
dirac	d i . l ae g
capone	k a . p o . n e
sutherland	s eo . d eo l . l ae n . d eu
krasheninnikov	k eu . l a . s ye . n i n . n i . k o . p eu
liddell	l i . d eu l
hopkins	h o b . k i n . s eu
capote	k eo . p o . t i
ecuador	e . k wa . d o . l eu
wedekind	b e . d e . k i n . t eu
seckel	s e . k eo l
calder	k o l . d eo
abruzzi	a . b eu . l u . ch i
janez	ya . n e . j eu
hauff	h a . u . p eu
filmer	p i l . m eo
marius	m a . l i . u . s eu
ungaretti	u ng . g a . l e . t i
adalbert	a . d a l . b e . l eu . t eu
bo	b o
toledo	t eo l . l i . d o
giulio	j u l . l i . o
amelia	a . m e l . l i . a
jawara	j a . wa . l a
sonja	s o . n ya
maurois	m o . l eu . wa
latimer	l e . i . t i . m eo
porter	p o . t eo
hines	h a . i n . j eu
dempsey	d e m . s i
ryzhkov	l i . s yu . k o . p eu
golden	g o l . d eu n
sherlock	s yeo l . l o g
solis	s o l . l i . s eu
