mari	m a . l i
waterbury	wo . t eo . b e . l i
tobey	t o . b i
sergio	s e . l eu . j o
wanda	wa n . d a
amiens	a . m i . ae ng
rio	l i . u
brooks	b eu . l u g . s eu
morocco	m o . l o . k o
elster	e l . s eu . t eo
fiji	p i . j i
rietveld	l i . t eu . b e l . t eu
kohler	k o l . l eo
kuropatkin	k u . l o . p a s . k i n
darko	d a . l eu . k o
rauch	l o . k eu
merce	m eo . s eu
soto	s o . t o
handler	h ae n . d eu l . l eo
bob	b a b
flesch	p eu l . l e . s wi
allison	ae l . l i . s eu n
smit	s eu . m i . t eu
niki	n i . k i
jade	j e . i . d eu
melvil	m e l . b i l
blanchard	b eu l . l a ng . s ya . l eu
illinois	i l . l i . n o . i
bennett	b e . n e s
viola	b i . o l . l a
heitor	h e . i . t o . l eu
jacobson	j e . i . k o b . s eu n
dora	d o . l a
topeka	t o . p i . k a
giovanni	j o . b a n . n i
honorius	h o . n o . l i . u . s eu
karsavina	k a . l eu . s a . b i . n a
hensel	h e n . j e l
levant	l e . b a n . t eu
luc	l wi . k eu
arthur	a . d eo
boston	b o . s eu . t eo n
cutler	k eo . t eu l . l eo
babylon	b a . b i l . l o n
binding	b i n . d i ng
stefan	s yu . t e . p a n
koopmans	k u . p eu . m eo n . s eu
root	l u . t eu
andrew	ae n . d eu . l yu
moshe	m o . s ye
chamberlain	ch e . i m . b eo l . l i n
wundt	b u n . t eu
ernestine	eo . n i . s eu . t i n
astley	ae . s eu . t eu l . l i
amber	ae m . b eo
boyd	b o . i . d eu
jill	j i l
wharton	wa . t eu n
uccello	u . ch e l . l o
loewy	l o . wi
fournier	p u . l eu . n i . e
jevons	j e . b eo n . s eu
josephson	j o . j i . p eu . s eu n
baylor	b ae . i l . l eo
eliade	e l . l i . a . d e
hacker	h ae . k eo
lowry	l o . l i
grotewohl	g eu . l o . t e . b o l
kasper	k a . s eu . p eo
sawyer	s o . i . eo
tangier	t ae n . j i . eo
barkley	b a . k eu l . l i
cartan	k a . l eu . t a ng
finch	p i n . ch i
ely	i l . l i
niebuhr	n i . b u . eo
condillac	k o ng . d i . ya . k eu
abrams	a . b eu . l a m . s eu
rawlinson	l o l . l i n . s eu n
angelica	a n . j e l . l i . k a
luchino	l u . k i . n o
damascus	d a . m a . s eu . k u . s eu
hammerstein	h ae . m eo . s eu . t a . i n
steers	s eu . t i . eo . s eu
hellman	h e l . m eo n
ruysdael	l o . i . s eu . d a l
bodo	b o . d o
schwarzkopf	s yu . wo . ch eu . k o . p eu
dolphin	d o l . p i n
kapitsa	k a . p i . ch a
jude	yu . d a
gusou	g u . ss eo . u
bess	b e . s eu
alexis	a l . l e g . s i
billings	b i l . l i ng . s eu
durant	d yu . l ae n . t eu
mcgrath	m ae g . g eu . l a . s eu
rushdie	l u . s yu . d i
ladislav	l a . d i . s eu l . l a . p eu
sperling	s eu . p eo l . l i ng
horst	h o . l eu . s eu . t eu
condo	k o n . d o
zapata	s a . p a . t a
casablanca	k a . s a . b eu l . l a ng . k a
bristol	b eu . l i . s eu . t eu l
hensen	h e n . j e n
stuart	s eu . t yu . eo . t eu
dorsey	d o . eo . s i
fleet	p eu l . l i . t eu
ashraf	a . s yu . l a . p eu
basso	b a . s o
goes	g u . s eu
aldanov	a l . d a . n o . p eu
angela	a n . j e l . l a
doisy	d o . i . j i
alice	e l . l i . s eu
lionel	l i . o . n e l
waltari	b a l . t a . l i
stone	s eu . t o n
lydia	l i . d i . a
mario	m a . l i . o
quebec	k we . b e g
sikorski	s i . k o . l eu . s eu . k i
molnar	m o l . n a
boghossian	b o . g o . s i . a ng
kirsch	k i . l eu . s wi
bion	b i . o n
croce	k eu . l o . ch e
rana	l a . n a
wolfowitz	u l . p o . wi . ch eu
rolls	l o l . s eu
ashley	ae . s yu l . l i
bonnard	b o . n a . l eu
gerasimov	g e . l a . s i . m o . p eu
andrade	a n . d eu . l a . d e
nouakchott	n u . a g . s yo . t eu
fiori	p i . o . l i
polanyi	p o l . l a . n i
gallagher	g ae l . l eo . g eo
dlamini	d eu l . l a . m i . n i
melinda	m e l . l i n . d a
geulincx	g oe l . l i ng . k eu . s eu
engel	e ng . g e l
aram	a . l a m
guillermo	g i . ye . l eu . m o
maurras	m o . l a . s eu
ferdianand	p e . l eu . d i . n a n . d eu
luca	l u . k a
bauer	b a . u . eo
angell	e . i n . j eo l
fiedler	p i . d eu l . l eo
idaho	a . i . d a . h o
mars	m a . l eu . s eu
hernandez	h e . l eu . n a n . d e . s eu
bergson	b e . l eu . g eu . s o ng
ayala	a . ya l . l a
kusch	k u . s i
liz	l i . j eu
valentino	b a l . l e n . t i . n o
monet	m o . n e
bisset	b i . s e s
barnard	b a . n eo . d eu
godard	g o . d a . l eu
balboa	b a l . b o . a
sonya	s o . n ya
clementi	k eu l . l e . m e n . t i
petipa	p e . t i . p a
novgorod	n o . b eu . g o . l o . t eu
homer	h o . m eo
gertsen	g e . l eu . ch e n
holger	h o l . g e . l eu
schleiden	s yu l . l a . i . d e n
loewi	l oe . b i
rozier	l o . j i . e
hewlett	h yu . l e s
manson	m ae n . s eu n
erdmann	e . l eu . d eu . m a n
abdus	a b . d u . s eu
winston	wi n . s eu . t eo n
carpenter	k a . p e n . t eo
dallapiccola	d a l . l a . p i . k o l . l a
louis	l u . i . s eu
hall	h o l
sachs	s ae g . s eu
norman	n o . l eu . m a n
segal	s i . g a l
naples	n a . p o l . l i
patinir	p a . t i . n i . l eu
brazzaville	b eu . l a . j a . b i l
tod	t o . d eu
tahiti	t a . h i . t i
edwards	e . d eu . wo . j eu
galloni	g ae l . l o . n i
jenny	j e . n i
burke	b eo . k eu
chabrier	s ya . b eu . l i . e
reiner	l a . i . n eo
mason	m e . i . s o n
zimmern	j i m . m e . l eu n
queneau	k eu . n o
longfellow	l o ng . p e l . l o
seyfert	s i . p eo . t eu
jamison	j e . i . m i . s eu n
sardinia	s a . l eu . d i . n i . a
clive	k eu l . l a . i . b eu
friche	p eu . l i . ch e
rydberg	l wi . d eu . b e . l i
wilhelm	b i l . h e l . l eu m
mikoyan	m i . k o . ya n
desai	d e . s a . i
isherwood	i . s yeo . u . d eu
grein	g eu . l a . i n
winfried	wi n . p eu . l e . d eu
rasa	l a . s a
felix	p e l . l i g . s eu
endre	e n . d eu . l e
bloch	b eu l . l o . k eu
alexander	a l . l e g . s a n . d eo
corsi	k o . s i
kroemer	k eu . l o . m eo
turkmenistan	t u . l eu . k eu . m e . n i . s eu . t a n
beveridge	b e . b eo . l i . j i
annika	a . n i . k a
herbart	h e . l eu . b a . l eu . t eu
schultz	s yu l . ch eu
anthony	a n . s o . n i
lepidus	l e . p i . d u . s eu
libya	l i . b i . a
fielding	p i l . d i ng
rembrandt	l e m . b eu . l a n . t eu
quasimodo	k wa . s i . m o . d o
ficino	p i . ch i . n o
neumann	n o . i . m a n
juglar	j wi . g eu l . l a
langdon	l ae ng . d eo n
clearwater	k eu l . l i . eo . wo . t eo
lennon	l e . n o n
gaspar	g a . s eu . p a
bebel	b e . b e l
flint	p eu l . l i n . t eu
midas	m i . d a . s eu
middlesex	m i . d eu l . s e g . s eu
stevens	s eu . t i . b eu n . s eu
inglis	i ng . g eu l . l i . s eu
willie	wi l . l i
lemarchand	l eu . m a g . s yeo ng
mecklenburg	m e . k eu l . l e n . b u . l eu . k eu
falkland	p o . k eu l . l ae n . d eu
marriott	m a . l i . o . t eu
croatia	k eu . l o . a . t i . a
avellaneda	a . b e . ya . n e . d a
macedonia	m a . k e . d o . n i . a
kurt	k u . l eu . t eu
bakhtin	b a . h eu . ch i n
junqueiro	j u n . k e . i . l u
lederberg	l e . d eo . b eo . g eu
toni	t a . n i
willcocks	wi l . k o g . s eu
boswell	b o . j eu . we l
tomsk	t o m . s eu . k eu
domingo	d o . m i ng . g o
leighton	l e . i . t eu n
langevin	l a ng . j u . b ae ng
kaplan	k ae . p eu l . l a n
antonin	a n . t o . n i n
gaetano	g a . e . t a . n o
gosse	g o . s eu
stoney	s eu . t o . n i
garner	g a . n eo
palissy	p a l . l i . s i
colette	k o l . l e . t eu
rolf	l o l . p eu
gullstrand	g u l . s eu . t eu . l a n . d eu
prager	p eu . l a . g eo
antonia	a n . t o . n i . a
banting	b ae n . t i ng
shestov	s ye . s eu . t o . p eu
caetano	kk a . e . tt a . n u
teresa	t e . l e . s a
herbert	h eo . b eo . t eu
kilkenny	k i l . k e . n i
makarenko	m a . k a . l e n . k o
kamenev	k a . m e . n e . p eu
axel	a g . s e l
giacosa	j a . k o . s a
cannon	k ae . n eo n
blanche	b eu l . l a ng . s wi
zaragoza	s a . l a . g o . s a
duffy	d eo . p i
batman	b ae . t eu . m ae n
poul	p o . u l
servais	s e . l eu . b e
granger	g eu . l e . i n . j eo
rambert	l ae m . b eo . t eu
nattier	n a . t i . e
healey	h i l . l i
martin	m a . l eu . t i n
quintana	j i n . t a . n a
ilse	i l . s eu
sucre	s u . k eu . l e
gallup	g ae l . l eo b
roux	l u
theobald	s i . eo . b eo l . d eu
luciano	l u . ch i . a . n o
haugland	h e . u l . l a n
boll	b o l
sternberg	s eu . t eo n . b eo . g eu
romania	l u . m a . n i . a
jespersen	ye . s eu . p e . l eu . s e n
naipaul	n a . i . p o l
mayer	m a . i . eo
america	a . m e . l i . k a
eudora	yu . d o . l a
weingartner	b a . i n . g a . l eu . t eu . n eo
tansley	t ae n . s eu l . l i
mackay	m ae g . k e . i
petrograd	p e . t eu . l o . g eu . l a . d eu
islamabad	i . s eu l . l a . m a . b a . d eu
lim	l i m
prandtl	p eu . l a n . t eu l
bidwell	b i . d eu . we l
laptev	l a b . t e . p eu
carlson	k a l . s eu n
marek	m a . l e g
sams	s ae m . s eu
heller	h e l . l eo
sommaruga	s o . m a . l u . g a
madeira	m a . d e . i . l a
spohr	s yu . p o . eo
orestes	o . l e . s eu . t e . s eu
clements	k eu l . l e . m eo n . ch eu
bakersfield	b e . k eo . j eu . p i l . d eu
crisp	k eu . l i . s eu . p eu
iraq	i . l a . k eu
sverdrup	s eu . b e . l eu . d eu . l u . p eu
canto	k a n . t o
flagstad	p eu l . l a . g eu . s eu . t a
pestalozzi	p e . s eu . t a l . l o . ch i
kamen	k e . i . m eo n
david	d e . i . b i . d eu
juma	j u . m a
solo	s o l . l o
nancy	n a ng . s i
schmitz	s yu . m i . ch eu
ashkenazi	a . s i . k e . n a . j i
freemantle	p eu . l i . m ae n . t eu l
wilt	wi l . t eu
liddell	l i . d eu l
sonia	s o . n ya
hinton	h i n . t eo n
duncan	d eo ng . k eo n
bohuslav	b o . h u . s eu l . l a . p eu
polynesia	p o l . l i . n e . s i . a
ashkhabad	a . s yu . h a . b a . t eu
morais	m o . l a . i . s eu
dewey	d yu . i
madge	m e . j wi
evans	e . b eo n . s eu
jaffna	j a . p eu . n a
quantz	k eu . b a n . ch eu
humphreys	h eo m . p eu . l i . s eu
oort	o . l eu . t eu
caird	k e . eo . d eu
herzberg	h e . l eu . ch eu . b e . l eu . k eu
albany	o l . b eo . n i
mona	m o . n a
nevelson	n i . b e l . s eu n
capri	k a . p eu . l i
dufy	d wi . p i
brian	b eu . l a . i . eo n
leopardi	l e . o . p a . l eu . d i
julie	j u l . l i
treitschke	t eu . l a . i . ch i . k e
amundsen	a . m u n . j e n
molotov	m o l . l o . t o . p eu
alina	a l . l i . n a
katharine	k ae . s eo . l i n
gervinus	g e . l eu . b i . n u . s eu
phillippe	p i l . l i . p eu
minnie	m i . n i
amon	a . m o n
lambeth	l ae m . b eo . s eu
gaza	g a . j a
negro	n i . g eu . l o
staub	s eu . t a . u b
marais	m a . l e
burns	b eo n . s eu
voigt	p o . k eu . t eu
lutz	l u . ch eu
gettysburg	g e . t i . j eu . b eo . g eu
nair	n a . i . l eu
ioffe	yo . p e
becky	b e . k i
devi	d e . b i
noyce	n o . i . s eu
sarajevo	s a . l a . ye . b o
greenspan	g eu . l i n . s eu . p eo n
emma	e . m a
gamble	g ae m . b eu l
nikolaev	n i . k o l . l a . ye . p eu
dave	d e . i . b eu
combs	k o m . s eu
russ	l eo . s eu
ortelius	o . l eu . t e l . l i . u . s eu
mccoy	m ae g . k o . i
campo	k a m . p o
espejo	e . s eu . p e . h o
bowker	b o . u . k eo
carolina	k ae . l o l . l a . i . n a
boye	b o . wi . e
montana	m o n . t ae . n a
wade	wa . d e
meunier	m oe . n i . e
garvey	g a . b i
fontainebleau	p o ng . t e n . b eu l . l o
hannibal	h a n . n i . b a l
yannick	ya . n i g
poland	p o l . l a n . d eu
binder	b a . i n . d eo
auriol	o . l i . o l
wit	b i . t eu
bush	b u . s i
bellamy	b e l . l eo . m i
aurelio	a . u . l e l . l i . o
glazunov	g eu l . l a . j u . n o . p eu
steffen	s eu . t e . p eu n
senghor	s a ng . g o . l eu
silber	s i l . b eo
jana	j a . n a
beatrice	b e . a . t eu . l i . s eu
bartolommeo	b a . l eu . t o l . l o m . m e . o
aleksandr	a l . l e g . s a n . d eu . l eu
lebedev	l e . b e . d e . p eu
caesar	s i . j eo
barnet	b a . n e s
obando	o . b a n . d o
schweizer	s yu . b a . i . ch eo
hanson	h ae n . s eu n
fredericton	p eu . l e . d eo . l i g . t eo n
vogt	p o . k eu . t eu
cuvier	k wi . b i . e
bjorn	b i . yo n
doyle	d o . i l
matthias	m a . t i . a . s eu
ockham	o . k eo m
armin	a . l eu . m i n
burton	b eo . t eo n
sutherland	s eo . d eo l . l ae n . d eu
abel	a . b e l
rudolf	l u . d o l . p eu
schulz	s yu l . ch eu
zemskov	j e m . s eu . k o . p eu
kolar	k o l . l a . l eu
cale	k e . i l
pachelbel	p a . h e l . b e l
peter	p i . t eo
garcia	g a . l eu . s i . a
hoel	h o . e l
stern	s yu . t e . l eu n
boucher	b a . u . ch eo
ware	we . eo
hubertus	h u . b e . l eu . t u . s eu
bobby	b o . b i
rude	l wi . d eu
lamb	l ae m
pacheco	p a . ch e . k o
chappe	s ya . p eu
java	j a . b a
noronha	n o . l o . n ya
mike	m a . i . k eu
strasser	s eu . t eu . l a . j eo
ponchielli	p o n . k i . e l . l i
erfurt	e . l eu . p u . l eu . t eu
harriman	h ae . l i . m eo n
jurgen	j u . g e n
blaine	b eu l . l e . i n
satish	s a . t i . s wi
calvino	k a l . b i . n o
sidney	s i . d eu . n i
barrett	b a . l e s
caracas	k a . l a . k a . s eu
hobsbawm	h o b . s eu . b o m
chicago	s i . k a . g o
zimmermann	ch i . m eo . m a n
herbst	h eo . b eu . s eu . t eu
lully	l wi l . l i
starr	s eu . t a
blumberg	b eu l . l eo m . b eo . g eu
tegucigalpa	t e . g u . s i . g a l . p a
hearn	h o n
michael	m a . i . k eu l
kircher	k i . l eu . h eo
tripoli	t eu . l i . p o l . l i
aptidon	a b . t i . d o n
suffolk	s eo . p eo g
lill	l i l
mazowiecki	m a . j o . b i . e . ch eu . k i
boise	b o . i . s i
issabel	i . j a . b e l
viotti	b i . o . t i
bandiera	b a n . d i . e . l a
bandeira	b a n . d e . i . l a
moi	m o . i
sikorsky	s i . k o . l eu . s eu . k i
schmiedeberg	s yu . m i . d e . b e . l eu . k eu
mariana	m a . l i . a . n a
anderton	a n . d eo . t o n
halifax	h ae l . l i . p ae g . s eu
firth	p eo . s eu
ismailia	i . s eu . m a . i l . l i . a
shakespeare	s ye . i g . s eu . p i . eo
willem	b i l . l e m
peeters	p e . t eo . s eu
perrier	p e . l i . e
flaubert	p eu l . l o . b e . l eu
rubin	l u . b i n
amalia	a . m a l . l i . a
hilary	h i l . l eo . l i
millay	m i l . l e . i
tennyson	t e . n i . s eu n
tiepolo	t i . e . p o l . l o
harald	h a . l a l . t eu
evanson	e . b a n . s eu n
hardin	h a . d i n
lynd	l i n . d eu
garrick	g ae . l i g
becher	b e . h eo
biya	b i . ya
wright	l a . i . t eu
lassus	l a . s u . s eu
witherspoon	wi . d eo . s eu . p u n
jolly	j o l . l i
afanasiev	a . p a . n a . s i . ye . p eu
goldstein	g o l . d eu . s eu . t a . i n
johnson	yo n . s o n
pettenkofer	p e . t e n . k o . p eo
taya	t a . ya
calderon	kk a l . d e . l o n
ivy	a . i . b i
gower	g a . wo
katz	k a . ch eu
dunne	d eo n
chisinau	ch i . s i . n a . u
ignacio	i . g eu . n a . s i . o
scheidt	s ya . i . t eu
bremerhaven	b eu . l e . m eo . h a . p e n
azad	a . j a . d eu
carlyle	k a l . l a . i l
ahmad	a . m a . d eu
hoss	h o . s eu
eduardo	e . d u . a . l eu . d o
meissner	m a . i . s eu . n eo
shalom	s ya l . l o m
hesse	h e . s e
lent	l e n . t eu
segni	s e . n i
nimitz	n i . m i . ch eu
auden	o . d eu n
larkin	l a . k i n
brookes	b eu . l u g . s eu
stephanie	s eu . t e . p a . n i
asia	a . s i . a
calderwood	k a l . d eo . u . d eu
algeciras	a l . h e . s i . l a . s eu
europe	yu . l eo b
goa	g o . a
ginsburg	g i n . j eu . b eo . g eu
serrano	s e . l a . n o
amiel	a . m i . e l
pierre	p i . eo
alice	ae l . l i . s eu
pettit	p e . t i . t eu
mathis	m ae . t i . s eu
ellery	e l . l eo . l i
wrightson	l a . i . t eu . s eu n
sanchez	s a n . ch e . s eu
rousseau	l u . s o
rotterdam	l o . t e . l eu . d a m
angeles	e n . j e l . l e . s eu
kolmogorov	k o l . m o . g o . l o . p eu
akron	ae . k eu . l eo n
guarnieri	g wa . l eu . n i . e . l i
menuhin	m e . n yu . i n
gabrielle	g a . b eu . l i . e l
niamey	n i . a . m e
trautmann	t eu . l o . t eu . m a n
bangladesh	b a ng . g eu l . l a . d e . s i
nichols	n i . k o l . s eu
jay	j e . i
boethius	b o . i . t i . u . s eu
tallinn	t a l . l i n
keith	k i . s eu
hunt	h eo n . t eu
black	b eu l . l ae g
koerner	k oe . l eu . n eo
harmon	h a . m eo n
sutton	s eo . t eo n
massa	m a . s a
ochirbat	o . ch i . l eu . b a . t eu
wetzel	we . j e l
yaounde	ya . u n . d e
marschner	m a . l eu . s yu . n eo
conte	k o ng . t e
hofstadter	h o . p eu . s eu . t ae . t eo
trevithick	t eu . l e . b i . s i g
philip	b i l . l i b
mathilde	m a . t i l . d eu
londonderry	l eo n . d eo n . d e . l i
henk	h e ng . k eu
giorgio	j o . l eu . j o
chamai	ch a . m a . i
nehru	n e . l u
bacon	b e . i . k eo n
malthus	m ae l . s eo . s eu
pfitzner	p i . ch eu . n eo
galland	g a l . l a ng
nicosia	n i . k o . s i . a
benedetto	b e . n e . d e . t o
frechette	p eu . l e . s ye . t eu
cavaignac	k a . b e . n ya . k eu
nasser	n a . s e . l eu
dushanbe	d u . s ya n . b e
sylvia	s i l . b i . a
gerlach	g e . l eu l . l a . h eu
bienville	b i . e n . b i l
mosley	m o . j eu l . l i
lexington	l e g . s i ng . t eo n
perugino	p e . l u . j i . n o
vladivostok	b eu l . l a . d i . b o . s eu . t o . k eu
suqi	ss u . ch i
mantovani	m a n . t o . b a . n i
johns	j o n . s eu
picabia	p i . k a . b i . a
banville	b a ng . b i l
jugnauth	j u . g eu . n o . t eu
port_of_spain	p o . t eu . o . b eu . s eu . p e . i n
denton	d e n . t eu n
vailland	b a . ya ng
anwari	a n . wa . l i
carmona	k a . m o . n a
cohn	k o n
paula	p o l . l a
pelle	p e l . l e
mel	m e l
alder	a l . d eo
scheler	s ye l . l eo
cournot	k u . l eu . n o
alfonsin	a l . p o n . s i n
diesel	d i . j e l
macauley	m ae g . k o l . l i
moravia	m o . l a . b i . a
scofield	s eu . k o . p i l . d eu
diogenes	d i . o . g e . n e . s eu
tyndall	t i n . d eu l
ugarte	u . g a . l eu . t e
forbes	p o . b eu . s eu
lille	l i l
dixit	d i g . s i . t eu
stratford	s eu . t eu . l ae s . p o . d eu
elisa	e l . l i . s a
marvell	m a . b eo l
poynting	p o . i n . t i ng
macmillan	m ae g . m i l . l a n
marini	m a . l i . n i
sanaa	s a . n a
indonesia	i n . d o . n e . s i . a
tan	t a n
wellington	we l . l i ng . t eo n
savonarola	s a . b o . n a . l o l . l a
leeds	l i . j eu
dick	d i g
renn	l e n
previn	p eu . l e . b i n
chissano	s i . s a . n o
kesey	k i . j i
abend	a . b e n . d eu
briscoe	b eu . l i . s eu . k o
velayati	b e l . l a . ya . t i
renzo	l e n . j o
agostino	a . g o . s eu . t i . n o
lana	l a . n a
mbasogo	eu m . b a . s o . g o
kelsey	k e l . s i
halma	h ae l . m eo
nicky	n i . k i
zagreb	j a . g eu . l e . b eu
zinzendorf	ch i n . ch e n . d o . l eu . p eu
meryl	m e . l i l
majuro	m a . j u . l o
cornelis	k o . l eu . n e l . l i . s eu
harare	h a . l a . l e
eads	i . j eu
ribbentrop	l i . b e n . t eu . l o . p eu
lieberman	l i . b eo . m eo n
boris	b o . l i . s eu
aske	a . s eu . k e
torricelli	t o . l i . ch e l . l i
carnes	k a . n e . s eu
usher	eo . s yeo
chamorro	ch a . m o . l o
horta	o . l eu . t a
spaak	s eu . p a . k eu
massey	m ae . s i
eamon	e . i . m eo n
racine	l a . s i n
remington	l e . m i ng . t eo n
malone	m a l . l o n
gundolf	g u n . d o l . p eu
silvestre	s i l . b e . s eu . t eu . l eu
penelope	p e . n e l . l o . p e
serena	s e . l i . n a
overton	o . b eo . t eu n
winthrop	wi n . s eu . l eo b
ridley	l i . d eu l . l i
george	g e . o . l eu . g e
tormod	t o . m o . d eu
chatterton	ch ae . t eo . t eo n
dagmar	d a . g eu . m a . l eu
kira	k i . l a
offenbach	o . p e n . b a . h eu
trollope	t eu . l o l . l eo b
rowling	l o l . l i ng
ericsson	e . l i g . s eu n
milan	m i l . l a . n o
sherrington	s ye . l i ng . t eo n
bolivia	b o l . l i . b i . a
anfinsen	a n . p i n . s eu n
sadat	s a . d a . t eu
rabi	l a . b i
goldberg	g o l . d eu . b eo . g eu
sarton	s a . t eo n
navarro	n a . b a . l o
samar	s a . m a . l eu
margery	m a . j e . l i
bolkiah	b o l . k i . a
natalia	n a . t a l . l i . a
fallopius	p a l . l o . p i . u . s eu
newport	n yu . p o . t eu
grenada	g eu . l e . n a . d a
aubert	o . b e . l eu
handel	h e n . d e l
gladkov	g eu l . l a s . k o . p eu
hamlet	h ae m . l i s
guzman	g u . j eu . m eo n
berwick	b e . l i g
biel	b i . e l
salten	j a l . t e n
gesner	g e . s eu . n eo
wedekind	b e . d e . k i n . t eu
kilauea	k i . l a . we . a
eckermann	e . k eo . m a n
brutus	b eu . l u . t u . s eu
sandro	s a n . d eu . l o
hilton	h i l . t eo n
guillaumin	g i . yo . m ae ng
marie	m a . l i
ginastera	h i . n a . s eu . t e . l a
kok	k o . k eu
martinez	m a . l eu . t i . n e . s eu
seipel	j a . i . p e l
reich	l a . i . h i
bolzano	b o l . ch a . n o
clara	k eu l . l a . l a
lytton	l i . t eo n
isaac	i . s a g
downs	d a . u n . s eu
valois	b a l . l u . a
andri	a n . d eu . l i . ch i
groom	g eu . l u m
parini	p a . l i . n i
frederik	p eu . l e . d e . l i . k eu
hunter	h eo n . t eo
manuel	m a . n u . e l
palmer	p a . m eo
craig	k eu . l e . i . g eu
hodel	h o . d eu l
shaheen	s yae . h i n
prentice	p eu . l ae n . t i . s eu
elias	e l . l i . a . s eu
carley	k a l . l i
hood	h u . d eu
carnot	k a . l eu . n o
carducci	k a . l eu . d u . ch i
antonio	a n . t o . n i . o
lautner	l o . t eu . n eo
freya	p eu . l o . i . ya
thelma	d e l . m a
percy	p eo . s i
irving	eo . b i ng
barrow	b a . l o . u
puccini	p u . ch i . n i
bluff	b eu l . l eo . p eu
rowan	l o . eo n
lou	l u
marc	m a . l eu . k eu
galilei	g a l . l i l . l e . i
walther	b a l . t eo
hebron	h e . b eu . l o n
togo	t o . g o
sade	s a . d eu
iglesias	i . g eu l . l e . s i . a . s eu
weiner	wa . i . n eo
card	k a . d eu
odessa	o . d e . s a
carver	k a . b eo
rifkin	l i . p eu . k i n
whittier	h wi . t i . eo
colin	k o l . l ae ng
salmon	s a l . m o ng
bates	b e . i . ch eu
chahine	s ya . h i n
forester	p o . l e . s eu . t eo
ludovic	l u . d o . b i
versailles	b e . l eu . s a . yu
mueller	m yu l . l eo
bryullov	b eu . l yu l . l o . p eu
ekman	e . k eu . m a n
jodie	j o . d i
zeyer	jj eo . ye . eo l
crosby	k eu . l o . s eu . b i
stefano	s eu . t e . p a . n o
mirabeau	m i . l a . b o
grekov	g eu . l e . k o . p eu
moira	m o . i . l a
grove	g eu . l o . b eu
bajer	b a . ye . l eu
rainwater	l e . i n . wo . t eo
sydenham	s i . d eu . n eo m
knightley	n a . i . t eu l . l i
vasari	b a . s a . l i
sheffield	s ye . p i l . d eu
harding	h a . d i ng
voynich	b o . n i . ch i
amar	a . m a . l eu
kohl	k o l
georgia	g eu . l u . j i . a
lindbergh	l i n . d eu . b eo . g eu
whitaker	h wi . t ae . k eo
petroni	p e . t eu . l o . n i
makin	m a . k i n
chung	j eo ng
pole	p o l
erving	eo . b i ng
willoughby	wi l . l u . b i
smedley	s eu . m e . d eu l . l i
pandolfi	p a n . d o l . p i
lie	l i
ajaccio	a . j a g . s i . o
fern	p eo n
hannelore	h a . n e l . l o . l e
gustav	g u . s eu . t a . b eu
meri	m e . l i
borlaug	b o l . l o . g eu
krauss	k eu . l a . u . s eu
gillian	j i l . l i . eo n
vanuatu	b a . n u . a . t u
lahnstein	l a n . s eu . t e . i n
valente	b a l . l e n . t e
mounier	m u . n i . e
bonney	b o . n i
foreman	p o . m eo n
escudero	e . s eu . k u . d e . l o
romeo	l o . m e . o
podolsky	p o . d o l . s eu . k i
antwerp	ae n . t eu . wo . p eu
eames	i m . s eu
eck	e . k eu
fiona	p i . o . n a
barthes	b a . l eu . t eu
branting	b eu . l a n . t i ng
packer	p ae . k eo
townes	t a . u n . s eu
gustavo	g u . s eu . t a . b o
bliss	b eu l . l i . s eu
ugo	u . g o
dianne	d a . i . ae n
algeria	a l . j e . l i
lagerkvist	l a . g e . l eu . k eu . b i . s eu . t eu
kretschmer	k eu . l e . ch i . m eo
hutchison	h eo . ch i . s eu n
crean	k eu . l i n
zakaria	j a . k a . l i . a
gurwitsch	g eo . b i . ch i
alessio	a l . l e . s i . o
oberth	o . b e . l eu . t eu
schaeffer	s we . p eo
borough	b o . l o
mou	m eo . u
vespucci	b e . s eu . p u . ch i
mahan	m eo . h ae n
huizinga	h o . i . j i ng . g a
regis	l e . j i . s eu
dublin	d eo . b eu l . l i n
kluge	k eu l . l u . g e
oppenheimer	o . p e n . h a . i . m eo
espronceda	e . s eu . p eu . l o n . s e . d a
perutz	p eo . l u . ch eu
munch	m u ng . k eu
bautista	b a . t i . s eu . t a
robin	l o . b i n
lawson	l o . s eu n
rowe	l o . we
andrew	a n . d eu . l e
fazal	p a . j a l
larsson	l a . l eu . s o n
casey	k e . i . s i
walpole	wo l . p o l
lobe	l o . b e
caprivi	k a . p eu . l i . b i
vaughan	b o n
capone	k a . p o . n e
saraiva	s a . l a . i . b a
nilson	n i l . s o n
tait	t a . i . t eu
gauss	g a . u . s eu
pechstein	p e . h i . s yu . t a . i n
washington	wo . s i ng . t eo n
langbein	l ae ng . b a . i n
murmansk	m u . l eu . m a n . s eu . k eu
marvin	m a . b i n
millar	m i l . l eo
semper	j e m . p eo
inge	i ng
stacy	s eu . t e . i . s i
bow	b o . u
escobar	e . s eu . k o . b a
derek	d e . l i g
eriksson	e . l i g . s o n
seton	s i . t eo n
hogarth	h o . g a . s eu
peltier	p e l . t i . e
lilley	l i l . l i
male	m a l . l i
xie	s ye
matt	m ae s
trenton	t eu . l e n . t eo n
hoskins	h o . s eu . k i n . s eu
brendan	b eu . l e n . d eo n
shelley	s ye l . l i
rivas	l i . b a . s eu
babbage	b ae . b i . j i
reines	l a . i . n eo . s eu
voss	p o . s eu
gibbon	g i . b eo n
camus	k a . m wi
heckman	h e . k eu . m eo n
eyck	e . i . k eu
lanvin	l a ng . b a ng
mitra	m i . t eu . l a
danieli	d a . n i . e l . l i
barnes	b a . n e . j eu
blackpool	b eu l . l ae g . p u l
snowdon	s eu . n o . d eu n
eisenhower	a . i . j e n . h a . wo
longman	l o ng . m ae n
zweig	ch eu . b a . i . k eu
peirce	p eo . s eu
rebecca	l e . b e . k a
heck	h e g
artsybashev	a . l eu . ch i . b a . s ye . p eu
aranda	a . l a n . d a
rajiv	l a . j i . b eu
gabon	g a . b o ng
bernadette	b eo . n a . d e . t eu
fries	p eu . l i . s eu
hubel	h eo . b eu l
voltaire	b o l . t e . l eu
newcomb	n yu . k eo m
varela	b a . l e . l a
orville	o . b i l
jam	j ae m
brandt	b eu . l a n . t eu
mackintosh	m ae . k i n . t o . s i
charlotte	s ya l . l eo s
sacchetti	s a . k e . t i
rankine	l ae ng . k i n
yorktown	yo . k eu . t a . u n
haller	h a l . l eo
meier	m a . i . eo
mello	m e l . l o
schiff	s wi . p eu
vancouver	b ae n . k u . b eo
westerberg	b e . s eu . t e . l eu . b e . l i
meitner	m a . i . t eu . n eo
travolta	t eu . l a . b o l . t a
daniell	d a . n i . e l
henrik	h e n . l i . k eu
carey	k e . l i
solari	s o l . l a . l i
anselmo	a n . s e l . m o
jamal	j a . m a l
zurich	ch wi . l i . h i
gloria	g eu l . l o . l i . a
ostade	o . s eu . t a . d e
hamilton	h ae . m i l . t eo n
maguire	m ae g . g wa . i . eo
vance	b eo n . s eu
werner	b e . l eu . n eo
zelaya	j e . l a . ya
frye	p eu . l a . i
william	wi l . l i . eo m
kaunda	k a . u n . d a
hinds	h a . i n . j eu
brazil	b eu . l a . j i l
gorter	g o . l eu . t e . l eu
hutten	h u . t e n
escher	e . s yeo
hale	h e . i l
annapolis	a . n a . p o l . l i . s eu
laud	l o . d eu
chapman	ch ae . p eu . m eo n
lower	l o . b e . l eu
beatrice	b e . a . t eu . l i . ch e
gutenberg	g u . t e n . b e . l eu . k eu
supervielle	s wi . p e . l eu . b i . e l
rosse	l o . s eu
nobel	n o . b e l
aldrin	o l . d eu . l i n
turk	t eo . k i
dever	d e . b eo
gouled	g u l . l e . d eu
hansard	h ae n . s eo . d eu
gennaro	j e n . n a . l o
alicia	ae l . l i . s ya
milford	m i l . p eo . d eu
page	p e . i . j i
guardini	g wa . l eu . d i . n i
innsbruck	i n . s eu . b eu . l u . k eu
sim	s i m
sabin	s e . i . b i n
shackleton	s yae . k eu l . t eo n
massine	m a . s i n
celso	s e . l eu . s o
arber	a . l eu . b eo
hahn	a n
ghana	g a . n a
cecilia	s e . s i l . l i . a
ortega	o . l eu . t e . g a
collins	k o l . l i n . s eu
menem	m e . n e m
gallegos	g a l . l e . g o . s eu
celia	s e l . l i . a
arndt	a . l eu n . t eu
mill	m i l
hudson	h eo . d eu . s eu n
perot	p e . l o
clough	k eu l . l a . p eu
wimbledon	wi m . b eu l . d eo n
manning	m ae . n i ng
benton	b e n . t eo n
geiger	g a . i . g eo
krogh	k eu . l o . g eu
springer	s eu . p eu . l i ng . g eo
meisheng	m e . i . s eo ng
mader	m a . d eo
aurora	a . u . l o . l a
busse	b u . s e
owen	o . we n
ayer	e . i . eo
hamann	h a . m a n
bossuet	b o . s wi . e
pelegrin	p e l . l e . g eu . l i n
tiele	t i l . l e
calvin	k a l . b ae ng
piranesi	p i . l a . n e . s i
shoemaker	s yu . m e . i . k eo
giuliani	j u l . l i . a . n i
sean	s yo n
walsingham	wo l . s i ng . eo m
arbuzov	a . l eu . b u . j o . p eu
duane	d yu . a n
arp	a . l eu . p eu
piazzetta	p i . a . ch e . t a
abbott	ae . b eo . t eu
olbrich	o l . b eu . l i . h i
piel	p i . e l
virchow	p i . l eu . h o
chiesa	k i . e . s a
chianti	k a n . t i
granada	g eu . l a . n a . d a
kenyatta	k e . n ya . t a
ripley	l i . p eu l . l i
como	k o . m o
kalamazoo	k a l . l a . m a . j u
jacobsen	ya . k o b . s e n
shields	s wi l . d eu
schongauer	s yo n . g a . u . eo
bass	b ae . s eu
garris	g a . l e . s eu
dent	t e n . t eu
david	d a . b i . d eu
rudiger	l u . d i . g eo
eschenbach	e . s ye n . b a . h eu
abadan	a . b a . d a n
basque	b a . s eu . k eu
lenormand	l eu . n o . l eu . m a ng
rodenbach	l o . d e n . b a . h eu
salim	s a l . l i m
bangemann	b a ng . g e . m a n
ellison	e l . l i . s eu n
deutsch	d o . i . ch i
moraes	m o . l a . e . s eu
rush	l eo . s i
zion	s i . o n
ensor	e n . s o . l eu
montoya	m o n . t o . ya
jawara	j a . wa . l a
angel	e n . j e l
rudolph	l u . d o l . p eu
dahl	d a l
rademacher	l a . d e . m a . h eo
claxton	k eu l . l e g . s eu . t eo n
barroso	b a . l o . s u
khadem	k a . d e m
joachim	yo . a . k i m
heisenberg	h a . i . j e n . b e . l eu . k eu
chanel	s ya . n e l
filmer	p i l . m eo
spain	s eu . p e . i n
brant	b eu . l a n . t eu
rabelais	l a . b eu l . l e
solow	s o l . l o
reuben	l eu . u . b e n
nureyev	n u . l e . ye . p eu
rais	l a . i . s eu
bowman	b o . m eo n
harris	h ae . l i . s eu
christoph	k eu . l i . s eu . t o . p eu
tennant	t e . n eo n . t eu
meadows	m i . d o . u . s eu
kelly	k e l . l i
bari	b a . l i
sue	s wi
clifton	k eu l . l i . p eu . t eo n
eustachio	yu . s eu . t a . k i . o
brindley	b eu . l i n . d eu l . l i
ragusa	l a . g u . s a
tobin	t o . b i n
landau	l a n . d a . u
grotius	g eu . l o . t i . u . s eu
hatch	h ae . ch i
tiffany	t i . p a . n i
aberdeen	ae . b eo . d i n
elgin	e l . g i n
fitzpatrick	p i . ch eu . p ae . t eu . l i g
paige	p e . i . j i
bratteli	b eu . l a . t e l . l i
ethan	i . d eo n
argento	a . l eu . j e n . t o
biden	b a . i . d eu n
gerhard	g e . l eu . h a . l eu . t eu
durand	d yu . l a n . d eu
baer	b e . eo
foley	p o l . l i
bassi	b a . s i
levy	l e . b i
hartley	h a . t eu l . l i
leon	l e . o ng
enzo	e n . j o
uno	u . n o
clarence	k eu l . l ae . l eo n . s eu
ranasinghe	l a . n a . s i ng . h e
angelou	ae n . j e l . l u
fajans	p a . ya n . s eu
burr	b eo
dixie	d i g . s i
empson	e m . p eu . s eu n
humboldt	h u m . b o l . t eu
carlo	k a . l eu l . l o
hoffa	h o . p a
gasser	g ae . s eo
highland	h a . i . l ae n . d eu
machiavelli	m a . k i . a . b e l . l i
posada	p o . s a . d a
sinan	s i . n a n
onsager	o n . s a . g eo
leila	l e . i l . l a
hogg	h o . g eu
julian	yu l . l i . a . n u . s eu
rosen	l o . s eu n
habib	h a . b i . b eu
margulis	m a . g u l . l i . s eu
limoges	l i . m o . j u
brett	b eu . l e . t eu
kerschensteiner	k e . l eu . s ye n . s yu . t a . i . n eo
randy	l ae n . d i
drew	d eu . l yu
sarney	s a . l eu . n e . i
qatar	k a . t a . l eu
santer	s a ng . t e . l eu
toma	t o . m a
sergi	s e . l eu . h i
kirby	k eo . b i
jasper	j a . s eu . p eo
curie	k wi . l i
milhaud	m i . yo
constance	k o n . s eu . t a n . s eu
hurley	h eo l . l i
abreu	eo . b eu . l e . u
wilton	wi l . t eo n
berto	b e . l eu . t o
michigan	m i . s i . g a n
navarre	n a . b a . l eu
gaultier	g o . t i . e
fitz	p i . ch eu
hales	h e . i l . j eu
horton	h o . t eu n
friedman	p eu . l i . d eu . m a n
fogel	p o . g e l
flaherty	p eu l . l a . eo . t i
santana	s a n . t a . n a
mendes	m e n . d i . s eu
valentine	b a l . l e n . t a . i n
appalachia	a . p a . l a . ch i . a
ontario	o n . t a . l i . o
hayden	h e . i . d eu n
desiderius	d e . s i . d e . l i . u . s eu
marx	m a . l eu . k eu . s eu
gonzales	g o n . s a l . l e . s eu
nicolae	n i . k o l . l a . e
reichenbach	l a . i . h e n . b a . h eu
farjeon	p a . j eo n
kellermann	k e l . l eo . m a n
felice	p e l . l i . s eu
darling	d a l . l i ng
ezra	e . s eu . l a
manger	m ae ng . g eo
blixen	b eu l . l i g . s e n
catherine	k a . t eu . l i n
agnew	ae . g eu . n yu
pea	p e . n ya
bruch	b eu . l u . h eu
trina	t eu . l i . n a
kopp	k o . p eu
courteline	k u . l eu . t eu l . l i n
douglas	d eo . g eu l . l eo . s eu
kaufman	k o . p eu . m eo n
roberta	l o . b eo . t a
canterbury	k ae n . t eo . b e . l i
penderecki	p e n . d e . l e . ch eu . k i
goujon	g u . j o ng
schwitters	s yu . b i . t eo . s eu
galway	g o l . we . i
lacombe	l a . k o m
hardwick	h a . d eu . wi g
kovalenko	k o . b a l . l e n . k o
antonius	a n . t o . n i . u . s eu
petty	p e . t i
donnie	d o . n i
pupin	p u . p i n
slovakia	s eu l . l o . b a . k i . a
hanna	h a n . n a
schaap	s eu . k a b
potter	p o . t eo
arroyo	a . l o . yo
luxenberg	l o g . s e m . b u . l u . k eu
salam	s a l . l a m
antony	a n . t o . n i
keri	k e . l i
barca	b a . l eu . k a
dimitrov	d i . m i . t eu . l o . p eu
marlowe	m a l . l o
wilkins	wi l . k i n . s eu
volga	b o l . g a
nafis	n a . p i . s eu
agatha	a . g a . s a
buckinghamshire	b eo . k i ng . eo m . s yeo
sid	s i . d eu
reuter	l o . i . t eo
pfeiffer	p a . i . p eo
danny	d a . n i
bessel	b e . s e l
strachey	s eu . t eu . l e . i . ch i
praia	p eu . l a . i . a
sharif	s ya . l i . p eu
palau	p a l . l a . u
harman	h a . m eo n
seligman	s e l . l i . g eu . m eo n
presley	p eu . l e . s eu l . l i
fremont	p eu . l e . m o n . t eu
ramuz	l a . m wi
sommerfield	s eo m . m eo . p i l . d eu
herzog	h e . eo . ch o . k eu
rugby	l eo g . b i
massimo	m a . s i . m o
mulroney	m eo l . l o . n i
eunice	yu . n i . s eu
spitsbergen	s eu . k i . ch eu . b e . l eu . g e n
chernenko	ch e . l eu . n e n . k o
tommy	t o . m i
holbein	h o l . b a . i n
falk	p o . k eu
bourke	b o . k eu
dieter	d i . t eu . l eu
michael	m i . s we l
munk	m u ng . k eu
lama	l a . m a
pagano	p a . g a . n o
green	g eu . l i n
harrington	h ae . l i ng . t eo n
frisch	p eu . l i . s yu
branson	b eu . l ae n . s eu n
milstein	m i l . s eu . t e . i n
hopkins	h o b . k i n . s eu
ndiaye	n eu . j ya . ye
irene	i . l e . i n
serlio	s e . l eu l . l i . o
pane	p e . i n
prishvin	p eu . l i . s yu . b i n
fulbright	p u l . b eu . l a . i . t eu
cordelia	k o . d e l . l i . a
lini	l i . n i
benson	b e n . s eu n
rodgers	l o . j eo . s eu
farber	p a . b eo
cyndi	s i n . d i
bruin	b eu . l wi n
strick	s eu . t eu . l i g
chopra	ch o . p eu . l a
selim	s e l . l i m
athabasca	ae . s eo . b ae . s eu . k a
welhaven	b e l . h a . b e n
yates	ye . i . ch eu
binoche	b i . n o . s yu
vega	b e . g a
riemenschneider	l i . m e n . s yu . n a . i . d eo
bayley	b e . i . l e . i
pott	p o . t eu
sagan	s e . i . g eo n
haren	h a . l e n
korn	k o n
cronaca	k eu . l o . n a . k a
phil	p i l
fraser	p eu . l e . i . j eo
wilder	wa . i l . d eo
farina	p a . l i . n a
lewes	l u . i . s eu
atal	a . t a l
vittorini	b i . t o . l i . n i
crispin	k eu . l i . s eu . p i . n u . s eu
jose	j o . j e
mukherjee	m u . k eo . l eu . j i
jaipur	j a . i . p u . l eu
hauff	h a . u . p eu
browning	b eu . l a . u . n i ng
atahualpa	a . t a . wa l . p a
leo	l e . o
peli	p e l . l i
agarwal	a . g a . l eu . wa l
suttner	j u . t eu . n eo
spada	s eu . p a . d a
maupertuis	m o . p e . l eu . t wi . i
mal	m a l
marcus	m a . l eu . k u . s eu
talbot	t o l . b eo s
antonina	a n . t o . n i . n a
allen	a l . l e n
cardiff	k a . d i . p eu
giles	j a . i l . s eu
lanier	l eo . n i . eo
elam	e l . l a m
banach	b a . n a . h eu
elia	e l . l i . a
alessandro	a l . l e . s a n . d eu . l o
eugen	o . i . g e n
gillespie	g i l . l e . s eu . p i
platonov	p eu l . l a . t o . n o . p eu
chain	ch e . i n
mogadishu	m o . g a . d i . s yu
luna	l u . n a
gibb	g i b
glover	g eu l . l o . b eo
haidar	h a . i . d a . l eu
pam	p ae m
liza	l i . j a
bias	b i . a . s eu
taine	t e n
victor	b i g . t eo
chaptal	s ya . p eu . t a l
caceres	k a . s e . l e . s eu
bergeron	b e . l eu . ye . l o n
ion	i . o n
rahman	l a . m a n
hawks	h o . k eu . s eu
silveira	s i l . b e . i . l a
malta	m o l . t a
abraham	a . b eu . l a . h a m
bering	b e . l i ng
grossman	g eu . l o . s eu . m eo n
oughtred	o . t eu . l e . d eu
asturias	a . s eu . t u . l i . a . s eu
rasmussen	l a . s eu . m u . s e n
kamu	k a . m u
simi	s i . m i
vasilevskaya	b a . s i l . l e . p eu . s eu . k a . ya
aloysius	a l . l u . a . s i . u . s eu
freire	p eu . l e . i . l e
loschmidt	l o . s yu . m i . t eu
duhem	d wi . e m
nilsson	n i l . s o n
rico	l i . k o
mira	m i . l a
catilina	k a . t i l . l i . n a
avenarius	a . b e n . n a . l i . u . s eu
ingrid	i ng . g eu . l i . d eu
castlereagh	k ae . s eu l . l e . i
ortiz	o . l eu . t i . s eu
wagner	b a . g eu . n eo
cabral	k a . b eu . l a l
assad	a . s a . d eu
everett	e . b eo . l e s
koblenz	k o . b eu l . l e n . ch eu
giolitti	j o l . l i . t i
most	m o . s eu . t eu
kilpinen	k i l . p i . n e n
hammer	h a . m eo
bali	b a l . l i
trudeau	t eu . l wi . d o
chapsal	s ya . p eu . s a l
steiner	s yu . t a . i . n eo
kissinger	k i . s i n . j eo
bahar	b a . h a . l eu
bragg	b eu . l ae . g eu
theresa	t e . l e . s a
piscator	p i . s eu . k a . t o . l eu
blinder	b eu l . l a . i n . d eo
richet	l i . s ye
sweeney	s eu . wi . n i
harsanyi	h eo . s ya . n i
springfield	s eu . p eu . l i ng . p i l . d eu
sharpe	s ya . p eu
judith	yu . d i . s eu
dmowski	d eu . m o . p eu . s eu . k i
remnant	l e m . n eo n . t eu
lolita	l o . l i . t a
silvester	s i l . b e . s eu . t eo
rochester	l o . ch e . s eu . t eo
windaus	b i n . d a . u . s eu
alam	a l . eo m
morton	m o . t eo n
gayoom	g a . yu m
cesarotti	ch e . s a . l o . t i
rankovic	l a ng . k o . b i . ch i
bondi	b o n . d i
craven	k eu . l e . i . b eu n
bianchi	b i . a ng . k i
ting	t i ng
kenton	k e n . t eo n
beattie	b i . t i
harwood	h a . u . d eu
ralf	l a l . p eu
cienfuegos	s i . e n . p u . e . g o . s eu
cyrus	k i . l o . s eu
markov	m a . l eu . k o . p eu
panofsky	p a . n o . p eu . s eu . k i
arno	a . l eu . n o
northcliffe	n o . s eu . k eu l . l i . p eu
caucasus	k o . k a . s eo . s eu
canberra	k ae n . b eo . l a
ecevit	e . j e . b i . t eu
tana	t a . n a
tagore	t a . g o . l eu
franken	p eu . l a ng . k e n
june	j yu n
frida	p eu . l i . d a
shelby	s ye l . b i
perdue	p eo . d yu
maurizio	m a . u . l i . ch i . o
schmidt	s yu . m i . t eu
purdy	p eo . d i
burrows	b eo . l o . u . j eu
marilyn	m e . l i l . l i n
spranger	s yu . p eu . l a ng . g eo
helga	h e l . g a
gosset	g o . s e s
pauline	p o l . l i n
murnau	m u . l eu . n a . u
kauffmann	k a . u . p eu . m a n
armenia	a . l eu . m e . n i . a
adolphe	a . d o l . p eu
perrin	p e . l ae ng
sharp	s ya . p eu
doppler	d o . p eu l . l eo
andes	a n . d e . s eu
sampson	s ae m . s eu n
hieronymus	h i . e . l o . n i . m u . s eu
sor	s o . l eu
glass	g eu l . l a . s eu
buckley	b eo . k eu l . l i
villani	b i l . l a . n i
merle	m eo l
eileen	a . i l . l i n
hoffman	h o . p eu . m a n
honeywell	h a . n i . we l
lion	l i . o n
ansel	eo n . s e l
hurt	h eo . t eu
lipps	l i b . s eu
seymour	s e . i . m u . eo
sears	ss i . eo . s eu
bremer	b eu . l e . m e . l eu
azhari	a . j a . l i
darlington	d a l . l i ng . t eo n
naomi	n a . o
connaught	k o . n eo s
frey	p eu . l o . i
karlsruhe	k a . l eu l . s eu . l u . e
batchelor	b ae . ch e l . l eo
atwood	ae . t u . d eu
susan	s u . j a n
botha	b o . t a
waage	b o . g e
nena	n i . n a
hermann	h e . l eu . m a n
fox	p o g . s eu
columbia	k eo l . l eo m . b i . a
sudbury	s eo . d eu . b e . l i
senefelder	j e . n e . p e l . d eo
funafuti	p u . n a . p u . t i
aaron	a . l o n
vivienne	b i . b i . a n
gurley	g eo l . l i
pottinger	p o . t i n . j eo
botticelli	b o . t i . ch e l . l i
fanning	p ae . n i ng
languedoc	l a ng . g eu . d o . k eu
ebbinghaus	e . b i ng . h a . u . s eu
rutherford	l eo . d eo . p eo . d eu
arnim	a . l eu . n i m
amanda	a . m a n . d a
lorrain	l o . l ae ng
pickford	p i g . p eo . d eu
regina	l i . j a . i . n a
aitken	e . i . k i n
necker	n e . k e . l eu
temin	t e . m i n
wollaston	u l . l eo . s eu . t eo n
ovechkin	o . b e . ch i . k i n
simms	s i m . s eu
severin	s e . b eo . l i n
mafeking	m a . p e . k i ng
desmoulins	d e . m u l . l ae ng
kenny	k e . n i
dupont	d yu . p o ng
wise	wa . i . j eu
maimon	m a . i . m o n
taussig	t a . u . s i . g eu
shockley	s yo . k eu l . l i
harbison	h a . b i . s eu n
westinghouse	we . s eu . t i ng . h a . u . s eu
serene	s e . l i n
vivian	b i . b i . eo n
sally	s ae l . l i
roald	l o . a l
piatigorsky	p i . a . t i . g o . l eu . s eu . k i
allende	a . ye n . d e
mischa	m i . s ya
gesell	g e . j e l
schell	s we l
booth	b u . d eu
deville	d eu . b i l
niels	n i l . s eu
mignon	m i . n yo ng
miura	m i . u . l a
falcone	p a l . k o . n e
janet	j a . n e
donnay	d o . n e
philipe	p i l . l i . p eu
jacks	j ae g . s eu
aguirre	a . g i . l e
ivanov	i . b a . n o . p eu
erwin	eo . wi n
sydney	s i . d eu . n i
lund	l u n . d eu
charleston	ch a l . s eu . t eo n
praetorius	p eu . l e . t o . l i . u . s eu
goethe	g oe . t e
townsend	t a . u n . s e n . d eu
hebbel	h e . b e l
gupta	g u b . t a
gavin	g ae . b i n
vakhtangov	b a . h eu . t a ng . g o . p eu
kennan	k e . n eo n
alvin	ae l . b i n
hart	h a . t eu
torrens	t o . l eo n . s eu
edel	e . d e l
feininger	p a . i . n i ng . eo
maximilian	m a g . s i . m i l . l i . a n
elena	e l . l e . n a
althusser	a l . t wi . s e . l eu
martins	m a . t i n
hawthorn	h o . s o n
sansovino	s a n . s o . b i . n o
alma	a l . m a
hartline	h a . t eu l . l a . i n
garnett	g a . n e s
baird	b e . eo . d eu
erhard	e . l eu . h a . l eu . t eu
kennedy	k e . n e . d i
maugham	m o m
armand	a . l eu . m a ng
jena	ye . n a
honig	h o . n i . g eu
lamennais	l a . m eu . n e
wergeland	b e . l eu . g e l . l a n
charles	s ya . l eu l
medhurst	m e . d eu . h eo . s eu . t eu
brigitte	b eu . l i . j i s
westwood	we . s eu . t eu . u . d eu
adel	a . d e l
alphonso	a l . p o n . s o
jane	j e . i n
metternich	m e . t e . l eu . n i . h i
helgeland	h e l . g eo l . l eo n . d eu
eugenio	e . u . j e . n i . o
diocletianus	d i . o . k eu l . l e . t i . a . n u . s eu
federer	p e . d eo . l eo
penn	p e n
achim	a . s i m
savinkov	s a . b i n . k o . p eu
warwick	wo . l i g
ernst	e . l eu n . s eu . t eu
pires	p i . l e . s eu
nipkow	n i b . k o
royce	l o . i . s eu
gail	g e . i l
ferris	p e . l i . s eu
matthews	m ae . s yu . s eu
gantt	g ae n . t eu
pelliot	p e l . l i . o
euler	o . i l . l eo
worthington	wo . s i ng . t eo n
malin	m a l . l i n
theo	t e . o
laird	l e . eo . d eu
nouri	n u . l i
brunner	b eu . l u . n eo
dreyfus	d eu . l e . p wi . s eu
wycliffe	wi . k eu l . l i . p eu
hepplewhite	h e . p eu l . h wa . i . t eu
chipman	ch i . p eu . m eo n
godwin	g o . d eu . wi n
woody	u . d i
earle	eo l
horn	h o . l eu n
grillparzer	g eu . l i l . p a . l eu . ch eo
rosset	l o . s e . t eu
jackie	j ae . k i
graf	g eu . l a . p eu
weizman	b a . i . ch eu . m a n
sharon	s ya . l o n
vida	b i . d a
anna	a n . n a
lorna	l o . n a
volkov	b o l . k o . p eu
colbert	k o l . b e . l eu
bessemer	b e . s e . m eo
tosti	t o . s eu . t i
bernhardt	b e . l eu . n a . l eu
zhdanov	j u . d a . n o . p eu
alva	a l . b a
isabella	i . s a . b e l . l a
downing	d a . u . n i ng
kuno	k u . n o
leonard	l e . n eo . d eu
bek	b e g
pilcher	p i . ch eo
hessen	h e . s e n
santander	s a n . t a n . d e . l eu
kuznetsov	k u . j eu . n e . ch o . p eu
lawrence	l o . l e n . s eu
zeeland	j e l . l a n . d eu
onassis	o . n a . s i . s eu
haarlem	h a . l eu l . l e m
debbie	d e . b i
ralph	l ae l . p eu
sanger	s ae ng . eo
bopp	b o . p eu
mendelssohn	m e n . d e l . s eu . j o n
edward	e . d eu . wo . d eu
tirana	t i . l a . n a
audrey	o . d eu . l i
dafoe	d e . p o
lyttelton	l i . t eu l . t eo n
indiana	i n . d e . e . n a
jodelle	j o . d e l
ancona	a n . k o . n a
wiener	wi . n eo
kevin	k e . b i n
gable	g e . i . b eu l
hooper	h u . p eo
chattanooga	ch ae . t eo . n u . g a
kozlov	k o . j eu l . l o . p eu
verdun	b e . l eu . d oe ng
wallenstein	b a l . l e n . s yu . t a . i n
dorn	d o n
jung	yu ng
ashton	ae . s yu . t eo n
naiman	n a . i . m a n
helmont	h e l . m o n . t eu
vondel	p o n . d e l
belmopan	b e l . m o . p a n
massenet	m a . s eu . n e
rodin	l o . d ae ng
algiers	a l . j e
mount	m a . u n . t eu
ven	b e n
chesterfield	ch e . s eu . t eo . p i l . d eu
iliev	i l . l i . ye . p eu
klaproth	k eu l . l a . p eu . l o . t eu
symons	s i . m eo n . s eu
port_au_prince	p o . l eu . t o . p eu . l ae ng . s eu
bucharest	b u . k a . l e . s eu . t eu
faust	p a . u . s eu . t eu
henze	h e n . ch e
bjorklund	b i . yo . l eu . k eu . l u n . t eu
hebel	h e . b e l
octavio	o g . t a . b i . o
shevchenko	s ye . p eu . ch e n . k o
mercer	m eo . s eo
wiley	wa . i l . l i
furmanov	p u . l eu . m a . n o . p eu
annie	ae . n i
rafik	l a . p i . k eu
romain	l o . m ae ng
vito	b i . t o
coignet	k o . wa . n i . e
verona	b e . l o . n a
modigliani	m o . d i l . l i . a . n i
wittenberg	b i . t e n . b e . l eu . k eu
christenson	k eu . l i . s eu . t eo n . s eu n
mills	m i l . s eu
karlgren	k a l . g eu . l e n
fechner	p e . h i . n eo
sully	s wi l . l i
lothar	l o . t a . eo
cervantes	s e . l eu . b a n . t e . s eu
australia	o . s eu . t eu . l e . i l . l i . a
elzevir	e l . j e . b i . eo
werfel	b e . l eu . p e l
cumberland	k eo m . b eo l . l ae n . d eu
ellsworth	e l . j eu . wo . s eu
mitchell	m i . ch e l
etcheverry	e . ch wi . b e . l i
svetlana	s eu . b e . t eu l . l a . n a
schmalenbach	s yu . m a l . l e n . b a . h eu
frei	p eu . l e . i
managua	m a . n a . g wa
mina	m i . n a
bette	b e . t i
allen	ae l . l eo n
jacobi	ya . k o . b i
grosso	g eu . l o . s o
dornbusch	d o n . b u . s i
rudi	l u . d i
ahern	eo . h eo n
rostov	l o . s eu . t o . p eu
prosper	p eu . l o . s eu . p e . l eu
vieta	b i . e . t a
frege	p eu . l e . g e
buchanan	b yu . k ae . n eo n
betjeman	b e . ch eo . m eo n
neverov	n e . b e . l o . p eu
dawkins	d o . k i n . s eu
haneke	h a . n e . k e
danny	d ae . n i
fessenden	p e . s e n . d e n
cassandra	k a . s a n . d eu . l a
alvarez	ae l . b eo . l e . j eu
mauritius	m o . l i . s yeo . s eu
wilde	wa . i l . d eu
cleveland	k eu l . l i . b eu l . l ae n . d eu
crawford	k eu . l o . p eo . d eu
walter	b a l . t eo
gumplowicz	g u m . p eu l . l o . b i . ch i
stafford	s eu . t ae . p o . d eu
reinhard	l a . i n . h a . l eu . t eu
langland	l ae ng . g eu l . l eo n . d eu
wolcott	wo l . k o . t eu
gino	j i . n o
peel	p i l
emilio	e . m i l . l i . o
daisy	d a . i . s i
white	h wa . i . t eu
belasco	b e l . l a . s eu . k o
maspero	m a . s eu . p e . l o
kentucky	k e n . t eo . k i
paolo	p a . o l . l o
ji	j i
rourke	l u . k eu
nathaniel	n eo . d ae . n i . eo l
bernie	b eo . n i
hawthorne	h o . s o n
baffin	b ae . p i n
anders	a n . d e . l eu . s eu
nico	n i . k o
stonehenge	s eu . t o n . h e n . j i
ilyushin	i l . l yu . s i n
braine	b eu . l e . i n
runge	l u ng . g e
knight	n a . i . t eu
ethel	e . d e l
khachaturyan	h a . ch a . t u . l i . a n
pasternak	p a . s eu . t e . l eu . n a . k eu
haber	h a . b eo
arnold	a . n o l . d eu
iceland	a . i . s eu l . l a n . d eu
kania	k a . n i . a
puig	p eu . i . g eu
duchamp	d wi . s ya ng
hyndman	h a . i n . d eu . m eo n
schubert	s yu . b e . l eu . t eu
tinbergen	t i n . b eo . g e n
reyes	l e . i . eo . s eu
hristov	h eu . l i . s eu . t o . p eu
wiesel	b i . s e l
rivero	l i . b e . l o
gobineau	g o . b i . n o
beverly	b i . b eo . l i
boothroyd	b u . s eu . l o . i . d eu
kearsley	k i . eo . s eu l . l i
altamira	a l . t a . m i . l a
yehudi	ye . h u . d i
nixon	n i g . s eu n
cortona	k o . l eu . t o . n a
conrad	k o n . l ae . d eu
brenda	b eu . l e n . d a
montessori	m o n . t e . s o . l i
sauer	j a . u . eo
beirut	b e . i . l u . t eu
colt	k o l . t eu
palgrave	p o l . g eu . l e . i . b eu
lehmbruck	l e m . b eu . l u . k eu
sexton	s e g . s eu . t eo n
huber	h u . b eo
martinus	m a . l eu . t i . n u . s eu
goldmann	g o l . d eu . m a n
vella	b e l . l a
caen	k a ng
elion	e l . l i . eo n
milo	m i l . l o
pieter	p i . t eo
wieland	b i l . l a n . t eu
ramirez	l a . m i . l e . j eu
plato	p eu l . l a . t o n
britt	b eu . l i s
turkey	t eo . k i
charlotte	s ya l . l o . t eu
chaplin	ch ae . p eu l . l i n
rabinowitz	l a . b i . n o . b i . ch eu
michel	m i . s ye l
pitt	p i . t eu
capote	k eo . p o . t i
hill	h i l
karimi	k a . l i . m i
joshi	j o . s i
escoffier	e . s eu . k o . p i . e
hanks	h ae ng . k eu . s eu
lise	l i . j e
pattani	p a . t a . n i
deaver	d i . b eo
michaux	m i . s yo
james	j e . i m . s eu
candice	k ae n . d i . s eu
erikson	e . l i g . s eu n
marianne	m a . l i . a n . n eu
lahti	l a . t i
mercator	m e . l eu . k a . t o . l eu
amado	a . m a . d o
savage	s e . b i . j i
heidelberg	h a . i . d e l . b e . l eu . k eu
alba	a l . b a
marjatta	m a . l eu . ya . t a
hendricks	h ae n . d eu . l i g . s eu
yvette	i . b e . tt eu
goodnow	g u s . n o . u
mabel	m a . b e l
stumpf	s yu . t u m . p eu
levi	l i . b a . i
wheatley	wi . t eu l . l i
berkeley	b a . k eu l . l i
cone	k o n
lucius	l u . ch i . u . s eu
lowe	l o . we
humphery	h eo m . p eu . l i
daniels	d ae . n i . eo l . s eu
mbabane	eu m . b a . b a . n e
trimble	t eu . l i m . b eu l
alisa	a l . l i . s a
swanson	s eu . wa n . s eu n
laufer	l a . u . p eo
sologub	s o l . l o . g u . p eu
schiller	s i l . l eo
wlodzimierz	b eu l . l o . ch i . m i . e . l eu . ch eu
steichen	s eu . t a . i . k eo n
fonseca	p o n . s e . k a
dortmund	d o . l eu . t eu . m u n . t eu
vieira	b i . e . l a
schlaf	s yu l . l a . p eu
taube	t a . u . b eo
bangui	b a ng . g i
murat	m u . l a . t eu
maor	m a . o
africa	a . p eu . l i . k a
britten	b eu . l i . t eu n
taunton	t o n . t eo n
billy	b i l . l i
derzhavin	d e . l eu . j a . b i n
mumford	m eo m . p eo . d eu
hollywood	h a l . l i . u . d eu
vaga	b a . g a
vallejo	b a . ye . h o
platt	p eu l . l ae s
southern	s eo . d eo n
bergengruen	b e . l eu . g e n . g eu . l wi n
eduard	e . d u . a . l eu . t eu
rota	l o . t a
stevin	s eu . t e . b i n
woodworth	u . d eu . wo . s eu
filchner	p i l . h i . n eo
renan	l eu . n a ng
connelly	k o . n eo l . l i
giauque	j i . o . k eu
appel	a . p e l
lang	l a ng
benvenuto	b e n . b e . n u . t o
morales	m o . l a l . l e . s eu
bellevue	b e l . l e . b yu
purcell	p eo . s e l
asso	a . s o
greenfield	g eu . l i n . p i l . d eu
diouf	d i . u . p eu
fairbanks	p e . eo . b ae ng . k eu . s eu
emeric	i . m e . l i g
tilman	t i l . m a n
neutra	n o . i . t eu . l a
camdessus	k a ng . d eu . s wi
lasse	l a . s e
begin	b e . g i n
hinshelwood	h i n . s yeo l . u . d eu
canaro	k a . n a . l o
colman	k o l . m eo n
andrews	ae n . d eu . l u . s eu
dutton	d yu . t o n
defoe	d i . p o
giddens	g i . d eu n . s eu
knox	n o g . s eu
joshua	yeo . h o . s u . a
cendrars	s a ng . d eu . l a . l eu
hilty	h i l . t i
adonis	a . d o . n i . s eu
brundtland	b eu . l u n . t eu l . l a n
houdon	u . d o ng
antal	ae n . t a l
lyons	l i . yo ng
varenius	b a . l e . n i . u . s eu
light	l a . i . t eu
dresden	d eu . l e . s eu . d e n
natalie	n a . t a l . l i
buch	b u . h eu
husserl	h u . s eo l
murphy	m eo . p i
peary	p i . eo . l i
raymond	l e . m o ng
busoni	b u . s o . n i
lister	l i . s eu . t eo
basseterre	b a . s eu . t e . l eu
lesseps	l e . s e b . s eu
pound	p a . u n . d eu
brzezinski	b eu . l e . j i n . s eu . k i
tanguy	t a ng . g i
bournonville	b u . l eu . n o ng . b i l
kathmandu	k a . t eu . m a n . d u
husseini	h u . s e . i . n i
stephens	s eu . t i . b eu n . s eu
georgi	g e . o . l eu . g i
kayser	k a . i . j eo
lindberg	l i n . d eu . b eo . g eu
brahms	b eu . l a m . s eu
olsen	o l . s eu n
avery	e . b eo . l i
massachusetts	m ae . s a . ch u . s e . ch eu
brunel	b eu . l u . n e l
mordechai	m o . l eu . d e . h a . i
eddie	e . d i
brunat	b eu . l wi . n a
nezval	n e . j eu . b a l
mironov	m i . l o . n o . p eu
bullock	b u l . l eo g
hoyt	h o . i . t eu
cates	k e . i . ch eu
petersen	p i . t eo . s eu n
wim	b i m
mesquita	m e . s eu . k i . t a
pershing	p eo . s i ng
butterworth	b eo . t eo . wo . s eu
pirenne	p i . l e n
giddings	g i . d i ng . s eu
kamal	k a . m a l
gerrit	h e . l i . t eu
ince	i n . s eu
hertwig	h e . l eu . t eu . b i . h i
lucien	l wi . s i . ae ng
mozart	m o . ch a . l eu . t eu
dodge	d a . j i
brad	b eu . l ae . d eu
montes	m o n . t e . s eu
bonhoeffer	b o n . h oe . p eo
darmstadt	d a . l eu m . s yu . t a . t eu
leipold	l a . i . p o l . t eu
eder	e . d eo
osbourne	o . s eu . b o n
castiglione	k a . s eu . t i l . l i . o . n e
beardsley	b i . eo . j eu l . l i
simone	s i . m o . n e
boyer	b o . i . eo
rubio	l u . b i . o
kinshasa	k i n . s ya . s a
wartburg	b a . l eu . t eu . b u . l eu . k eu
coubertin	k u . b e . l eu . t ae ng
gance	g a ng . s eu
alfred	a l . p eu . l e . d eu
alger	a l . j e
prus	p eu . l u . s eu
serafin	s e . l a . p i n
woodrow	u . d eu . l o
tavares	t a . b a . l e . s eu
schleiermacher	s yu l . l a . i . eo . m a . h eo
chelmsford	ch e l . l eu m . s eu . p eo . d eu
sorge	s o . l eu . j u
ustinov	yu . s eu . t i . n o . p eu
gleysteen	g eu l . l a . i . s eu . t i n
fraunhofer	p eu . l a . u n . h o . p eo
eystein	e . s eu . t a . i n
sonja	s o . n ya
kumar	k u . m a . l eu
mays	m e . i . s eu
repin	l e . p i n
moreno	m o . l e . n o
manchester	m ae n . ch e . s eu . t eo
wallon	wa l . l o ng
bergman	b eo . g eu . m eo n
ruggiero	l u . j i . e . l o
peyton	p e . i . t eu n
colorado	k o l . l o . l a . d o
becket	b e . k e . t eu
daniele	d a . n i . e l
sosa	s o . s a
feuchtwanger	p o . i . h i . t eu . b a ng . g eo
lilienthal	l i l . l i . e n . s o l
raphael	l a . p a . e l
winchester	wi n . ch e . s eu . t eo
youssef	yu . s e . p eu
weiyi	we . i . i
scranton	s eu . k eu . l ae n . t eo n
grieg	g eu . l i . g eu
lowie	l o . wi
moniz	m o . n i . j eu
gossec	g o . s e . k eu
french	p eu . l e n . ch i
katie	k e . i . t i
fano	p a . n o
wallach	b a l . l a . h eu
roma	l o . m a
fadeev	p a . d e . ye . p eu
carnegie	k a . n e . g i
wohlgemut	b o l . g e . m u . t eu
bishop	b i . s yo b
cuthbert	k eo . s eu . b eo . t eu
kaganovich	k a . g a . n o . b i . ch i
honghai	h u ng . h a . i
keiser	k a . i . j eo
denny	d e . n i
whitfield	h wi s . p i l . d eu
monique	m o . n i . k eu
michels	m i . h e l . s eu
tiberius	t i . b e . l i . u . s eu
addams	ae . d eo m . s eu
tran	t eu . l a n
karina	k a . l i . n a
griffin	g eu . l i . p i n
moss	m o . s eu
alexandra	a l . l e g . s a n . d eu . l a
pretorius	p eu . l e . t o . l i . u . s eu
whipple	h wi . p eu l
myers	m a . i . eo . s eu
griffiths	g eu . l i . p i . s eu
zorn	s o . l eu n
rachel	l a . h e l
guerra	g e . l a
thorvaldsen	t o . l eu . b a l . s e n
habermas	h a . b eo . m a . s eu
kyle	k a . i l
weinberg	wa . i n . b eo . g eu
vladimir	b eu l . l a . d i . m i . l eu
mark	m a . l eu . k eu
vittorio	b i . t o . l i . o
everhart	e . b eo . h a . t eu
goldsworthy	g o l . j eu . wo . d i
hemingway	h e . m i ng . we . i
marinetti	m a . l i . n e . t i
unger	u ng . g eo
pitcairn	p i s . k e . eo n
delano	d i l . l a . n o
whittall	h wi s . t o l
heyman	h e . i . m eo n
hort	h o l . t eu
kiev	k i . ye . p eu
chad	ch a . d eu
weismann	b a . i . s eu . m a n
spencer	s eu . p e n . s eo
reg	l e . j i
hasenclever	h a . j e n . k eu l . l e . b eo
benito	b e . n i . t o
kosygin	k o . s i . g i n
ozenfant	o . j a ng . p a ng
magellan	m a . j e l . l a n
isabel	i . s a . b e l
tad	t ae . d eu
heymans	h a . i . m a n . s eu
humphrey	h eo m . p eu . l i
barlach	b a . l eu l . l a . h eu
szilard	j i l . l a . d eu
qingxian	ch i ng . s ye n
funke	p u ng . k e
barrera	b a . l e . l a
cremona	k eu . l e . m o . n a
freddie	p eu . l e . d i
liam	l i . eo m
delia	d e l . l i . a
gilbert	g i l . b eo . t eu
arce	a . l eu . s e
simic	s i . m i . ch i
katharina	k a . t a . l i . n a
beda	b e . d a
moody	m u . d i
nightingale	n a . i . t i ng . g e . i l
maine	m e . i n
salvini	s a l . b i . n i
stroessner	s eu . t eu . l o . e . s eu . n e . l eu
kris	k eu . l i . s eu
jim	j i m
spengler	s yu . p e ng . g eu l . l eo
liechtenstein	l i . h i . t e n . s yu . t a . i n
tilghman	t i l . m eo n
funk	p u ng . k eu
chile	ch i l . l e
dovzhenko	d o . p eu . j e n . k o
oken	o . k e n
astana	a . s eu . t a . n a
norbert	n o . l eu . b e . l eu . t eu
focke	p o . k e
starling	s eu . t a l . l i ng
raya	l a . ya
franklin	p eu . l ae ng . k eu l . l i n
bukharin	b u . h a . l i n
suarez	s u . a . l e . j eu
davies	d e . i . b i . s eu
dietzgen	d i . ch eu . g e n
paterson	p ae . t eo . s eu n
jobim	j o . b i m
francke	p eu . l a ng . k e
danielsson	d a . n i . e l . s o n
kingstown	k i ng . s eu . t a . u n
flynn	p eu l . l i n
eritrea	e . l i . t eu . l e . a
childe	ch a . i l . d eu
lasky	l ae . s eu . k i
grass	g eu . l a . s eu
budapest	b u . d a . p e . s eu . t eu
welsh	we l . s wi
ungaretti	u ng . g a . l e . t i
gromyko	g eu . l o . m i . k o
cain	k a . i n
berkshire	b a . k eu . s yeo
lilli	l i l . l i
goode	g u . d eu
grande	g eu . l ae n . d eu
redmond	l e . d eu . m o n . d eu
fahmi	p a . m i
galton	g o l . t eo n
stan	s eu . t ae n
kingston	k i ng . s eu . t eo n
rose	l o . j eu
klein	k eu l . l a . i n
karin	k a . l i n
snider	s eu . n a . i . d eo
tarrant	t a . l a n . t eu
simeon	s i . m eu . o n
jahn	ya n
robbins	l o . b i n . s eu
alejandro	a l . l e . h a n . d eu . l o
benjamin	b e n . j a . m i n
capra	k ae . p eu . l a
marton	m a . l eu . t o n
baccelli	b a . s e l . l i
howell	h a . we l
cassidy	k ae . s i . d i
gomulka	g o . m u . u . k a
sok	s eo g
mortimer	m o . t i . m eo
reinhardt	l a . i n . h a . l eu . t eu
dickinson	d i . k i n . s eu n
vicki	b i . k i
claude	k eu l . l a . u . d eu
gaskell	g ae . s eu . k e l
daladier	d a l . l a . d i . e
hekmatyar	h e . k eu . m a . t i . a . l eu
djibouti	j i . b u . t i
salih	ss a l . l i . h eu
weizmann	b a . i . ch eu . m a n
bevan	b e . b eo n
garibaldi	g a . l i . b a l . d i
debye	d i . b a . i
gibbons	g i . b eo n . s eu
metz	m e . s eu
wilma	wi l . m a
allon	a l . l o n
miguel	m i . g e l
cottbus	k o s . b u . s eu
nodier	n o . d i . e
abercromby	ae . b eo . k eu . l o m . b i
jarre	j a . l eu
gaitskell	g e . i . ch eu . k e l
broadway	b eu . l o . d eu . we . i
heine	h a . i . n e
joost	yo . s eu . t eu
ogburn	o . g eu . b eo n
godin	g o . d i n
els	e l . s eu
arturo	a . l eu . t u . l o
heiberg	h e . i . b e . l eu . g eu
agrippa	a . g eu . l i . p a
babe	b e . i . b eu
vinay	b i . n a . i
petit	p eu . t i
yala	ya l . l a
vavilov	b a . b i l . l o . p eu
coleman	k o l . m ae n
clapton	k eu l . l ae b . t eu n
platen	p eu l . l a . t e n
kamil	k a . m i l
herta	h e . l eu . t a
bryusov	b eu . l yu . s o . p eu
hartmann	h a . l eu . t eu . m a n
kathy	k ae . s i
yassin	ya . s i n
korngold	k o n . g o l . d eu
asher	a . s e l
worms	b o . l eu m . s eu
cyril	k i . l i l . l o . s eu
schleicher	s yu l . l a . i . h eo
khalil	k a l . l i l
littleton	l i . t eu l . t eo n
botswana	b o . ch eu . wa . n a
helmholtz	h e l . l eu m . h o l . ch eu
saillant	s a . ya ng
bitter	b i . t eo
fuller	p u l . l eo
fernandez	p e . l eu . n a n . d e . s eu
scipio	s eu . k i . p i . o
gregorius	g eu . l e . g o . l i . u . s eu
heinrich	h a . i n . l i . h i
cara	k a . l a
jozef	yo . j e . p eu
curt	k u . l eu . t eu
nadar	n a . d a . l eu
houghton	h o . t eu n
field	p i l . d eu
rene	l eu . n e
hagen	h a . g e n
kane	k e . i n
machado	m a . ch a . d o
harlem	h a l . l e m
joule	j u l
butler	b eo . t eu l . l eo
lagrange	l a . g eu . l a ng . j u
chardonne	s ya . l eu . d o n
potyomkin	p o . t yo m . k i n
robert	l o . b eo . t eu
jerusalem	ye . l u . s a l . l e m
reggie	l e . j i
bonnici	b o . n i . ch i
troy	t eu . l o . i
kierkegaard	k i . e . l eu . k e . g o . l eu
batyushkov	b a . t yu . s yu . k o . p eu
grassmann	g eu . l a . s eu . m a n
albano	a l . b a . n o
steinberg	s eu . t a . i n . b eo . g eu
kazan	k a . j a n
martine	m a . l eu . t i n
dufour	d u . p o . b o ng
luxemburg	l u g . s e m . b u . l eu . k eu
antananarivo	a n . t a . n a . n a . l i . b o
salinger	s ae l . l i n . j eo
emily	e . m i l . l i
inger	i ng . g eo
wayne	we . i n
moretti	m o . l e . t i
felipe	p e l . l i . p e
donne	d eo n
spallanzani	s eu . p a l . l a n . ch a . n i
jacobs	j e . i . k o b . s eu
beyer	b a . i . eo
worthy	wo . d i
dartmouth	d a . t eu . m eo . s eu
mann	m a n
patterson	p ae . t eo . s eu n
madras	m a . d eu . l a . s eu
albo	ae l . b o
zaire	j a . i . l eu
kulikov	k u l . l i . k o . p eu
hazard	h ae . j eo . d eu
boccherini	b o . k e . l i . n i
cassou	k a . s u
adamov	a . d a . m o . p eu
soros	s o . l o . s eu
apollinaire	a . p o l . l i . n e . l eu
saran	s a . l a n
baum	b a . u m
mengelberg	m e ng . g e l . b e . l eu . k eu
herman	h eo . m eo n
minaux	m i . n o
mia	m i . a
pierluigi	p i . e . l eu l . l u . i . j i
flavius	p eu l . l a . b i . u . s eu
newbolt	n yu . b o l . t eu
ricky	l i . k i
winifred	wi n . p eu . l e . d eu
young	yeo ng
daumier	d o . m i . e
karrer	k a . l eo
lamar	l a . m a
denis	d e . n i . s eu
acosta	a . k o . s eu . t a
toynbee	t o . i n . b i
lesotho	l e . s o . t o
pembroke	p e m . b eu . l u g
nathan	n a . d a n
landgrebe	l ae n . d eu . g eu . l e . b e
pym	p i m
bentley	b e n . t eu . l i
amin	a . m i n
stephan	s yu . t e . p a n
gretchen	g eu . l e . ch e n
alencar	a l . l e n . k a . l eu
claudius	k eu l . l a . u . d i . u . s eu
ziegler	ch i . g eu l . l eo
volgograd	b o l . g o . g eu . l a . d eu
mart	m a . l eu . t eu
mexico	m e g . s i . k o
fiennes	p a . i n . j eu
delius	d i l . l i . eo . s eu
switzerland	s eu . wi . s eu
oceania	o . s e . a . n i . a
stanislav	s eu . t a . n i . s eu l . l a . p eu
wheatstone	h wi . t eu . s eu . t o n
kell	k e l . l i
petri	p e . t eu . l i
montreal	m o n . t eu . l i . o l
naumann	n a . u . m a n
tom	t o m
haas	h a . s eu
aziz	a . j i . j eu
christchurch	k eu . l a . i . s eu . t eu . ch eo . ch i
preminger	p eu . l e . m i n . j eo
breuer	b eu . l o . i . eo
patricia	p eo . t eu . l i . s ya
tura	t u . l a
israel	i . s eu . l a . e l
uzi	u . j i
hobbes	h o b . s eu
macdonald	m ae g . d o . n eo l . d eu
nunes	n u . n i . s eu
melba	m e l . b a
brendel	b eu . l e n . d e l
caton	k e . i . t eu n
dayton	d e . i . t eo n
donahue	d o . n a . h yu
bodin	b o . d ae ng
parish	p ae . l i . s wi
helsinki	h e l . s i ng . k i
valadon	b a l . l a . d o ng
gozzoli	g o . ch o l . l i
bourget	b u . l eu . j e
roxanne	l o g . s a n . n eu
braga	b eu . l a . g a
schliemann	s yu l . l i . m a n
encke	e ng . k e
windsor	wi n . j eo
heym	h a . i m
cesalpino	ch e . s a l . p i . n o
peres	p e . l e . s eu
torrence	t o . l eo n . s eu
utah	yu . t a
eliezer	e l . l i . e . j e . l eu
macy	m e . i . s i
koller	k o l . l eo
buchenwald	b u . h e n . b a l . t eu
nicaragua	n i . k a . l a . g wa
haydn	h a . i . d eu n
concord	k o ng . k o . d eu
imre	i m . l e
prior	p eu . l a . i . eo
garland	g a l . l eo n . d eu
reichstein	l a . i . h i . s yu . t a . i n
eckert	e . k e . l eu . t eu
mach	m a . h a
gautier	g o . t i . e
cambiaso	k a m . b i . a . s o
germain	j e . l eu . m ae ng
pike	p a . i . k eu
dunkirk	d wi ng . k e . l eu . k eu
reading	l e . d i ng
andrei	a n . d eu . l e . i
curtis	k eo . t i . s eu
hayat	h a . ya s
benedikt	b e . n e . d i g . t eu
kaufmann	k a . u . p eu . m a n
saint	s ae n . t eu
robb	l o b
herschel	h eo . s yeo l
planck	p eu l . l a ng . k eu
litvinov	l i . t eu . b i . n o . p eu
william	b i l . l i . a m
fridtjof	p eu . l i . d eu . s yo . p eu
renard	l eu . n a . l eu
rauschenbusch	l a . u . s yeo n . b u . s i
peterson	p i . t eo . s eu n
buck	p eo l
heckel	h e . k e l
araujo	a . l a . u . j o
chesterton	ch e . s eu . t eo . t eo n
crivelli	k eu . l i . b e l . l i
ferguson	p eo . g eo . s eu n
marin	m a . l ae ng
riddick	l i . d i g
simmons	s i . m eo n . s eu
thaddeus	d a . d ae . o
laplace	l a . p eu l . l a . s eu
osler	o . s eu l . l eo
vinci	b i n . ch i
mobile	m o . b a . i l
selznick	s e l . j eu . n i g
comoros	k o . m o . l o
saxon	s ae g . s eu n
alexei	a l . l e g . s e . i
perec	p e . l e g
pfeffer	p e . p eo
huntsville	h eo n . ch eu . b i l
eusebio	e . u . s e . b i . u
bogarde	b o . g a . d eu
savannah	s eo . b ae . n eo
kenya	k e . n ya
marko	m a . l eu . k o
giza	g i . j a
magee	m ae . g i
east	d o ng . b a ng
kale	k e . i l
topelius	t o . p e l . l i . u . s eu
espinosa	e . s eu . p i . n o . j a
pufendorf	p u . p e n . d o . l eu . p eu
cardano	k a . l eu . d a . n o
saroyan	s a . l o . i . eo n
mendes	m e n . d e . s eu
pons	p o ng . s eu
peper	p e . p e . l eu
rolland	l o l . l a ng
veronica	b e . l o . n i . k a
hibernia	h a . i . b eo . n i . a
montpellier	m o ng . p e l . l i . e
proust	p eu . l u . s eu . t eu
bud	b eo . d eu
woods	u . j eu
portman	p o . t eu . m a n
cram	k eu . l ae m
rosenthal	l o . j e n . t a l
cuomo	k u . o . m o
guatemala	g wa . t e . m a l . l a
ismael	i . s eu . m a . e l
gilels	g i l . l e l . s eu
prokhorov	p eu . l o . h o . l o . p eu
leonhard	l e . o n . h a . l eu . t eu
mance	m ae n . s eu
sand	s a ng . d eu
brunei	b eu . l u . n a . i
barton	b a . t eo n
vorontsov	b o . l o n . ch o . p eu
danton	d a ng . t o ng
baty	b a . t i
sickingen	j i . k i ng . g e n
joaquim	h o . a . k i m
pettersson	p e . t eo . s eu n
riyadh	l i . ya . d eu
liebermann	l i . b e . l eu . m a n
chagall	s ya . g a l
knowles	n o l . s eu
henkel	h e n . k e l
harlow	h a l . l o
fidel	p i . d e l
shlomo	s yu l . l o . m o
bradstreet	b eu . l ae . d eu . s eu . t eu . l i . t eu
phelps	p e l . p eu . s eu
iberia	i . b e . l i . a
goldie	g o l . d i
maher	m a . h e . l eu
ezekiel	e . j e . k i . e l
dugan	d yu . g eo n
gianfranco	j a n . p eu . l a ng . k o
crispi	k eu . l i . s eu . p i
kornfeld	k o n . p i l . d eu
eckardt	e . k a . l eu . t eu
hassanal	h a . s a . n a l
dirichlet	d i . l i . k eu l . l e
latvia	l a . t eu . b i . a
macbeth	m ae g . b e . s eu
baldung	b a l . d u ng
brody	b eu . l o . d i
michell	m i . ch e l
grandi	g eu . l a n . d i
pinero	p i . n e . l o
speight	s eu . p e . i . t eu
gabrieli	g a . b eu . l i . e l . l i
duvall	d yu . b a l
frits	p eu . l i . ch eu
calcutta	k ae l . k eo . t a
verrocchio	b e . l o . k i . o
moroni	m o . l o . n i
turin	t u . l i n
moberg	m o . b e . l i
bram	b eu . l a m
garr	g a
hardie	h a . d i
pontryagin	p o n . t eu . l ya . g i n
juneau	j u . n o
sula	s u . l a
cartier	k a . l eu . t i . e
opitz	o . p i . ch eu
rudin	l u . d i n
spitteler	s yu . p i . t e l . l eo
cherry	ch e . l i
haiti	a . i . t i
lafontaine	l a . p o ng . t e n
lundberg	l u n . d eu . b e . l i
fritz	p eu . l i . ch eu
gabriele	g a . b eu . l i . e l . l e
scorsese	s eu . k o l . s e . i . j i
jakobson	ya . k o b . s eu n
kaas	k a . s eu
spence	s eu . p e n . s eu
gaye	g e . i
holst	h o l . s eu . t eu
chiara	k i . a . l a
schneider	s yu . n a . i . d eo
ramon	l a . m o n
frunze	p eu . l u n . j e
bernstein	b eo n . s eu . t a . i n
orson	o . s eo n
biddle	b i . d eu l
scherman	s ye . l eu . m a n
khan	k a n
bakst	b a g . s eu . t eu
eager	i . g eo
sydow	s i . d o
bradford	b eu . l e . d eu . p o . d eu
davids	d a . b i . ch eu
darryl	d ae . l i l
joyce	j o . i . s eu
kee	k i
jaspers	ya . s eu . p eo . s eu
berti	b e . l eu . d i
weir	wi . eo
linschoten	l i n . s eu . h o . t e n
viking	b a . i . k i ng
undset	u n . s e . t eu
pauli	p a . u l . l i
soledad	s o l . l i . d a . d eu
rossellini	l o . s e l . l i . n i
mayflower	m e . i . p eu l . l a . wo
georges	j e . o . l eu . j e . s eu
heseltine	h e . s eu l . t a . i n
lanning	l ae . n i ng
barents	b a . l e n . ch eu
blok	b eu l . l o . k eu
cabell	k ae . b eo l
angelo	a n . j e l . l o
calgary	k ae l . g eo . l i
caplet	k ae . p eu l . l i s
camara	k a . m a . l a
reilly	l a . i l . l i
wieniawski	b i . e . n i . a . p eu . s eu . k i
babeuf	b a . b oe . p eu
cynthia	s i n . s i . a
saarinen	s a . l i . n e n
trinidad	t eu . l i . n i . d a . d eu
chopin	s yo . p ae ng
valletta	b a l . l e . t a
shah	s ya . a
frankland	p eu . l ae ng . k eu l . l ae n . d eu
bode	b o . d e
olive	o l . l i . b eu
nujoma	n u . j o . m a
shapley	s yae . p eu l . l i
benghazi	b e ng . g a . j i
zuckmayer	ch u . k eu . m a . i . eo
delhi	d e l . l i
joel	yo . e l
segovia	s e . g o . b i . a
somare	s o . m a . l e
mikhailov	m i . h a . i l . l o . p eu
vazov	b a . j o . p eu
loy	l o . i
pratt	p eu . l ae s
whitworth	h wi . t eu . wo . s eu
reagan	l e . i . g eo n
ephraim	e . p eu . l a . i m
zajac	j a . j a . k eu
rommel	l o . m e l
verdier	b e . l eu . d i . e
anwar	a n . wa . l eu
casella	k a . s e l . l a
walton	wo l . t eo n
papini	p a . p i . n i
georgetown	j o . j i . t a . u n
gaul	g o l
bertin	b e . l eu . t ae ng
rob	l o b
masur	m a . j u . eo
myron	m i . l o n
vauban	b o . b a ng
freytag	p eu . l a . i . t a . k eu
philippa	p i l . l i . p a
waterloo	wo . t eo l . l u
sargent	s a . j eo n . t eu
schweitzer	s yu . b a . i . ch eo
holstein	h o l . s eu . t a . i n
bishkek	b i . s yu . k e . k eu
arnauld	a . l eu . n o
nyers	n e . l eu . s i
burbank	b eo . b ae ng . k eu
leary	l i . eo . l i
charlie	ch a l . l i
margarita	m a . g a . l i . t a
hedy	h e . d i
monaco	m o . n a . k o
dube	d u . b e
mate	m e . i . t eu
lithuania	l i . t u . a . n i . a
dunant	d wi . n a ng
reddy	l e . d i
ellington	e l . l i ng . t eo n
sabine	s a . b i n
hogan	h o . g eo n
richter	l i . h i . t eo
sidgwick	s i . j i . wi g
lucena	l u . s e . n a
pietro	p i . e . t eu . l o
tussaud	t eo . s o
churchill	ch eo . ch i l
degas	d eu . g a
fritsch	p eu . l i . ch i
isaacs	i . s a g . s eu
grenville	g eu . l e n . b i l
grosse	g eu . l o . s e
alberto	a l . b e . l eu . t o
virginia	b eo . j i . n i . a
matthew	m ae . s yu
eisenstaedt	a . i . j e n . s eu . t a . t eu
venter	b e n . t eo
kivi	k i . b i
hardwicke	h a . d eu . wi . k e
grillo	g eu . l i l . l o
seth	s e s
karachi	k a . l a . ch i
devonshire	d e . b eo n . s yeo
tikhonov	t i . h o . n o . p eu
eyre	e . eo
avogadro	a . b o . g a . d eu . l o
emin	e . m i n
joseph	yo . s e b
roach	l o . ch i
haris	h a . l i . s eu
jongkind	yo ng . k i n . t eu
byrd	b eo . d eu
sammy	s ae . m i
kemble	k e m . b eu l
polevoi	p o l . l e . b o . i
renata	l e . n a . t a
hering	h e . l i ng
kaiser	k a . i . j eo
roosevelt	l u . s eu . b e l . t eu
aragon	a . l a . g o n
malkin	m a l . k i n
heaviside	h e . b i . s a . i . d eu
rollo	l o l . l o
theodore	t e . o . d o . l eu
paola	p a . o l . l a
beatty	b i . t i
bloomington	b eu l . l u . m i ng . t eo n
guarino	g wa . l i . n o
willemstad	b i l . l e m . s eu . t a . t eu
lander	l ae n . d eo
bunche	b eo n . ch i
rucker	l eo . k eo
brady	b eu . l ae . d i
kristin	k eu . l i . s eu . t i n
ems	e m . s eu
corradi	k o . l a . d i
stephanopoulos	s eu . t e . p a . n o . p u l . l o . s eu
ahn	a n
albania	a l . b a . n i . a
lofting	l o . p eu . t i ng
cabrera	k a . b eu . l e . l a
eli	e l . l i
packard	p ae g . k eo . d eu
gryphius	g eu . l i . p i . u . s eu
windhoek	b i n . t eu . h u . k eu
lodi	l o . d i
eddington	e . d i ng . t eo n
midway	m i . d eu . we . i
vera	b e . l a
neil	n i l
andy	ae n . d i
utrecht	wi . t eu . l e . h eu . t eu
sangallo	s a ng . g a l . l o
hope	h o . p eu
guarini	g wa . l i . n i
andreas	a n . d eu . l e . a . s eu
mingdao	m i ng . d a . o
hastings	h e . i . s eu . t i ng . s eu
harvard	h a . b eo . d eu
sol	s o l
rivlin	l i . b eu l . l i n
bausch	b a . u . s yu
milt	m i l . t eu
lemaire	l eu . m e . l eu
lake	l e . i . k eu
klopstock	k eu l . l o b . s yu . t o . k eu
kaverin	k a . b e . l i n
jain	j e . i n
jeff	j e . p eu
mcbride	m ae g . b eu . l a . i . d eu
discovery	d i . s eu . k eo . b eo . l i
tiger	t a . i . g eo
reis	l a . i . s eu
allah	a l . l a
wolker	b o l . k e . l eu
lucille	l u . s i l
gabor	g a . b o . l eu
farmington	p a . m i ng . t eo n
vesuvius	b e . s u . b i . o
miami	m a . i . e . m i
ariosto	a . l i . o . s eu . t o
bowring	b o . u . l i ng
pacino	p a . ch i . n o
ira	a . i . l a
rumsey	l eo m . j i
lyell	l a . i . e l
gilmore	g i l . m o . eo
beatrix	b e . a . t eu . l i g . s eu
short	s yo . t eu
aachen	a . h e n
arne	a . l eu . n e
bjork	b i . yo . k eu
delaunay	d eu l . l o . n e
dion	d i . o ng
abbot	a . b o . t eu
eysenck	a . i . s eo n . k eu
krueger	k eu . l u . g eo
bojer	b o . ye . l eu
kann	k a n
hepworth	h e b . wo . s eu
hassel	h a . s e l
einhorn	a . i n . h o n
nicholas	n i . k o l . l a . s eu
mutter	m u . t eo
bang	b a ng
montemayor	m o n . t e . m a . yo . l eu
leno	l e . n o
urey	yu . l i
derby	d eo . b i
caine	k e . i n
cane	k e . i n
odilon	o . d i l . l o ng
wittig	b i . t i . h i
oaxaca	o . a g . s a . k a
ferenc	p e . l e n . ch eu
templeton	t e m . p eu l . t eo n
sherriff	s ye . l i . p eu
kahn	k a n
fitch	p i . ch i
alexandria	a l . l e g . s a n . d eu . l i . a
levine	l eo . b a . i n
snow	s eu . n o
smolensk	s eu . m o l . l e n . s eu . k eu
kolarov	k o l . l a . l o . p eu
montgolfier	m o ng . g o l . p i . e
pastor	p a . s eu . t eo
carl	k a . l eu l
norah	n o . l a
newlands	n yu . l ae n . j eu
pollard	p o l . l a . d eu
pritchard	p eu . l i . ch eo . d eu
ibadan	i . b a . d a n
riverside	l i . b eo . s a . i . d eu
suess	j wi . s eu
marlin	m a l . l i n
pergolesi	p e . l eu . g o l . l e . s i
olof	o l . l o . p eu
edmonton	e . d eu . m eo n . t eo n
punsalmaagiyn	p u n . s a l . m a . g i n
schumann	s yu . m a n
karel	k a . l e l
montalvo	m o n . t a l . b o
huguette	wi . g e . t eu
rossi	l o . s i
tate	t e . i . t eu
josh	j o . s i
lipchitz	l i b . s i . ch eu
xenophon	k eu . s e . n o . p o n
moudud	m u . d u . d eu
rosario	l o . s a . l i . o
mathews	m ae . t yu . s eu
bo	b o
strickland	s eu . t eu . l i g . l ae n . d eu
martindale	m a . t i n . d e . i l
hayes	h e . i . s eu
dobrolyubov	d o . b eu . l u l . l yu . b o . p eu
algren	o l . g eu . l eo n
aleksander	a l . l e g . s a n . d eo
stockman	s eu . t o . k eu . m eo n
bruce	b eu . l u . s eu
ada	e . i . d eo
branca	b eu . l a n . k a
bose	b o . s eu
jayne	j e . i n
matias	m a . t i . a . s eu
ullman	u l . m a n
greta	g eu . l e . t a
malinowski	m a l . l i . n o . p eu . s eu . k i
melissa	m e l . l i . s a
ute	u . t eu
goncourt	g o ng . k u . l eu
hoxha	h o . j a
shane	s we . i n
boulanger	b u l . l a ng . j e
brezhnev	b eu . l e . j u . n e . p eu
rosetta	l o . j e . t a
khrushchev	h eu . l u . s i . ch o . p eu
sokoloff	s o . k o l . l o . p eu
quiroga	k i . l o . g a
crabbe	k eu . l ae . b eu
faure	p o . l e
rika	l i . k a
hankel	h a ng . k e l
forlani	p o l . l a . n i
crespo	k eu . l e . s eu . p o
buchner	b u . h eu . n eo
gapon	g a . p o n
leonor	l e . o . n o . l eu
malik	m a l . l i . k eu
michelson	m a . i . k eo l . s eu n
weber	we . b eo
jenney	j e . n i
northampton	n o . s ae m . p eu . t eo n
ringer	l i ng . g eo
clinton	k eu l . l i n . t eo n
scheele	s ye l . l e
dubois	d wi . b u . a
auerbach	a . u . eo . b a . h eu
swami	s eu . wa . m i
angela	a ng . g e l . l a
tauler	t a . u l . l eo
breton	b eu . l e . t eu n
belize	b e l . l i . j eu
jameson	j e . i m . s eu n
feetham	p i . s ae m
babbitt	b a . b i . t eu
vidor	b i . d eo
bentinck	b e n . t i ng . k eu
gale	g e . i l
oklahoma	o . k eu l . l eo . h o . m a
garshin	g a . l eu . s i n
claudio	k eu l . l a . u . d i . o
mendoza	m e n . d o . j a
guadalajara	g wa . d a l . l a . h a . l a
belli	b e l . l i
rakhmaninov	l a . h eu . m a . n i . n o . p eu
leonov	l e . o . n o . p eu
brescia	b eu . l e . s i . a
koirala	k o . i . l a l . l a
edouard	e . d u . a . l eu
valeri	b a l . l e . l i
mandela	m a n . d e l . l a
muirhead	m yu . eo . h e . d eu
drinkwater	d eu . l i ng . k eu . wo . t eo
adriana	a . d eu . l i . a . n a
oliveira	o l . l i . b e . i . l a
gustaf	g u . s eu . t a . p eu
bevin	b e . b i n
maurus	m o . l wi . s eu
lambert	l a m . b e . l eu . t eu
deepak	d i . p ae g
vatican	b a . t i . k a n
lot	l o s
steffens	s yu . t e . p e n . s eu
ireland	a . i l . l ae n . d eu
harden	h a . d eu n
nernst	n e . l eu n . s eu . t eu
moll	m o l
salween	s a l . wi n
indra	i n . d eu . l a
ribera	l i . b e . l a
rolando	l o l . l a n . d o
klimt	k eu l . l i m . t eu
luise	l u . i . j e
boult	b o . u l . t eu
patti	p ae . t i
hans	h a n . s eu
oakeshott	o . k eu . s yeo . t eu
andre	a n . d eu . l e
tam	t a m
chaim	k a . i m
senior	s i . n i . eo
haldane	h o l . d e . i n
montero	m o n . t e . l o
bundy	b eo n . d i
schrieffer	s yu . l i . p eo
getty	g e . t i
zamboni	j a m . b o . n i
tendryakov	t e n . d eu . l ya . k o . p eu
angle	ae ng . g eu l
verne	b e . l eu n
perm	p e . l eu m
muzio	m u . ch i . o
ryzhkov	l i . s yu . k o . p eu
hedtoft	h e . d eu . t o . p eu . t eu
ramus	l a . m u . s eu
berman	b eo . m a n
pigalle	p i . g a l
hungary	h eo ng . g a . l i
rollins	l o l . l i n . s eu
hennebique	e n . b i . k eu
nagy	n eo . j i
carpaccio	k a . l eu . p a . ch o
garrison	g ae . l i . s eu n
bruno	b eu . l u . n o
thompson	t o m . s eu n
vigano	b i . g a . n o
krakow	k eu . l a . k o . p eu
kokoschka	k o . k o . s yu . k a
nino	n i . n o
kirchner	k i . l eu . h i . n eo
elizabeth	e l . l i . j a . b e . s eu
morgenthau	m o . g e n . ss o
pallas	p a l . l a . s eu
thomas	d o . m a
crompton	k eu . l eo m . p eu . t eo n
barrymore	b e . l i . m o . eo
herren	h e . l e n
arena	a . l e . n a
amontons	a . m o ng . t o ng
holden	h o l . d eu n
mandalay	m a n . d a l . l e . i
sheila	s wi l . l a
fonteyn	p o n . t e . i n
cassandre	k a . s a ng . d eu . l eu
elijah	e l . l i . ya
scholl	s eu . k o l
asser	a . s e . l eu
santiago	s a n . t i . a . g o
bilbao	b i l . b a . o
peron	p e . l o n
krasnodar	k eu . l a . s eu . n o . d a . l eu
weinheber	b a . i n . h e . b eo
ian	i . eo n
dukas	d wi . k a
jackson	j ae g . s eu n
rwanda	l eu . wa n . d a
heidenstam	h e . i . d e n . s eu . t a m
duke	d yu . k eu
jacqueline	j ae . k eu l . l i n
beiqi	b e . i . ch i
gneisenau	g eu . n a . i . j e . n a . u
julio	h u l . l i . o
behring	b e . l i ng
ohm	o m
aho	a . h o
huch	h u . h eu
recorde	l e . k o . d eu
becker	b e . k eo
flory	p eu l . l o . l i
siegfried	j i . k eu . p eu . l i . t eu
wiechert	b i . h e . l eu . t eu
montesquieu	m o ng . t e . s eu . k i . oe
lansing	l ae n . s i ng
granet	g eu . l a . n e
siegel	s i . g e l
andersson	a n . d e . l eu . s o n
linares	l i . n a . l e . s eu
zeeman	j e . m a n
bettino	b e . t i . n o
serafimovich	s e . l a . p i . m o . b i . ch i
garnier	g a . l eu . n i . e
hardy	h a . d i
lynen	l i . n e n
nono	n o . n o
schumacher	s yu . m a . h eo
glemp	g eu l . l e m . p eu
henry	a ng . l i
uli	u l . l i
bernd	b e . l eu n . t eu
ouagadougou	wa . g a . d u . g u
holliday	h o l . l i . d e . i
baruch	b a . l u . k eu
sitwell	s i . t eu . we l
simon	s i . m o n
hanzi	h a n . jj eu
aphra	ae . p eu . l a
marne	m a . l eu n
bentham	b e n . d a m
amara	a . m a . l a
philippines	p i l . l i . p i n
stewart	s eu . t yu . eo . t eu
cairo	k a . i . l o
ciriaco	k eu . l i . a . k o
durham	d eo . l eo m
stead	s eu . t e . d eu
bethesda	b e . d e . s eu . d a
ellis	e l . l i . s eu
monica	m o . n i . k a
gracia	g eu . l a . s i . a
seuse	j o . i . j e
loewe	l oe . b e
perreau	p e . l o
bandaranaike	b a n . d a . l a . n a . i . k e
weder	we . d eo
lusaka	l u . s a . k a
ilona	i l . l o . n a
pais	p a . i . s eu
roos	l u . s eu
munro	m eo n . l o
duncan	d eo n . k eo n
bagehot	b ae . j eo s
pampas	p a m . p a . s eu
clarendon	k eu l . l ae . l eo n . d eo n
kaj	k a . i
carmel	k a . l eu . m e l
cambridge	k e . i m . b eu . l i . j i
jenkins	j e n . k i n . s eu
hulme	h yu m
tuvalu	t u . b a l . l u
rubens	l u . b e n . s eu
tyndale	t i n . d eu l
honda	h o n . d a
verner	b e . l eu . n eo
belcher	b e l . ch eo
bandello	b a n . d e l . l o
koenigsberger	k wi . n i . s eu . b eo . g eo
tutu	t u . t u
monteux	m o ng . t oe
lucia	l u . ch i . a
wolfrum	wo l . p eu . l eo m
hellsing	h e l . s i ng
tulasne	t u l . l a . s eu n
barrie	b ae . l i
ciano	ch i . a . n o
newton	n yu . t eo n
morice	m o . l i . s eu
kirov	k i . l o . p eu
mojave	m o . h a . b i
woolley	u l . l i
tippett	t i . p e s
rufus	l u . p eo . s eu
hilferding	h i l . p eo . d i ng
schwerin	s yu . b e . l i n
ober	o . b eo
romberg	l o m . b eo . g eu
capuana	k a . p u . a . n a
soddy	s o . d i
meyer	m a . i . eo
castello	k a . s eu . t e l . l o
wolff	b o l . p eu
burgess	b eo . j i . s eu
stockton	s eu . t o g . t eo n
lubbock	l eo . b eo g
asch	ae . s wi
gaia	g a . i . a
henryk	h e n . l i . k eu
syria	s i . l i . a
hench	h e n . ch i
max	m a g . s eu
tim	t i m
adriano	a . d eu . l i . a . n o
timberlake	t i m . b eo . l e . i . k eu
bertini	b eo . t i . n i
waltham	wo l . s eo m
ward	wo . d eu
kern	k eo n
pidgeon	p i . j eo n
deissmann	d a . i . s eu . m a n
laban	l a . b a n
haavelmo	h o . b e l . m o
hindemith	h i n . d e . m i . t eu
luigi	l u . i . j i
mercouri	m e . l eu . k u . l i
negroponte	n e . g eu . l o . p o n . t e
rameau	l a . m o
texas	t e g . s a . s eu
nie	n ye
willis	wi l . l i . s eu
adolfo	a . d o l . p o
meindert	m a . i n . d e . l eu . t eu
scalapino	s eu . k a l . l a . p i . n o
camargo	k a . m a . l eu . g o
michelet	m i . s yu l . l e
brighton	b eu . l a . i . t eu n
taverner	t a . b e . n eo
leicester	l e . s eu . t eo
deed	d i . d eu
longford	l o ng . p o . d eu
abdul	a b . d u l
epstein	e b . s eu . t a . i n
ulises	yu l . l i . s i . s eu
ricardo	l i . k a . d o
stammler	s yu . t a m . l eo
rathenau	l a . t e . n a . u
maxwell	m ae g . s eu . we l
noel	n o . e l
brown	b eu . l a . u n
leyte	l e . i . t e
brito	b eu . l i . t o
arkansas	a . k a n . s o
botsford	b o . ch eu . p o . d eu
bunyan	b eo n . ya n
campos	k a m . p u . s eu
lash	l ae . s wi
corsica	k o . l eu . s i . k a
sorokin	s o . l o . k i n
linz	l i n . ch eu
ocampo	o . k a m . p o
gould	g u l . d eu
nerva	n e . l eu . b a
maga	m a . g a
knowles	n o l . j eu
butte	b yu . t eu
atlanta	ae . t eu l . l ae n . t a
isaiah	i . s a . ya
cassell	k a . s e l
jacob	ya . g o b
bremen	b eu . l e . m e n
jonathan	j o . n eo . s eo n
augustin	o . g u . s eu . t i n
litt	l i s
ribot	l i . b o
lima	l i . m a
lovelace	l eo . b eu . l e . i . s eu
hawkins	h o . k i n . s eu
grimm	g eu . l i m
mondriaan	m o n . d eu . l i . a n
jeanette	j i . n e s
clayton	k eu l . l e . i . t eo n
kirsten	k eo . s eu . t i n
twardowski	t eu . wa . l eu . d o . p eu . s eu . k i
morrison	m o . l i . s eu n
ott	o . t eu
welles	we l . s eu
standen	s eu . t ae n . d eu n
marsh	m a . s i
balfour	b a l . p u . eo
probst	p eu . l o . b eu . s eu . t eu
maksim	m a g . s i m
syse	s wi . s e
frederic	p eu . l e . d eo . l i g
dod	d o . d eu
cornwell	k o n . wo l
amman	a m . m a n
kuhlau	k u l . l a . u
gierek	g i . e . l e . k eu
insel	i n . s e l
seurat	s oe . l a
johnny	j o . n i
bocage	b o . k a . j e
hawn	h o n
anaheim	ae . n eo . h a . i m
brent	b eu . l e n . t eu
kassem	k a . s e m
kempff	k e m . p eu
jean	j a n
snyder	s eu . n a . i . d eo
denise	d e . n i . j eu
pisano	p i . s a . n o
albert	a l . b eo . t eu
paraguay	p a . l a . g wa . i
beust	b o . i . s eu . t eu
steger	s yu . t e . g eo
natta	n a . t a
houston	h yu . s eu . t eo n
margaret	m a . g eo . l i s
lanson	l a ng . s o ng
browne	b eu . l a . u n
dongen	d o ng . g e n
minsk	m i n . s eu . k eu
lombardy	l o m . b a . l eu . d i . a
pire	p i . l eu
wick	wi g
elliott	e l . l i . eo s
procter	p eu . l o g . t eo
wyatt	wa . i . eo s
andres	a n . d eu . l e . s eu
jobs	j a b . s eu
lilly	l i l . l i
boulder	b o . u l . d eo
habakkuk	h a . b a g . g u g
france	p eu . l a ng . s eu
newcastle	n yu . k ae . s eu l
renault	l eu . n o
debussy	d eu . b wi . s i
queen	k wi n
melbourne	m e l . b eo . l eu n
gatto	g a . t o
wesley	we . s eu l . l i
cranach	k eu . l a . n a . h eu
pisa	p i . s a
margolis	m a . g o l . l i . s eu
kolbenheyer	k o l . b e n . h a . i . eo
reinhold	l a . i n . h o l . t eu
faraday	p ae . l eo . d i
chevalier	s yu . b a l . l i . e
lilongwe	l i l . l o ng . g we
fourier	p u . l i . e
hobbema	h o . b e . m a
burroughs	b eo . l o . s eu
deacon	d i . k o n
hunker	h a n . k a
mackenzie	m ae . k e n . j i
everest	e . b e . l e . s eu . t eu
amy	e . i . m i
petrus	b e . d eu . l o
medici	m e . d i . ch i
milosevic	m i l . l o . s ye . b i . ch i
gold	g o l . d eu
cheshire	ch e . s yeo
sara	s a . l a
larson	l a . s eu n
alameda	a l . l eo . m i . d a
ash	ae . s wi
mahaffy	m a . h a . p i
tindemans	t i n . d e . m a n . s eu
janice	j e . n i . s eu
kone	k o . n e
cadiz	k a . d i . s eu
hutchinson	h eo . ch i n . s eu n
loos	l u . s eu
beck	b e g
picasso	p i . k a . s o
eleanor	e l . l i . n eo
horacio	h o . l a . s i . o
sauvy	s o . b i
fogazzaro	p o . g a . ch a . l o
helmut	t eu
megan	m e . g a n
karelia	k a . l e l . l i . a
randolph	l ae n . d o l . p eu
merkel	m e . l eu . k e l
leskov	l e . s eu . k o . p eu
lloyd	l o . i . d eu
stakhanov	s eu . tt a . h a . n o . p eu
duer	d yu . eo
mahendra	m a . h e n . d eu . l a
sibelius	s i . b e l . l i . u . s eu
broch	b eu . l o . h eu
espinoza	e . s eu . p i . n o . j a
licht	l i . h i . t eu
nesmeyanov	n e . s eu . m e . ya . n o . p eu
geoff	j e . p eu
goebel	g oe . b e l
tamayo	t a . m a . yo
honolulu	h o . n o l . l u l . l u
rhine	l a . i n
abernethy	ae . b eo . n e . s i
bonds	b o n . j eu
goldoni	g o l . d o . n i
johanna	yo . h a . n a
ritchie	l i . ch i
quito	k i . t o
liszt	l i . s eu . t eu
ulaanbaatar	u l . l a n . b a . t o . l eu
monteiro	m o n . t e . i . l u
dov	d o . b eu
hopp	h o . p eu
adalbert	a . d a l . b e . l eu . t eu
aretino	a . l e . t i . n o
erin	e . l i n
lu	l u
brockman	b eu . l o . k eu . m a n
titchener	t i . ch i . n eo
wend	we n . d eu
temple	t e m . p eu l
beckett	b e . k e . t eu
quant	k wo n . t eu
dichev	d i . ch e . p eu
baumeister	b a . u . m a . i . s eu . t eo
estonia	e . s eu . t o . n i . a
jordan	yo . l eu . d a n
hahnemann	h a . n e . m a n
lebanon	l e . b a . n o n
darby	d a . b i
giraudoux	j i . l o . d u
pinheiro	p i . n e . i . l o
maupassant	m o . p a . s a ng
burger	b eo . g eo
humason	h yu . m e . i . s eu n
jefferson	j e . p eo . s eu n
needham	n i . d eo m
vinogradov	b i . n o . g eu . l a . d o . p eu
wald	wo l . d eu
steven	s eu . t i . b eu n
chang	j a ng
chuvash	ch u . b a . s yu
gambier	g ae m . b i . eo
lancaster	l ae ng . k eo . s eu . t eo
sherwood	s yeo . u . d eu
wilbur	wi l . b eo
andrzejewski	a n . j e . ye . p eu . s eu . k i
respighi	l e . s eu . p i . g i
balch	b o l . ch i
sabina	s a . b i . n a
yitzhak	i . ch eu . h a . k eu
kharkov	k a . k o . h eu
mohawk	m o . h o . k eu
barranquilla	b a . l a ng . k i . ya
boas	b o . ae . s eu
quincy	k wi n . s i
gassendi	g a . s a ng . d i
regan	l i . g eo n
coronado	k o . l o . n a . d o
stalin	s eu . t a l . l i n
hains	e ng . s eu
gibbs	g i . b eu . s eu
mirza	m i . l eu . j a
geoffrey	j e . p eu . l i
dupuy	d wi . p yu . i
lynch	l i n . ch i
cox	k o g . s eu
matterhorn	m a . t eo . h o . l eu n
kendall	k e n . d eu l
thatcher	d ae . ch eo
wieman	wi . m eo n
rosemary	l o . j eu . m e . l i
tajikistan	t a . j i . k i . s eu . t a n
kiowa	k a . i . o . wa
foggia	p o . j i . a
arthur	a . l eu . t u . l eu
montherlant	m o ng . t e . l eu l . l a ng
ossola	o . s o l . l a
guetta	g we . t a
lombardo	l o m . b a . l eu . d o
amelia	a . m e l . l i . a
somalia	s o . m a l . l i . a
tatum	t e . i . t eo m
allan	ae l . l eo n
petersburg	p e . t e . s eu . b u . l eu . k eu
alfa	a l . p a
ross	l o . s eu
appleton	ae . p eu l . t eo n
dill	d i l
nerval	n e . l eu . b a l
tessa	t e . s a
pollock	p o l . l o g
briand	b eu . l i . a ng
donaldson	d o . n a l . d eu . s eu n
bok	b o g
tomas	t o . m a . s eu
thorndike	s o n . d a . i . k eu
morel	m o . l e l
frobenius	p eu . l o . b e . n i . u . s eu
fichte	p i . h i . t e
smellie	s eu . m e l . l i
edwin	e . d eu . wi n
holley	h o l . l i
lincoln	l i ng . k eo n
nelson	n e l . s eu n
szigeti	s i . g e . t i
abidjan	a . b i . j a ng
angelika	a ng . g e l . l i . k a
andersen	a n . d e . l eu . s e n
santos	s a n . t u . s eu
nowak	n o . wo . k eu
polk	p o . k eu
stoltenberg	s yu . t o l . t e n . b e . l eu . k eu
poole	p u l
napier	n e . i . p i . eo
ralston	l ae l . s eu . t eo n
wilm	b i l . l eu m
enoch	e . n o g
martino	m a . l eu . t i . n o
himmler	h i m . l eo
ron	l o n
danilo	d a . n i l . l o
carnap	k a . l eu . n a b
eugene	yu . j i n
charlottetown	s ya l . l eo s . t a . u n
cartagena	k a . l eu . t a . h e . n a
kafka	k a . p eu . k a
reiners	l a . i . n eo . j eu
thornton	s o n . t eu n
howells	h a . u . eo l . s eu
chris	k eu . l i . s eu
perenlei	p e . l e n . l e . i
farren	p ae . l eo n
ferry	p e . l i
camper	k a m . p e . l eu
thomsen	t o m . s e n
epirus	e . p i . l u . s eu
gheorghiu	g e . o . l eu . g yu
turing	t yu . l i ng
agnelli	a . n ye l . l i
belfast	b e l . p a . s eu . t eu
hyderabad	h a . i . d e . l a . b a . d eu
hay	h e . i
edelstein	e . d e l . s eu . t e . i n
fiorentino	p i . o . l e n . t i . n o
murray	m a . l e
toffler	t o . p eu l . l eo
holl	h o l
valentin	b a l . l e n . t i n
gough	g o . p u
alfieri	a l . p i . e . l i
huberman	h yu . b eo . m eo n
nepal	n e . p a l
flores	p eu l . l o . l e . s eu
dee	d i
marlene	m a . l eu l . l e . n e
sheppard	s ye . p eo . d eu
linda	l i n . d a
deneuve	d eu . n oe . b eu
saussure	s o . s wi . l eu
diallo	d i . ae l . l o
hollingworth	h o l . l i ng . wo . s eu
hitchcock	h i . ch i . k o g
dehmel	d e . m e l
redon	l eu . d o ng
terra	t e . l a
mcguire	m ae g . g wa . i . eo
fisher	p i . s yeo
laura	l a . u . l a
rex	l e g . s eu
tasha	t a . s ya
faiz	p e . i . j eu
laos	l a . o . s eu
pablo	p a . b eu l . l o
charlton	ch a l . t eo n
neher	n e . eo
gall	g a l
richards	l i . ch eo . j eu
muscat	m u . s eu . k a . t eu
schwan	s yu . b a n
arnaldo	a . l eu . n a l . d o
dolores	d o l . l o . l e . s eu
barth	b a . l eu . t eu
ted	t e . d eu
dubinin	d u . b i . n i n
pauling	p o l . l i ng
harrisburg	h ae . l i . s eu . b eo . g eu
oppert	o . p e . l eu . t eu
carr	k a
dustin	d eo . s eu . t i n
voroshilov	b o . l o . s i l . l o . p eu
casadesus	k a . j a . d eu . j wi
vivian	b i . b i . a n
mitterrand	m i . t e . l a ng
warsaw	b a . l eu . s ya . b a
kantor	k ae n . t eo
lippi	l i . p i
sunderland	s eo n . d eo . l ae n . d eu
christopher	k eu . l i . s eu . t o . p eo
pisarev	p i . s a . l e . p eu
beckmann	b e . k eu . m a n
fred	p eu . l e . d eu
zasulich	j a . s u l . l i . ch i
macon	m a . k o ng
bouton	b u . t o ng
bismarck	b i . j eu . m a . k eu
dominique	d o . m i . n i . k eu
macaulay	m ae . k o l . l i
flora	p eu l . l o . l a
carvalho	k a . l eu . b a l . l yo
judd	j eo . d eu
kitty	k i . t i
ueberweg	yu . b eo . b e g
eichmann	a . i . h i . m a n
grace	g eu . l a . s eu
oresme	o . l e m
pakistan	p a . k i . s eu . t a n
poter	p o . t eo
borges	b o . l eu . h e . s eu
engels	e ng . g e l . s eu
dior	d i . o . l eu
keller	k e l . l eo
flanders	p eu l . l ae n . d eo . s eu
behrman	b e . eo . m eo n
roberts	l o . b eo . ch eu
birkhoff	b eo . k o . p eu
kigali	k i . g a l . l i
fryer	p eu . l a . i . eo
masaccio	m a . s a . ch o
oskar	o . s eu . k a . l eu
belgium	b e l . g i . e
priestley	p eu . l i . s eu . t eu l . l i
reade	l i . d eu
pichon	p i . s yo ng
verdi	b e . l eu . d i
alfred	ae l . p eu . l e . d eu
prata	p eu . l a . t a
kidd	k i . d eu
cameroon	k a . m e . l u n
cardinal	k a . d i . n a l
thomas	t o . m eo . s eu
ramos	l a . m o . s eu
duvivier	d wi . b i . b i . e
busia	b u . s i . a
zunzunegui	s u n . s u . n e . g i
livius	l i . b i . u . s eu
athens	a . t e . n e
cairns	k e . i n . j eu
hubbard	h eo . b eo . d eu
rodney	l o . d eu . n i
constantin	k o n . s eu . t a n . t i n
quental	k we n . t a l
lamour	l a . m u . l eu
feinberg	p a . i n . b eo . g eu
nicolle	n i . k o l
coppola	k o . p eu l . l a
bernardino	b e . l eu . n a . l eu . d i . n o
jess	j e . s eu
ashcroft	ae . s yu . k eu . l o . p eu . t eu
weiss	b a . i . s eu
caruso	k a . l u . s o
nazareth	n a . s a . l e s
keeley	k e l . l i
pushkin	p u . s i . k i n
vigeland	b i . g e l . l a n
victorien	b i g . t o . l i . ae ng
esposito	e . s eu . p o . s i . t o
alaska	a l . l ae . s eu . k a
shchepkin	s i . ch e b . k i n
susanne	j u . j a . n e
darwin	d a . wi n
bongo	b o ng . g o
berkley	b eo . k eu l . l i
baron	b a . l o n
melanchthon	m e l . l a n . h i . t o n
ruska	l u . s eu . k a
kensington	k e n . j i ng . t eo n
don	d a n
sam	s ae m
gilson	j i l . s o ng
negev	n e . g e . b eu
pompidou	p o ng . p i . d u
svevo	s eu . b e . b o
cheney	ch e . n i
bedford	b e . d eu . p eo . d eu
doherty	d o . h eo . t i
alvares	a l . b a . l e . s eu
dunham	d eo n . h ae m
voight	b o . i . t eu
ruo	l wo
duvalier	d wi . b a l . l i . e
senegal	s e . n e . g a l
beauchamp	b o . s ya ng
gerard	j e . l a . l eu
ventura	b e n . ch yu . l a
janine	j e . n i n
arizona	ae . l i . j o . n a
julien	j wi l . l i . ae ng
rice	l a . i . s eu
wegener	b e . g e . n eo
sandi	s ae n . d i
haag	h e . i . g eu
hals	h a l . s eu
nicolai	n i . k o l . l a . i
karajan	k a . l a . ya n
hoche	o . s yu
pedro	p e . d eu . l o
basin	b a . s i n
larsen	l a . l eu . s e n
merlin	m eo l . l i n
wesleyan	we . s eu l . l i
alex	a l . l e g . s eu
hodgson	h o . j i . s eu n
freitas	p eu . l e . i . t a . s eu
eminescu	e . m i . n e . s eu . k u
adenauer	a . d e . n a . wo
bardem	b a . d e m
cousin	k u . j ae ng
mistral	m i . s eu . t eu . l a l
dunstable	d eo n . s eu . t eo . b eu l
rosenberg	l o . j e n . b e . l eu . k eu
clapeyron	k eu l . l a . p e . l o ng
drake	d eu . l e . i . k eu
guerrero	g e . l e . l o
pellegrini	p e l . l e . g eu . l i . n i
teagarden	t i . g a . d eu n
meister	m e . i . s eu . t eo
hodgkin	h o . j i . k i n
erbakan	e . l eu . b a . k a n
luke	l u g . k eu
andrzej	a n . j e . i
dyke	d a . i . k eu
house	h a . u . s eu
lenard	l e . n a . l eu . t eu
connolly	k o . n eo l . l i
dunlop	d eo n . l o b
carolyn	k ae . l eo l . l i n
ochab	o . h a . p eu
nanny	n ae . n i
kulik	k u l . l i . k eu
schroeder	s yu . l o . d eo
skoda	s eu . k o . d a
forsyth	p o . s a . i . s eu
morand	m o . l a ng
normandy	n o . l eu . m a ng . d i
wight	wa . i . t eu
branco	b eu . l a ng . k o
stephen	s eu . t i . b eu n
andalusia	a n . d a l . l u . s i . a
pascoli	p a . s eu . k o l . l i
julianus	yu l . l i . a . n u . s eu
zane	j e . i n
drago	d eu . l a . g o
holmes	h o m . s eu
jacksonville	j ae g . s eu n . b i l
rama	l a . m a
indus	i n . d eo . s eu
gay	g e . i
bach	b a . h eu
casals	k a . s a l . s eu
girard	j i . l a . d eu
dekker	d e . k eo
cramer	k eu . l ae . m eo
candela	k a ng . d e l . l a
johan	yo . h a n
pigou	p i . g u
gris	g eu . l i . s eu
torsten	t o l . s eu . t eo n
matute	m a . t u . t e
grafton	g eu . l a . p eu . t eu n
wren	l e n
alan	ae l . l eo n
whorf	wo . p eu
stoddard	s eu . t o . d a . d eu
elton	e l . t eu n
eiffel	e . p e l
randall	l ae n . d a l
dillon	d i l . l eo n
cayenne	k a . ye n
kaminski	k a . m i n . s eu . k i
martha	m a . s ya
artur	a . t eo
erickson	e . l i g . s eu n
huysmans	wi . s eu . m a ng . s eu
point	p o . i n . t eu
malipiero	m a l . l i . p i . e . l o
markham	m a . k a m
raabe	l a . b e
elsie	e l . s i
dolph	d o l . p eu
revere	l i . b i . eo
cass	k ae . s eu
ferre	p e . l e
moritz	m o . l i . ch eu
schilling	s i l . l i ng
abigail	ae . b i . g ae . i l
ines	i . n e . s eu
isadora	i . s a . d o . l a
glasgow	g eu l . l ae . s eu . g o
dowling	d a . u l . l i ng
lepsius	l e b . s i . u . s eu
marchais	m a . l eu . s ye
shadwell	s yae . d eu . we l
casper	k ae . s eu . p eo
lourdes	l u . l eu . d eu
kostov	k o . s eu . t o . p eu
jacek	ya . ch e . k eu
prout	p eu . l a . u . t eu
everson	e . b eo . s eu n
foucault	p u . k o
kemp	k e m . p eu
malabo	m a l . l a . b o
flemming	p eu l . l e . m i ng
petric	p e . t eu . l i g
cech	ch e . k eu
alison	ae l . l i . s eu n
sanders	s ae n . d eo . s eu
dyson	d a . i . s eu n
frakes	p eu . l e . i . k eu
missouri	m i . j u . l i
colgate	k o l . g e . i . t eu
yao	ya . o
mahmoud	m a . m u . d eu
connecticut	k o . n e . t i . k eo s
gustave	g u . s eu . t a . b eu
herriot	e . l i . o
bly	b eu l . l a . i
sterne	s eu . t eo n
leif	l e . i . p eu
lombardi	l o m . b a . l eu . d i
tarkington	t a . k i ng . t eo n
lindgren	l i n . d eu . g eu . l e n
luiz	l u . i . j eu
ceylon	s i l . l o n
petropavlovsk	p e . t eu . l o . p a . b eu . l o . s eu . k eu
bruckner	b eu . l u . k eu . n eo
perret	p e . l e
albani	a l . b a . n i
keynes	k e . i n . s eu
irons	a . i . eo n . s eu
wycherley	wi . ch eo l . l i
makarov	m a . k a . l o . p eu
giambattista	j a m . b a . t i . s eu . t a
beaumont	b a . m o n . t eu
lisbon	l i . s eu . b o n
tang	d a ng
hersey	h eo . s i
coker	k o . k eo
salomon	s a l . l o . m o n
bellow	b e l . l o
petrie	p i . t eu . l i
lina	l i . n a
durkheim	d wi . l eu . k e m
groth	g eu . l o . t eu
adani	a . d a . n i
hein	h e . i n
bonnie	b o . n i
antoinette	a ng . t u . a . n e . t eu
brentano	b eu . l e n . t a . n o
ambrose	ae m . b eu . l o . j eu
basel	b a . j e l
schinkel	s i ng . k e l
eisenstadt	a . i . j e n . s yu . t a . t eu
waldheim	b a l . t eu . h a . i m
behaim	b e . h a . i m
burundi	b u . l u n . d i
geneva	j e . n e . b a
scholes	s yo l . s eu
parry	p e . l i
ferdinand	p e . l eu . d i . n a n . d eu
athanasius	a . t a . n a . s i . u . s eu
van	b a n
bash	b ae . s wi
cecchetti	ch e . k e . t i
armen	a . l eu . m e n
mauritania	m o . l i . t a . n i . a
lenoir	l eu . n u . a . l eu
collett	k o l . l e . t eu
olivia	o l . l i . b i . a
corneille	k o . l eu . n e . yu
hoff	h o . p eu
niger	n i . j e . l eu
hotchkiss	h o . ch i . k i . s eu
berne	b e . l eu n
ronald	l o . n eo l . d eu
hettner	h e . t eu . n eo
disney	d i . j eu . n i
harry	h ae . l i
bogomolov	b o . g o . m o . l o . p eu
ghosh	g o . s i
delgado	d e l . g a . d o
oslo	o . s eu l . l o
sommer	j o . m eo
arden	a . d eu n
paulus	p a . u l . l u . s eu
draper	d eu . l e . i . p eo
gene	j i n
walsh	wa l . s i
jantzen	j a n . ch e n
strasburger	s yu . t eu . l a . s eu . b u . l eu . g eo
abebe	a . b e . b e
hasse	h a . s e
lamprecht	l a m . p eu . l e . h i . t eu
keats	k i . ch eu
leonid	l e . o . n i . t eu
stefani	s eu . t e . p a . n i
weil	b a . i l
kerekou	k e . l e . k u
gotthelf	g o . t eu . h e l . p eu
elmo	e l . m o
pascal	p a . s eu . k a l
iacocca	a . i . eo . k o . k a
posner	p o . j eu . n eo
schwinger	s yu . wi ng . g eo
gairdner	g e . eo . d eu . n eo
isler	a . i . s eu l . l eo
carpentier	k a . l eu . p e n . t i . e . l eu
trygve	t eu . l wi . g eu . b e
chao	ch a . o
shute	s yu . t eu
gaj	g a . i
menger	m e ng . g eo
grossi	g eu . l o . s i
pacher	p a . h eo
salerno	s a l . l e . l eu . n o
cornwall	k o n . wo l
hank	h ae ng . k eu
viktor	b i g . t o . l eu
gamba	g a m . b a
quaid	k we . i . d eu
jost	yo . s eu . t eu
joni	j o . n i
kalinin	k a l . l i . n i n
staudinger	s yu . t a . u . d i ng . g eo
nebojsa	n e . b o . i . s a
powell	p a . wo l
cincinnatus	k i n . k i . n a . t u . s eu
vesaas	b e . s o . s eu
whale	we . i l
sabastian	s e . b a . s eu . ch a n
igor	i . g o . l eu
vento	b e n . t o
burnley	b eo n . l i
mahler	m a l . l eo
spiegel	s eu . p i . g e l
glenda	g eu l . l e n . d a
lubbers	l wi . b e . l eu . s eu
montaigne	m o ng . t e . n yu
klagenfurt	k eu l . l a . g e n . p u . l eu . t eu
oparin	o . p a . l i n
petra	p e . t eu . l a
boole	b u l
paul	b a . u l
faulkner	p o . k eu . n eo
bazin	b a . j ae ng
london	l eo n . d eo n
udo	u . d o
malpighi	m a l . p i . g i
hamlin	h ae m . l i n
biagio	b i . a . j i . o
gershwin	g eo . s yu . wi n
little	l i . t eu l
gelsenkirchen	g e l . j e n . k i . l eu . h e n
lisa	l i . s a
dubcek	d u . b eu . ch e . k eu
donen	d o . n eo n
jarvis	j a . b i . s eu
wynn	wi n
butts	b eo . ch eu
warren	wo . l eo n
bromfield	b eu . l o m . p i l . d eu
meany	m i . n i
sunday	s eo n . d e . i
petrarca	p e . t eu . l a . l eu . k a
coolidge	k u l . l i . j i
marion	m ae . l i . eo n
zahn	j ae n
gogol	g o . g o l . l i
margaret	m a . g eo . l i . t eu
tupolev	t u . p o l . l e . p eu
leverrier	l eu . b e . l i . e
hohenstaufen	h o . e n . s yu . t a . u . p e n
tristram	t eu . l i . s eu . t eu . l eo m
mehdi	m e . d i
romano	l o . m a . n o
geijer	ye . i . ye . l eu
davenport	d ae . b eu n . p o . t eu
calfa	ch a l . p a
jaruzelski	ya . l u . j e l . s eu . k i
gerardus	h e . l a . l eu . d wi . s eu
byrnes	b eo n . s eu
halter	h a l . t eo
bloomfield	b eu l . l u m . p i l . d eu
anja	a n . ya
andreotti	a n . d eu . l e . o . t i
northrop	n o . s eu . l eo b
mats	m ae . ch eu
stockholm	s eu . t o g . h o l . l eu m
wood	u . d eu
paganini	p a . g a . n i . n i
aylwin	a . i l . wi n
speakes	s eu . p i . k eu . s eu
born	b o . l eu n
freudenthal	p eu . l o . i . d e n . t a l
vaillant	b a . ya ng
chavez	ch a . b e . s eu
laussedat	l o . s e . d a
morrow	m o . l o
rosas	l o . s a . s eu
hanoi	h a . n o . i
thailand	t a . i
bloomberg	b eu l . l u m . b eo . g eu
say	s e
murillo	m u . l i . yo
nord	n o . d eu
glauber	g eu l . l a . u . b eo
pope	p o . p eu
hacks	h a g . s eu
demeter	d e . m e . t e . l eu
volcker	b o l . k eo
apelt	a . p e l . t eu
tallis	t ae l . l i . s eu
balenciaga	b a l . l e n . s i . a . g a
ken	k e n
stirling	s eu . t eo . l i ng
galli	g a l . l i
schultze	s yu l . ch e
phoebe	p o . i . b e
semenov	s e . m yo . n o . p eu
festus	p e . s eu . t eo . s eu
asam	a . j a m
prince	p eu . l i n . s eu
clausius	k eu l . l a . u . j i . u . s eu
dessau	d e . s a . u
mogens	m o . g e n . s eu
salas	s a l . l a . s eu
zhukov	j u . k o . p eu
geibel	g a . i . b e l
menon	m e . n o n
asimov	a . s i . m o . p eu
mindy	m i n . d i
irina	i . l i . n a
stifter	s yu . t i . p eu . t eo
verga	b e . l eu . g a
neill	n i l
mori	m o . l i
herb	h eo . b eu
gary	g e . l i
moussa	m u . s a
dupleix	d wi . p eu l . l e g . s eu
finsen	p i n . s e n
ney	n e
bruant	b eu . l wi . a ng
dulbecco	d u l . b e . k o
krzysztof	k eu . s i . s yu . t o . p eu
quigley	k wi . g eu l . l i
rupert	l u . p eo . t eu
preston	p eu . l e . s eu . t eo n
runeberg	l u . n e . b e . l i
doumergue	d u . m e . l eu . g eu
mucha	m u . h a
baumann	b a . u . m a n
bernauer	b e . l eu . n a . wo
maxim	m ae g . s i m
severo	s e . b e . l o
jerrold	j e . l eo l . d eu
wodehouse	u . d eu . h a . u . s eu
barron	b ae . l o n
pevsner	p e . p eu . s eu . n eo
sandburg	s ae n . d eu . b eo . g eu
bassett	b a . s e s
vientiane	b i . e n . t i . a n
benedict	b e . n e . d i g . t eu
michelle	m i . s ye l
roman	l o . m a n
hindenburg	h i n . d e n . b u . l eu . k eu
dakar	d a . k a . l eu
mackinder	m ae . k i n . d eo
hammond	h ae . m o n . d eu
rasputin	l a . s eu . p u . t i n
campbell	k ae m . b e l
bunin	b u . n i n
wali	wa . l i
ricou	l i . k o . u
breyer	b eu . l e . i . eo
alexander	a l . l e g . s a n . d eu . l eu
acapulco	a . k a . p u l . k o
gallo	g a l . l o
benda	b a ng . d a
kyrgyzstan	k i . l eu . g i n . s eu . s eu . t a n
vernon	b eo . n o n
groza	g eu . l o . j a
hagerstown	h e . g eo . s eu . t a . u n
chautemps	s yo . t a ng
bonneville	b o . n e . b i l
gorchakov	g o . l eu . ch a . k o . p eu
bacchus	b a . k eo . s eu
otto	o . t o
pagnol	p a . n yo l
maeterlinck	m e . i . t eo . l i ng . k eu
adrian	e . i . d eu . l i . eo n
fulton	p u l . t eo n
krim	k eu . l i m
guinea_bissau	g i . n i . b i . s a . u
kanpur	k a n . p u . l eu
ehrenfeld	e . l eo n . p e l . d eu
maccoby	m ae . k o . b i
tricia	t eu . l i . s i . a
dampier	d ae m . p i . eo
alain	a l . l ae ng
kirkland	k eo . k eu l . l eo n . d eu
dorothy	d o . l o . s i
langer	l a ng . g eo
suslov	s u . s eu l . l o . p eu
leroy	l i . l o . i
goldschmidt	g o l . t eu . s yu . m i . t eu
galle	g a l
christophe	k eu . l i . s eu . t o . p eu
noah	n o . a
sweden	s eu . we . d e n
ramsay	l ae m . j i
romero	l o . m e . l o
babcock	b ae b . k o g
engelbert	e ng . g e l . b eo . t eu
pitman	p i . t eu . m eo n
claudia	k eu l . l a . u . d i . a
guericke	g e . l i . k e
tashkent	t a . s yu . k e n . t eu
hendrik	h e n . d eu . l i . k eu
kessel	k e . s e l
josephus	yo . s e . p u . s eu
abba	a . b a
bovet	b o . b e
maclean	m ae g . k eu l . l ae n
thurnwald	t u . l eu n . b a l . t eu
kiss	k i . s i
artigas	a . l eu . t i . g a . s eu
fillmore	p i l . m o . eo
jukes	j yu . k eu . s eu
benitez	b e . n i . t e . j eu
palikir	p a l . l a . k i . l eu
evelyn	i . b e l . l i n
reppe	l e . p e
marit	m a . l i . t eu
sharaf	s ye . l a . p eu
withers	wi . d eo . s eu
memphis	m e m . p i . s eu
schwartz	s yu . wo . ch eu
lorenzen	l o . l e n . j e n
merritt	m e . l i . t eu
coiter	k o . i . t eo
lyonnet	l i . o . n e
shu	s u
irena	i . l e . n a
berenger	b e . l i n . j eo
giordano	j o . l eu . d a . n o
griffis	g eu . l i . p i . s eu
soupault	s u . p o
judah	yu . d a
warner	wo . n eo
rashid	l a . s i . d eu
hedge	h e . j i
jonas	yo . n a . s eu
robson	l o b . s eu n
saleh	s a l . l e
primakov	p eu . l i . m a . k o . p eu
flaxman	p eu l . l ae g . s eu . m eo n
pete	p i . t eu
salt	s o l . t eu
hartford	h a . t eu . p eo . d eu
gascoyne	g ae . s eu . k o . i n
panama	p a . n a . m a
banks	b ae ng . k eu . s eu
martenot	m a . l eu . t eu . n o
feldstein	p e l . d eu . s eu . t a . i n
kitchener	k i . ch i . n eo
hobson	h o b . s eu n
constant	k o ng . s eu . t a ng
josef	yo . s e . p eu
dunn	d eo n
symonds	s i . m eo n . j eu
russel	l eo . s e l
unsworth	eo n . s eu . wo . s eu
padua	p a . d u . a
jouvet	j u . b e
granit	g eu . l a . n i . t eu
fromm	p eu . l o m
hess	h e . s eu
seward	s yu . eo . d eu
ryle	l a . i l
franco	p eu . l a ng . k o
champollion	s ya ng . p o l . l i . o ng
elise	e l . l i . s eu
hansson	h a n . s o n
bromley	b eu . l o m . l i
isola	i . s o l . l a
elmer	e l . m eo
ankara	a ng . k a . l a
babson	b ae b . s eu n
krasnoyarsk	k eu . l a . s eu . n o . ya . l eu . s eu . k eu
bean	b i n
maputo	m a . p u . t o
giaever	g i . e . b eo
anouilh	a . n u . i
hancock	h ae n . k o g
wilkinson	wi l . k i n . s eu n
iowa	a . i . o . wa
myburgh	m a . i . b eo . g eu
sebastian	s eo . b ae . s eu . ch eo n
gobi	g o . b i
rehnquist	l e n . k wi . s eu . t eu
hazlitt	h ae . j eu l . l i s
nash	n ae . s i
darcy	d a . s i
gardner	g a . d eu . n eo
smetana	s eu . m e . t a . n a
evan	e . b eo n
zamora	s a . m o . l a
kimberley	k i m . b eo l . l i
hicks	h i g . s eu
danforth	d ae n . p o . s eu
koch	k o . h eu
quinton	k wi n . t eo n
beauvoir	b o . b u . a . l eu
skopje	s eu . k o . p e
tyutchev	t yu . ch e . p eu
gallio	g a l . l i . o
mila	m i l . l a
groethuysen	g eu . l e . t wi . j ae ng
lasso	l a . s o
jue	j we
bernhard	b eo n . h a . d eu
kroeber	k eu . l o . b eo
immermann	i . m eo . m a n
vargas	b a . l eu . g a . s eu
kramer	k eu . l e . i . m eo
kalman	k a l . m a n
bona	b o . n a
kant	k a n . t eu
noether	n oe . t eo
roussel	l u . s e l
laredo	l a . l e . d o
seyni	s e . i . n i
thom	t o m
henriot	a ng . l i . o
nicolaus	n i . k o l . l a . u . s eu
borodin	b o . l o . d i n
roseau	l o . j o
lasker	l ae . s eu . k eo
miller	m i l . l eo
abegg	a . b e . g eu
dian	d i . a n
stimson	s eu . t i m . s eu n
arago	a . l a . g o
elsheimer	e l . s eu . h a . i . m eo
mohamad	m o . h a . m a . d eu
piotrowski	p i . o . t eu . l o . p eu . s eu . k i
mellon	m e l . l eo n
veblen	b e . b eu l . l eo n
gere	g i . eo
emanuel	e . m a . n u . e l
libby	l i . b i
maior	m a . i . o . l eu
villa	b i l . l a
ogilvy	o . g eu l . b i
heyerdahl	h e . wi . e . l eu . d a l
ellesmere	e l . j eu . m i . eo
sander	s ae n . d eo
helge	h e l . g e
georgina	j o . l eu . j i . n a
krasheninnikov	k eu . l a . s ye . n i n . n i . k o . p eu
michie	m i . ch i . e
wentworth	we n . t eu . wo . s eu
aldo	a l . d o
landers	l ae n . d eo . s eu
freyssinet	p eu . l e . i . s i . n e s
armando	a . l eu . m a n . d o
aasen	o . s e n
agnes	a . g eu . n e . s eu
gerstner	g eo . s eu . n eo
schaudinn	s ya . u . d i n
frank	p eu . l a ng . k eu
frankel	p eu . l a n . k e l
bunsen	b u n . j e n
bourne	b o n
nina	n i . n a
youngstown	yeo ng . s eu . t a . u n
trevor	t eu . l e . b eo
constantinescu	k o n . s eu . t a n . t i . n e . s eu . k u
nicholson	n i . k eo l . s eu n
camilo	k a . m i l . l o
hamza	h a m . j a
bradbury	b eu . l ae . d eu . b eo . l i
gunther	g eo n . s eo
monod	m o . n o
felder	p e l . d eo
lasswell	l a . s eu . we l
blakeslee	b eu l . l e . i . k eu . s eu l . l i
melville	m e l . b i l
ellen	e l . l e n
lombard	l o m . b a . l eu . d eu
sforza	s eu . p o . l eu . j a
maciel	m a . s i . e l
jaques	j a . k eu
beliaev	b e l . l i . a . e . p eu
mathewson	m ae . t yu . s eu n
kochanowski	k o . h a . n o . p eu . s eu . k i
pople	p o . p eu l
carney	k a . n i
weaver	wi . b eo
delon	d eu . l o ng
salman	s a l . m a n
mussolini	m u s . s o l . l i . n i
poiseuille	p o . a . j eu . i . yu
steinberger	s eu . t a . i n . b eo . g eo
tristan	t eu . l i . s eu . t a ng
honegger	o . n e . g e . l eu
foster	p o . s eu . t eo
bethel	b e . d e l
perth	p eo . s eu
pamela	p a . m e l . l a
peacock	p i . k o g
gunnar	g u n . n a . l eu
denikin	d e . n i . k i n
pissarro	p i . s a . l o
uruguay	u . l u . g wa . i
tweed	d e . d o
pirelli	p i . l e l . l i
greuze	g eu . l oe . j eu
worcester	u . s eu . t eo
negri	n e . g eu . l i
tobias	t o . b i . a . s eu
vecellio	b e . ch e l . l i . o
cassel	k a . s e l
ionesco	i . o . n e . s eu . k o
sherlock	s yeo l . l o g
buffalo	b eo . p eo l . l o
adama	a . d a . m a
imam	i . m a m
karl	k a . l eu l
granville	g eu . l ae n . b i l
vinogradoff	b i . n o . g eu . l a . d o . p eu
ismail	i . s eu . m a . i l
micronesia	m i . k eu . l o . n e . s i . a
sadik	s a . d i . k eu
keaton	k i . t eu n
burt	b eo . t eu
capa	k a . p a
housman	h a . u . s eu . m eo n
ge	g e
azevedo	a . j e . b e . d o
gartner	g a . t eu . n eo
waigel	b a . i . g e l
hadley	h a . d eu l . l i
baku	b a . k u
karen	k a . l e n
vidal	b i . d a l
nansen	n a n . s e n
ewing	yu . i ng
valdivia	b a l . d i . b i . a
khorana	k o . l a . n a
fleischer	p eu l . l a . i . s yeo
engler	e ng . g eu l . l eo
robespierre	l o . b e . s eu . p i . e . l eu
ethan	i . s eo n
wolf	b o l . p eu
trier	t eu . l i . eo
cologne	k oe l . l eu n
glenn	g eu l . l e n
vincent	b i n . s e n . t eu
piazzi	p i . a . ch i
hofer	h o . p eo
yul	yu l
perkins	p eo . k i n . s eu
ridel	l i . d e l
simons	s a . i . m eo n . j eu
kelsen	k e l . j e n
north	n o . s eu
cruyff	k eu . l u . i . p eu
heike	h a . i . k e
laski	l ae . s eu . k i
brangwyn	b eu . l ae ng . g wi n
schutz	s yu . ch eu
hartmut	h a . l eu . t eu . m u . t eu
crane	k eu . l e . i n
sutter	s u . t eo
bakan	b a . k a n
march	m a . ch i
kuhn	k u n
meyerbeer	m a . i . eo . b e . eo
joanna	j o . a n . n a
gjellerup	g i . e l . l e . l u . p eu
mencken	m e ng . k e n
kreutzer	k eu . l o . i . ch eo
dowiyogo	d o . wi . yo . g o
augusta	o . g eo . s eu . t a
susanna	s u . s a n . n a
vincent	b ae ng . s a ng
emerson	e . m eo . s eu n
norton	n o . t eo n
smollett	s eu . m o l . l e s
lynne	l i n
taglioni	t a l . l i . o . n i
brasseur	b eu . l a . s oe . l eu
gompers	g o m . p eo . s eu
halls	h o l . s eu
chichester	ch i . ch e . s eu . t eo
dylan	d i l . l eo n
dollar	d a l . l eo
moltke	m o l . t eu . k e
paavo	p a . b o
foote	p u . t eu
nunn	n eo n
santorio	s a n . t o . l i . o
bosch	b o . s yu
bouts	b o . ch eu
benin	b e . n ae ng
bianco	b i . a n . k o
appenzeller	a . p e n . j e l . l eo
novikov	n o . b i . k o . p eu
palme	p a l . m e
cesare	ch e . s a . l e
hildebrand	h i l . d e . b eu . l a n . d eu
jourdan	j o . d a n
samson	s a m . s o n
ast	a . s eu . t eu
ganges	g ae n . j i . s eu
chamisso	s ya . m i . s o
jordaens	yo . l eu . d a n . s eu
sands	s ae n . j eu
vaduz	p a . d u . ch eu
alberti	a l . b e . l eu . t i
burlington	b eo . l i ng . t o n
ram	l ae m
saar	j a . l eu
blache	b eu l . l a . s yu
gilbreth	g i l . b eu . l e . s eu
dirk	d eo . k eu
borg	b o . g eu
sodoma	s o . d o . m a
marietta	m a . l i . e . t a
gyula	j u l . l eo
bingham	b i ng . h ae m
frankenstein	p eu . l a ng . k e n . s yu . t a . i n
hitchings	h i . ch i ng . s eu
shaginyan	s ya . g i . n ya n
danzig	d a n . ch i . h i
maya	m a . ya
thimphu	t i m . b u
berchem	b eo . ch e m
schiele	s i l . l e
amyot	a . m i . yo
frost	p eu . l o . s eu . t eu
poisson	p u . a . s o ng
cantor	k a n . t o . eo
cavour	k a . b o . u . l eu
maddox	m ae . d o g . s eu
lachmann	l a . h eu . m a n
edelman	e . d eo l . m eo n
genevieve	j e . n e . b i . b eu
leipzig	l a . i . p eu . ch i . h i
neilson	n i l . s eu n
bertie	b eo . t i
chamson	s ya ng . s o ng
cassin	k a . s ae ng
constantine	k o ng . s eu . t a ng . t i n
enrique	e n . l i . k e
doris	d o . l i . s eu
amelie	a . m e l . l i . e
mugabe	m u . g a . b e
henderson	h e n . d eo . s eu n
hoover	h u . b eo
lombard	l o m . b a . d eu
lorentz	l o . l e n . ch eu
joe	j o
norfolk	n o . p eo g
kautsky	k a . u . ch eu . k i
quayle	k we . i l
nath	n a . s eu
gaspard	g a . s eu . p a . l eu
elman	e l . m eo n
cukor	k u . k eo
guillemin	g i . yu . m ae ng
welch	we l . ch i
faith	p e . i . s eu
lavoisier	l a . b u . a . j i . e
robles	l o . b eu l . l e . s eu
iskandar	i . s eu . k a n . d a l
curtiz	k eo . t i . s eu
cunningham	k eo . n i ng . eo m
dunsany	d eo n . s e . i . n i
peggy	p e . g i
holberg	h o l . b e . l eu
fanny	p a . n i
witz	b i . ch eu
horowitz	h o . l o . b i . ch eu
laurence	l o . l e n . s eu
berger	b eo . g eo
pater	p e . i . t eo
francis	p eu . l a ng . s i . s eu
reuchlin	l o . i . h i l . l i n
seifert	s a . i . p e . l eu . t eu
portland	p o . t eu l . l ae n . d eu
smithson	s eu . m i . s eu . s eu n
lombroso	l o m . b eu . l o . s o
clyde	k eu l . l a . i . d eu
dorchester	d o . ch e . s eu . t eo
ryan	l a . i . eo n
remy	l e . m i
sennett	s e . n e s
jara	h a . l a
baade	b a . d e
bray	b eu . l e . i
penny	p e . n i
avraham	a . b eu . l a . h a m
congo	k o ng . g o
edna	e . d eu . n a
morisot	m o . l i . j o
roche	l o . ch e
rautio	l o . t i . o
bernardo	b e . l eu . n a . l eu . d o
walter	wo l . t eo
kaspar	k a . s eu . p a . eo
jouhaux	j u . o
maseru	m a . s e . l u
vernet	b e . l eu . n e
angara	a n . g a . l a
gottlieb	g o . t eu l . l i . b eu
waksman	wa g . s eu . m eo n
broadbent	b eu . l o . d eu . b e n . t eu
wernicke	b e . l eu . n i . k e
paulsen	p o l . s eu n
poe	p o
bjerknes	b i . e . l eu . k eu . n e . s eu
comte	k o ng . t eu
kate	k e . i . t eu
beila	b e . i . l a
herzl	h e . l eu . ch eu l
hecht	h e g . t eu
ronge	l o ng . i
oman	o . m a n
hannover	h a . n o . b eo
bilal	b i l . l a l
cossa	k o . s a
leoncavallo	l e . o n . k a . b a l . l o
erik	e . l i . k eu
isabelle	i . j a . b e l
richie	l i . ch i
terrace	t e . l a . s eu
adler	a . d eu l . l eo
marsden	m a . s eu . d eu n
joxe	j o g . s eu
xavier	j a . b i . e . l eu
osborne	o . j eu . b eo n
madagascar	m a . d a . g a . s eu . k a . l eu
kollwitz	k o l . b i . ch eu
cudworth	k eo . d eu . wo . s eu
arcos	a . l eu . k o . s eu
seychelles	s e . i . s ye l
arminius	a . l eu . m i . n i . u . s eu
pimentel	p i . m e n . t e l
billie	b i l . l i
romer	l o . m eo
amsterdam	a m . s eu . t e . l eu . d a m
beckenbauer	b e . k e n . b a . u . eo
lyndon	l i n . d eu n
barros	b ae . l o . s eu
wrangel	b eu . l a ng . g e l
fick	p i . k eu
ryszard	l i . s eu . j a . d eu
allentown	a l . l e n . t a . u n
urbano	eo l . b a . n o
evers	e . b eo . s eu
turgenev	t u . l eu . g e . n e . p eu
thebes	t e . b e
sert	s eo . t eu
richer	l i . ch eo
fokker	p o . k eo
lucy	l u . s i
christina	k eu . l i . s eu . t i . n a
pride	p eu . l a . i . d eu
sparks	s eu . p a g . s eu
cennini	ch e n . n i . n i
symington	s a . i . m i ng . t eo n
decker	d e . k eo
ferrari	p e . l a . l i
jeanne	j a n
margarete	m a . l eu . g a . l e . t e
filippo	p i l . l i . p o
cellini	ch e l . l i . n i
aiken	e . i . k i n
husak	h u . s a g
baldus	b a l . d u . s eu
mecca	m e . k a
pennsylvania	p e n . s i l . b e . i . n i . a
lem	l e m
sumatra	s u . m a . t eu . l a
konstantinos	k o n . s eu . t a n . t i . n o . s eu
dryden	d eu . l a . i . d eu n
goethals	g o . s eo l . s eu
garfield	g a . p i l . d eu
bamber	b ae m . b eo
carlsson	k a l . s o n
czerny	ch e . l eu . n i
badger	b ae . j eo
dart	d a . t eu
haider	h a . i . d eo
malebranche	m a l . b eu . l a ng . s yu
ernesto	e . l eu . n e . s eu . t o
senna	s e . n a
renato	l e . n a . t o
ling	l i ng
easton	i . s eu . t eo n
brahm	b eu . l a m
eisenstein	a . i . j e n . s yu . t a . i n
alexandre	a l . l e g . s a ng . d eu . l eu
halstead	h a l . s eu . t ae . d eu
roland	l o l . l a n . d eu
galvani	g a l . b a . n i
sen	s e n
malawi	m a l . l a . wi
peter	b e . d eu . l o
lujo	l u . j o
helene	h e l . l e . n e
mendelsohn	m e n . d e l . j o n
pasternack	p a . s eu . t eo . n e g
norrish	n o . l i . s i
ava	e . b a
frantisek	p eu . l a n . t i . s e g
marjorie	m a . j eo . l i
pankhurst	p ae ng . k eu . h eo . s eu . t eu
shea	s ye . i
kabul	k a . b u l
hal	h ae l
bangkok	b a ng . k o g
fontane	p o n . t a . n e
johnstown	j o n . s eu . t a . u n
jouve	j u . b eu
gilberto	j i l . b e . l eu . t o
colleen	k o l . l i n
piccoli	p i . k o l . l i
medford	m ae . d eu . p o . d eu
rau	l a . u
kashmir	k a . s yu . m i . l eu
chippendale	ch i . p e n . d e . i l
kilby	k i l . b i
angora	a ng . g o . l a
henne	h e . n i
lauren	l o . l e n
erica	e . l i . k a
ella	e l . l a
nick	n i g
sullivan	s eo l . l i . b eo n
quadri	k wa . d eu . l i
aslan	a . s eu l . l a n
elgar	e l . g a
candolle	k a ng . d o l
dirac	d i . l ae g
quentin	k wo n . t i n
dragan	d eu . l a . g a n
omaha	o . m a . h a
boileau	b u . a l . l o
jakob	ya . k o . p eu
albuquerque	ae l . b eo . k eo . k i
nagel	n a . g e l
pardo	p a . l eu . d o
kundt	k u n . t eu
haley	h a l . l i
hawaii	h a . wa . i
knut	k eu . n u . t eu
chomsky	ch o m . s eu . k i
cullen	k eo l . l e n
grew	g eu . l u
port	p o . t eu
veneziano	b e . n e . ch i . a . n o
paz	p a . s eu
houssay	u . s a . i
urbain	wi . l eu . b ae ng
bert	b e . l eu . t eu
lowell	l o . we l
whymper	h wi m . p eo
singer	s i ng . eo
copernicus	k o . p e . l eu . n i . k u . s eu
morley	m o l . l i
potapenko	p o . t a . p e n . k o
saul	s a . u l
hefner	h e . p eu . n eo
pudovkin	p u . d o . p eu . k i n
adam	a . d a m
verhaeren	b e . l eu . h a . l e n
twining	t eu . wa . i . n i ng
kuibyshev	k u . i . b i . s ye . p eu
tehran	d e . h e . l a n
fletcher	p eu l . l ae . ch eo
ingenhousz	i ng . g e n . h o . u . s eu
lacan	l a . k a ng
sarah	s a . l a
edvard	e . d eu . b a . l eu
dia	d i . a
flamsteed	p eu l . l ae m . s eu . t i . d eu
lome	l o . m e
stilwell	s eu . t i l . we l
nigel	n a . i . j eo l
meredith	m e . l e . d i . s eu
heintze	h a . i . t eu . ch e
polly	p o l . l i
pere	p e . l eu
schally	s ya l . l i
ogden	o . g eu . d eo n
campanella	k a m . p a . n e l . l a
jonny	j o . n i
lardner	l a . d eu . n eo
ratzinger	l a . ch i ng . g eo
kean	k i n
jeremiah	ye . l e . m i . ya
din	d i n
horner	h o . n eo
bruni	b eu . l u . n i
abell	a . b e l
martina	m a . l eu . t i . n a
hyde	h a . i . d eu
lillian	l i l . l i . eo n
albertville	a l . b e . l eu . b i l
lippmann	l i . p eu . m a n
rouault	l u . o
abe	a . b e
donna	d o . n a
bergen	b e . l eu . g e n
cressent	k eu . l e . s a ng
georg	g e . o . l eu . g eu
norma	n o . m a
eddy	e . d i
bowen	b o . e n
kansas	k ae n . j a . s eu
serao	s e . l a . o
ames	e . i m . s eu
bonsels	b o n . j e l . s eu
namur	n a . m u . l eu
dominguez	d o . m i ng . g e . j eu
ohio	o . h a . i . o
plekhanov	p eu l . l e . h a . n o . p eu
patricia	p ae . t eu . l i . s ya
ricci	l i . ch i
harte	h a . t eu
limburg	l i m . b u . l eu . h eu
ari	ae . l i
bara	b a . l a
amazon	a . m a . j o n
suk	s u . k eu
stockwell	s eu . t o g . we l
mandeville	m ae n . d eo . b i l
barrios	b a . l i . o . s eu
schawlow	s yo l . l o
lucie	l u . s i
poulet	p u l . l e
pearson	p i . eo . s eu n
smiles	s eu . m a . i l . s eu
sal	s a l
golding	g o l . d i ng
cindy	s i n . d i
bohemia	b o . h e . m i . a
burma	b eo . m a
disraeli	d i . j eu . l e . i l . l i
bayard	b a . ya . l eu
coen	k o . e n
muris	m yu . l i . s eu
allard	a l . l a . d eu
dorian	d o . l i . a n
eden	e . d e n
eichendorff	a . i . h e n . d o . l eu . p eu
bostic	b o . s eu . t i g
terborch	t e . l eu . b o . l eu . h i
rawlings	l o l . l i ng . s eu
forst	p o . l eu . s eu . t eu
indianapolis	i n . d i . ae . n a . p o l . l i . s eu
arvid	a . l eu . b i . d eu
swammerdam	s eu . wa m . m e . l eu . d a m
kummer	k u . m eo
venturi	b e n . t u . l i
gooch	g u . ch i
henriquez	e n . l i . k e . s eu
kraepelin	k eu . l e . p e l . l i n
verissimo	b e . l i . s i . m o
sylvain	s i l . b ae ng
szymanowski	s i . m a . n o . p eu . s eu . k i
hebra	h e . b eu . l a
finney	p i . n i
berzelius	b e . l eu . s e l . l i . u . s eu
phillpotts	p i l . p o . ch eu
patel	p a . t e l
michnik	m i . h eu . n i . k eu
laurel	l a . u . l e l
gomes	g o . m e . s eu
omsk	o m . s eu . k eu
livingston	l i . b i ng . s eu . t eo n
baekeland	b e . i . k eu l . l ae n . d eu
slovenia	s eu l . l o . b e . n i . a
tanner	t ae . n eo
sammartini	s a m . m a . l eu . t i . n i
wingrove	wi n . g eu . l o . b eu
bontempelli	b o n . t e m . p e l . l i
westermarck	we . s eu . t eo . m a . k eu
estremadura	e . s eu . t eu . l e . m a . d u . l a
kohlrausch	k o l . l a . u . s yu
pavese	p a . b e . s e
kossel	k o . s e l
more	m o . eo
menelaos	m e . n e l . l a . o . s eu
bloemfontein	b eu l . l u m . p o n . t e . i n
jules	j u l . s eu
powys	p o . u . i . s eu
turner	t eo . n eo
rockefeller	l o g . p e l . l eo
maastricht	m a . s eu . t eu . l i . h i . t eu
newman	n yu . m eo n
foch	p o . s yu
cube	k yu . b i g
mendel	m e n . d e l
hathaway	h ae . s eo . we . i
shropshire	s yu . l o b . s yeo
weller	we l . l eo
schwann	s yu . b a n
mora	m o . l a
laurent	l o . l a ng
edith	e . d i . s eu
dundee	d eo n . d i
dowden	d a . u . d eu n
moscow	m o . s eu . k eu . b a
nasmyth	n e . i . j eu . m i . s eu
melton	m e l . t o n
bela	b e l . l a
pate	p e . i . t eu
caroline	k ae . l o l . l a . i n
stieglitz	s eu . t i . g eu l . l i . ch eu
biber	b i . b eo
ebert	e . b e . l eu . t eu
binet	b i . n e
zeiss	ch a . i . s eu
burney	b eo . n i
galileo	g a l . l i l . l e . o
bethe	b e . t e
dausset	d o . s e
hubert	wi . b e . l eu
nolte	n o l . t e
alek	a l . l e g
kuznets	k u . j eu . n e . ch eu
claus	k eu l . l a . u . s eu
vienna	b i . e n . n a
oldenburg	o l . d e n . b u . l eu . k eu
guardi	g wa . l eu . d i
pekka	p e . k a
hines	h a . i n . j eu
magdalena	m a g . d a l . l e . n a
clausewitz	k eu l . l a . u . j e . b i . ch eu
kursk	k u . l eu . s eu . k eu
beaver	b i . b eo
basov	b a . s o . p eu
curel	k wi . l e l
sabri	s a . b eu . l i
nolan	n o l . l eo n
gladstone	g eu l . l ae . d eu . s eu . t eo n
hewish	h yu . i . s i
besancon	b eu . j a ng . s o ng
gounod	g u . n o
herrick	h e . l i g
akhmatova	a . h eu . m a . t o . b a
mississippi	m i . s i . s i . p i
buisson	b wi . s o ng
dam	d a m
luria	l u . l i . a
labrador	l ae . b eu . l a . d o
greece	g eu . l i . s eu
riley	l a . i l . l i
wisconsin	wi . s eu . k o n . s i n
silvia	s i l . b i . a
chausson	s yo . s o ng
steinbeck	s eu . t a . i n . b e g
molander	m o l . l a n . d eo
heuss	h o . i . s eu
josep	h o . s e b
wien	b i n
principe	p eu . l i n . s i . p e
carpini	k a . l eu . p i . n i
khartoum	h a . l eu . t u m
albin	a l . b i n
alberta	a l . b a . t a
lothian	l o . d i . eo n
ephesus	e . p e . s u . s eu
khamenei	h a . m e . n e . i
schonberg	s oe n . b e . l eu . k eu
layton	l e . i . t eu n
segantini	s e . g a n . t i . n i
leeuwenhoek	l e . b e n . h u . k eu
gwyn	g eu . wi n
hauser	h a . u . j eo
tito	t i . t o
busby	b eo . s eu . b i
lefebvre	l eu . p e . b eu . l eu
dina	d i . n a
ambrosius	a m . b eu . l o . s i . u . s eu
fay	p e . i
rogers	l o . j eo . s eu
libreville	l i . b eu . l eu . b i l
bakunin	b a . k u . n i n
fischer	p i . s yeo
ramo	l a . m o
pandora	p a n . d o . l a
edmundo	e . d eu . m o n . d eu
jonah	yo . n a
guinea	g i . n i
chaumont	s yo . m o ng
dietrich	d i . t eu . l i . s i
staffordshire	s eu . t ae . p eo . d eu . s yeo
bryce	b eu . l a . i . s eu
proudhon	p eu . l u . d o ng
steffi	s yu . t e . p i
florey	p eu l . l o . l i
holt	h o l . t eu
tasman	t a . s eu . m eo n
monrovia	m o n . l o . b i . a
bosanquet	b o . s a ng . k e
