monaco	m o . n a . k o
walker	wo . k eo
casadesus	k a . j a . d eu . j wi
pfitzner	p i . ch eu . n eo
serena	s e . l i . n a
guyana	g a . i . a . n a
broch	b eu . l o . h eu
ashkenazi	a . s i . k e . n a . j i
fein	p e . i n
cowper	k u . p eo
bryusov	b eu . l yu . s o . p eu
brangwyn	b eu . l ae ng . g wi n
prentice	p eu . l ae n . t i . s eu
macaulay	m ae . k o l . l i
cairns	k e . i n . j eu
weinberger	wa . i n . b eo . g eo
lionel	l i . o . n e l
carolyn	k ae . l eo l . l i n
alf	a l . p eu
alphonso	a l . p o n . s o
cube	k yu . b i g
laban	l a . b a n
dayan	d a . ya n
karim	k a . l i m
maldives	m o l . d i . b eu
principe	p eu . l i n . s i . p e
badger	b ae . j eo
rasputin	l a . s eu . p u . t i n
phoebe	p o . i . b e
annika	a . n i . k a
hanzi	h a n . jj eu
botswana	b o . ch eu . wa . n a
adrian	e . i . d eu . l i . eo n
mathias	m a . t i . a . s eu
cope	k o . p eu
hitch	h i . ch i
more	m o . eo
highland	h a . i . l ae n . d eu
bopp	b o . p eu
bovet	b o . b e
greer	g eu . l i . eo
tallinn	t a l . l i n
albin	a l . b i n
sabastian	s e . b a . s eu . ch a n
claus	k eu l . l a . u . s eu
moniuszko	m o . n i . u . s yu . k o
swart	s eu . wa . l eu . t eu
elster	e l . s eu . t eo
wand	b a n . t eu
canadian	k ae . n a . d i . a n
eads	i . j eu
gogol	g o . g o l . l i
gabin	g a . b ae ng
buono	b o . n o
lion	l i . o n
aylwin	a . i l . wi n
florian	p eu l . l o . l i . a n
mitterrand	m i . t e . l a ng
almeida	a l . m e . i . d a
barre	b a . l e
tyutchev	t yu . ch e . p eu
sylvain	s i l . b ae ng
fiona	p i . o . n a
cathy	k ae . s i
dubois	d wi . b u . a
lasker	l ae . s eu . k eo
stein	s yu . t a . i n
santander	s a n . t a n . d e . l eu
segovia	s e . g o . b i . a
devon	d e . b eo n
diogenes	d i . o . g e . n e . s eu
reines	l a . i . n eo . s eu
vivien	b i . b i . eo n
bevin	b e . b i n
nicholas	n i . k o l . l eo . s eu
agnelli	a . n ye l . l i
graham	g eu . l e . i . eo m
keyserling	k a . i . j eo l . l i ng
alba	a l . b a
bryan	b eu . l a . i . eo n
prebisch	p eu . l e . b i . s i
portugal	p o . l eu . t u . g a l
weizmann	b a . i . ch eu . m a n
michaux	m i . s yo
florida	p eu l . l o . l i . d a
nicole	n i . k o l
penny	p e . n i
anson	ae n . s eu n
phillips	p i l . l i b . s eu
waikiki	wa . i . k i . k i
dnepropetrovsk	d eu . n e . p eu . l o . p e . t eu . l o . p eu . s eu . k eu
campo	k a m . p o
senegal	s e . n e . g a l
zacharias	j a . k a . l i . a . s eu
guardi	g wa . l eu . d i
langmuir	l ae ng . m yu . eo
asimov	a . s i . m o . p eu
queneau	k eu . n o
ludovic	l u . d o . b i
shestov	s ye . s eu . t o . p eu
turgenev	t u . l eu . g e . n e . p eu
vincent	b i n . s e n . t eu
cassandra	k a . s a n . d eu . l a
brescia	b eu . l e . s i . a
casablanca	k a . s a . b eu l . l a ng . k a
abbot	a . b o . t eu
danny	d ae . n i
williamson	wi l . l i . eo m . s eu n
campbell	k ae m . b e l
starling	s eu . t a l . l i ng
ortelius	o . l eu . t e l . l i . u . s eu
aubert	o . b e . l eu
caravaggio	k a . l a . b a . j o
menem	m e . n e m
beecham	b i . ch eo m
alfredo	a l . p eu . l e . d o
gennaro	j e n . n a . l o
schubert	s yu . b e . l eu . t eu
guerrero	g e . l e . l o
wilkins	wi l . k i n . s eu
hepburn	h e b . b eo n
rebecca	l e . b e . k a
gertsen	g e . l eu . ch e n
musa	m u . s a
salerno	s a l . l e . l eu . n o
tessa	t e . s a
burney	b eo . n i
hoxha	h o . j a
maddox	m ae . d o g . s eu
bessel	b e . s e l
angela	a n . j e l . l a
vatican	b a . t i . k a n
benghazi	b e ng . g a . j i
jeff	j e . p eu
maurois	m o . l eu . wa
macauley	m ae g . k o l . l i
perot	p e . l o
rudin	l u . d i n
pane	p e . i n
anand	a . n a n . d eu
agrippina	a . g eu . l i . p i . n a
draper	d eu . l e . i . p eo
vinay	b i . n a . i
reger	l e . g eo
schnitzler	s yu . n i . ch eu l . l eo
karakhan	k a . l a . h a n
dunsany	d eo n . s e . i . n i
octavio	o g . t a . b i . o
iacocca	a . i . eo . k o . k a
morisot	m o . l i . j o
massey	m ae . s i
frida	p eu . l i . d a
attwood	ae . t u . d eu
robbins	l o . b i n . s eu
connelly	k o . n eo l . l i
clementi	k eu l . l e . m e n . t i
ritz	l i . ch eu
dedekind	d e . d e . k i n . t eu
buffon	b wi . p o ng
eckardt	e . k a . l eu . t eu
renato	l e . n a . t o
cavour	k a . b o . u . l eu
albrecht	a l . b eu . l e . h i . t eu
bristol	b eu . l i . s eu . t eu l
wycherley	wi . ch eo l . l i
fiori	p i . o . l i
avellaneda	a . b e . ya . n e . d a
rodrigues	l o . d eu . l i . g e . s eu
sherlock	s yeo l . l o g
brasseur	b eu . l a . s oe . l eu
pieter	p i . t eo
constance	k o n . s eu . t a n . s eu
liddell	l i . d eu l
ahmadabad	a . m a . d a . b a . d eu
zeeman	j e . m a n
calvino	k a l . b i . n o
gascoyne	g ae . s eu . k o . i n
eiffel	e . p e l
putnam	p eo . t eu . n eo m
ghana	g a . n a
thorvaldsen	t o . l eu . b a l . s e n
paine	p e . i n
schlegel	s yu l . l e . g e l
sigrid	s i . g eu . l i . d eu
bjorklund	b i . yo . l eu . k eu . l u n . t eu
chekhov	ch e . h o . p eu
andres	a n . d eu . l e . s eu
collett	k o l . l e . t eu
matt	m ae s
briscoe	b eu . l i . s eu . k o
pierluigi	p i . e . l eu l . l u . i . j i
wergeland	b e . l eu . g e l . l a n
andrade	a n . d eu . l a . d e
chissano	s i . s a . n o
winkler	b i ng . k eu l . l eo
baffin	b ae . p i n
baum	b a . u m
richards	l i . ch eo . j eu
botha	b o . t a
swammerdam	s eu . wa m . m e . l eu . d a m
marconi	m a . l eu . k o . n i
martin	m a . l eu . t ae ng
dev	d e . b eu
leszek	l e . s ye . k eu
rabi	l a . b i
grass	g eu . l a . s eu
bowden	b o . u . d e n
rolls	l o l . s eu
labrador	l ae . b eu . l a . d o
epstein	e b . s eu . t a . i n
ducommun	d wi . k o . m oe ng
luna	l u . n a
rolf	l o l . p eu
maureen	m o . l i n
cesalpino	ch e . s a l . p i . n o
cromer	k eu . l o . m eo
chuvash	ch u . b a . s yu
vance	b eo n . s eu
aragon	a . l a . g o n
humperdinck	h u m . p eo . d i ng . k eu
gros	g eu . l o
pankhurst	p ae ng . k eu . h eo . s eu . t eu
palermo	p a l . l e . l eu . m o
strick	s eu . t eu . l i g
angelika	a ng . g e l . l i . k a
allan	ae l . l eo n
piaf	p i . a . p eu
todor	t o . d o . l eu
jasper	j a . s eu . p eo
fitzgerald	p i . ch eu . j e . l eo l . d eu
haiti	a . i . t i
randolph	l ae n . d o l . p eu
denzel	d e n . j eo l
babbitt	b a . b i . t eu
mathewson	m ae . t yu . s eu n
furtado	p eo l . t a . d o
lucie	l u . s i
schwarzkopf	s yu . wo . ch eu . k o . p eu
hale	h e . i l
nicolas	n i . k eo l . l eo . s eu
kendrick	k e n . d eu . l i g
inga	i ng . g a
oldham	o l . d eu . h ae m
baier	b a . i . eo
beckett	b e . k e . t eu
josef	yo . s e . p eu
como	k o . m o
kelsen	k e l . j e n
rocco	l o . k o
dongen	d o ng . g e n
olbrich	o l . b eu . l i . h i
lenormand	l eu . n o . l eu . m a ng
pardo	p a . l eu . d o
doyle	d o . i l
spencer	s eu . p e n . s eo
helena	h e l . l e . n a
bangemann	b a ng . g e . m a n
battista	b a . t i . s eu . t a
dever	d e . b eo
flaubert	p eu l . l o . b e . l eu
mansfield	m ae n . s eu . p i l . d eu
antoni	a n . t o . n i
lanzhan	l a n . j a n
jacoby	j a . k o . b i
fontaine	p o ng . t e n
bessie	b e . s i
raymond	l e . m o ng
desmond	d e . j eu . m eo n . d eu
fourier	p u . l i . e
amin	a . m i n
presley	p eu . l e . s eu l . l i
belgium	b e l . g i . e
heidenstam	h e . i . d e n . s eu . t a m
lyman	l a . i . m eo n
fischer	p i . s yeo
dave	d e . i . b eu
duncan	d eo ng . k eo n
kutuzov	k u . t u . j o . p eu
dionysius	d i . o . n i . s i
rivero	l i . b e . l o
fuller	p u l . l eo
steiner	s yu . t a . i . n eo
caroline	k ae . l o l . l a . i n
cone	k o n
frick	p eu . l i g
sholes	s yo l . s eu
bratislava	b eu . l a . t i . s eu l . l a . b a
paderewski	p a . d e . l e . p eu . s eu . k i
mott	m o . t eu
reinhold	l a . i n . h o l . t eu
senefelder	j e . n e . p e l . d eo
hort	h o l . t eu
kandel	k ae n . d eu l
stafford	s eu . t ae . p o . d eu
castello	k a . s eu . t e l . l o
uwe	u . b e
tobey	t o . b i
beth	b e . s eu
harry	h ae . l i
ocampo	o . k a m . p o
moore	m u . eo
emile	e . m i l
ricci	l i . ch i
andreotti	a n . d eu . l e . o . t i
gaspard	g a . s eu . p a . l eu
hubertus	h u . b e . l eu . t u . s eu
holger	h o l . g e . l eu
baumann	b a . u . m a n
minneapolis	m i . n i . ae . p o l . l i . s eu
pedro	p e . d eu . l o
bentinck	b e n . t i ng . k eu
patricia	p ae . t eu . l i . s ya
roald	l o . a l
hidalgo	i . d a l . g o
rosse	l o . s eu
monique	m o . n i . k eu
sabine	s a . b i n
machel	m a . s ye l
beddoes	b e . d o . s eu
diouf	d i . u . p eu
santer	s a ng . t e . l eu
samuelson	s a . m u . e l . s eu n
baird	b e . eo . d eu
robespierre	l o . b e . s eu . p i . e . l eu
sears	ss i . eo . s eu
krupp	k eu . l u . p eu
mole	m o l
piotrowski	p i . o . t eu . l o . p eu . s eu . k i
darmstadt	d a . l eu m . s yu . t a . t eu
marian	m a . l i . a n
lennon	l e . n o n
gomes	g o . m e . s eu
balas	b a l . l a . s eu
zetkin	ch e . t eu . k i n
bass	b ae . s eu
eckermann	e . k eo . m a n
kopp	k o . p eu
bitter	b i . t eo
larson	l a . s eu n
conakry	k o . n a . k eu . l i
quantz	k eu . b a n . ch eu
neilson	n i l . s eu n
terra	t e . l a
blackpool	b eu l . l ae g . p u l
melo	m e l . l o
ringer	l i ng . g eo
rene	l eu . n e
josephus	yo . s e . p u . s eu
hanks	h ae ng . k eu . s eu
schiaparelli	s eu . k i . a . p a . l e l . l i
landers	l ae n . d eo . s eu
kolar	k o l . l a . l eu
posse	p o . s e
aachen	a . h e n
cornforth	k o n . p o . s eu
vicki	b i . k i
tischbein	t i . s yu . b a . i n
latimer	l e . i . t i . m eo
zajac	j a . j a . k eu
laussedat	l o . s e . d a
hampton	h ae m . p eu . t eo n
lovelace	l eo . b eu . l e . i . s eu
dunne	d eo n
hettner	h e . t eu . n eo
angola	a ng . g o l . l a
benacerraf	b e . n a . s e . l a . p eu
candice	k ae n . d i . s eu
eve	i . b eu
hutson	h eo . t eu . s eu n
hirsch	h eo . s wi
strand	s eu . t eu . l ae n . d eu
wade	wa . d e
albertville	a l . b e . l eu . b i l
morel	m o . l e l
svetlana	s eu . b e . t eu l . l a . n a
steno	s eu . t e . n o
longchamp	l o ng . s ya ng
huff	h eo . p eu
rogers	l o . j eo . s eu
dianne	d a . i . ae n
garris	g a . l e . s eu
batman	b ae . t eu . m ae n
brno	b eu . l eu . n o
nizan	n i . j a ng
edelman	e . d eo l . m eo n
sophia	s o . p i . a
gogh	g o . h eu
giono	j i . o . n o
alabama	ae l . l a . b ae . m a
fowles	p a . u l . j eu
doran	d o . l eo n
wendy	we n . d i
bruch	b eu . l u . h eu
alberti	a l . b e . l eu . t i
filchner	p i l . h i . n eo
taussig	t a . u . s i . g eu
touraine	t u . l e n
crommelynck	k eu . l o m . l ae ng . k eu
gall	g a l
avenarius	a . b e n . n a . l i . u . s eu
ugarte	u . g a . l eu . t e
lotto	l o . t o
cardiff	k a . d i . p eu
myron	m i . l o n
crean	k eu . l i n
pople	p o . p eu l
heyden	h e . i . d e n
thomas	d o . m a
hellen	h e l . l e n
caen	k a ng
herrera	h e . l e . l a
landgrebe	l ae n . d eu . g eu . l e . b e
moira	m o . i . l a
spenser	s eu . p e n . s eo
kesey	k i . j i
hobsbawm	h o b . s eu . b o m
noble	n o . b eu l
guizot	g i . j o
carey	k e . l i
szigeti	s i . g e . t i
laski	l ae . s eu . k i
reichenbach	l a . i . h e n . b a . h eu
hanon	a . n o ng
ernie	eo . n i
loos	l u . s eu
batyushkov	b a . t yu . s yu . k o . p eu
scheidemann	s ya . i . d e . m a n
busby	b eo . s eu . b i
dill	d i l
arne	a . l eu . n e
montelius	m o n . t e l . l i . u . s eu
jerrold	j e . l eo l . d eu
engels	e ng . g e l . s eu
percy	p eo . s i
koen	k o . e n
romer	l o . m eo
yaounde	ya . u n . d e
clark	k eu l . l a . k eu
wallace	wo l . l i . s eu
dieter	d i . t eu . l eu
hawthorn	h o . s o n
biber	b i . b eo
kaspar	k a . s eu . p a . eo
cromwell	k eu . l o m . we l
beza	b e . j a
algren	o l . g eu . l eo n
baxter	b ae g . s eu . t eo
mojave	m o . h a . b i
kochanowski	k o . h a . n o . p eu . s eu . k i
gaj	g a . i
carpini	k a . l eu . p i . n i
cellini	ch e l . l i . n i
augustin	o . g u . s eu . t i n
rollo	l o l . l o
coburn	k o . b eo n
lagos	l a . g o . s eu
ion	i . o n
bunsen	b u n . j e n
barrera	b a . l e . l a
cheney	ch e . n i
boyce	b o . i . s eu
sorokin	s o . l o . k i n
arnhem	a . l eu n . h e m
haifa	h a . i . p a
harlow	h a l . l o
danton	d a ng . t o ng
morin	m o . l ae ng
thomas	t o . m eo . s eu
trollope	t eu . l o l . l eo b
lasso	l a . s o
ankara	a ng . k a . l a
dimitri	d i . m i . t eu . l i
noether	n oe . t eo
petrie	p i . t eu . l i
rod	l o . d eu
bonnard	b o . n a . l eu
chamorro	ch a . m o . l o
ruth	l u . s eu
tang	d a ng
brassens	b eu . l a . s a ng . s eu
morrow	m o . l o
benda	b a ng . d a
bella	b e l . l a
revere	l i . b i . eo
edward	e . d eu . wo . d eu
boethius	b o . i . t i . u . s eu
needham	n i . d eo m
milhaud	m i . yo
lombardo	l o m . b a . l eu . d o
nevelson	n i . b e l . s eu n
artigas	a . l eu . t i . g a . s eu
milt	m i l . t eu
cassini	k a . s i . n i
salt	s o l . t eu
sinan	s i . n a n
schleiden	s yu l . l a . i . d e n
liechtenstein	l i . h i . t e n . s yu . t a . i n
marquand	m a . k wo n . d eu
kingsley	k i ng . j eu l . l i
bolton	b o l . t eo n
powell	p a . wo l
nimu	n i . m u
emilio	e . m i l . l i . o
lambeth	l ae m . b eo . s eu
gunnar	g u n . n a . l eu
maurer	m a . u . l eo
babe	b e . i . b eu
mann	m a n
ronan	l o . n a n
malinowski	m a l . l i . n o . p eu . s eu . k i
arnim	a . l eu . n i m
verhaeren	b e . l eu . h a . l e n
mendel	m e n . d e l
blaine	b eu l . l e . i n
robb	l o b
pufendorf	p u . p e n . d o . l eu . p eu
earl	eo l
rousseau	l u . s o
jeremiah	ye . l e . m i . ya
moldova	m o l . d o . b a
barroso	b a . l o . s u
taylor	t e . i l . l eo
behrman	b e . eo . m eo n
dee	d i
castries	k ae . s eu . t eu . l i . s eu
dulbecco	d u l . b e . k o
agostino	a . g o . s eu . t i . n o
bias	b i . a . s eu
nils	n i l . s eu
julie	j u l . l i
leslie	l e . s eu l . l i
gartner	g a . t eu . n eo
margarita	m a . g a . l i . t a
pigalle	p i . g a l
trevelyan	t eu . l i . b e l . l i . eo n
eckhart	e . k eu . h a . l eu . t eu
quebec	k we . b e g
gallegos	g a l . l e . g o . s eu
hebra	h e . b eu . l a
edwards	e . d eu . wo . j eu
stephanie	s eu . t e . p a . n i
elise	e l . l i . s eu
taine	t e n
esteban	e . s eu . t e . b a n
alameda	a l . l eo . m i . d a
thom	t o m
lombard	l o m . b a . d eu
riefenstahl	l i . p e n . s yu . t a l
kuprin	k u . p eu . l i n
troy	t eu . l o . i
carson	k a . s eu n
magnus	m a . g eu . n u . s eu
thyssen	t i . s e n
languedoc	l a ng . g eu . d o . k eu
fanny	p a . n i
groom	g eu . l u m
greg	g eu . l e . g eu
stark	s yu . t a . l eu . k eu
fox	p o g . s eu
speth	s eu . p e . s eu
muriel	m yu . l i . e l
binyon	b i . n i . eo n
costa	k o . s eu . t a
crompton	k eu . l eo m . p eu . t eo n
capri	k a . p eu . l i
litt	l i s
schmiedeberg	s yu . m i . d e . b e . l eu . k eu
pompidou	p o ng . p i . d u
rahal	l a . h o . l eu
adorno	a . d o . l eu . n o
cabral	k a . b eu . l a l
martha	m a . s ya
radu	l a . d u
butts	b eo . ch eu
metzler	m e . ch eu . l eo
jordaens	yo . l eu . d a n . s eu
knox	n o g . s eu
johnston	j o n . s eu . t o n
toffler	t o . p eu l . l eo
leila	l e . i l . l a
astrakhan	a . s eu . t eu . l a . h a n
wiesbaden	b i . s eu . b a . d e n
ronge	l o ng . i
fay	p e . i
bayard	b a . ya . l eu
bible	b a . i . b eu l
hebron	h e . b eu . l o n
turk	t eo . k i
jonny	j o . n i
arndt	a . l eu n . t eu
nathan	n a . d a n
butenandt	b u . t e . n a n . t eu
goodnow	g u s . n o . u
balboa	b a l . b o . a
amato	a . m a . t o
millard	m i l . l eo . d eu
kiel	k i l
severo	s e . b e . l o
bidwell	b i . d eu . we l
martenot	m a . l eu . t eu . n o
bowen	b o . e n
jaspers	ya . s eu . p eo . s eu
thaddeus	d a . d ae . o
spengler	s yu . p e ng . g eu l . l eo
casey	k e . i . s i
ferrante	p e . l a n . t eu
schiller	s i l . l eo
cherenkov	ch e . l e n . k o . p eu
neumann	n o . i . m a n
lacan	l a . k a ng
blanche	b eu l . l a ng . s wi
barmen	b a . l eu . m e n
parkes	p a g . s eu
bourne	b o n
suzanne	s u . j a n
fazal	p a . j a l
duvall	d yu . b a l
chang	j a ng
raman	l a . m a n
lake	l e . i . k eu
eyck	e . i . k eu
jouve	j u . b eu
gainsborough	g e . i n . j eu . b eo . l eo
biel	b i . e l
rehnquist	l e n . k wi . s eu . t eu
barnard	b a . n eo . d eu
anouilh	a . n u . i
strang	s eu . t eu . l ae ng
gerard	j e . l a . l eu
valdivia	b a l . d i . b i . a
bongo	b o ng . g o
joaquim	h o . a . k i m
bettina	b e . t i . n a
nasmyth	n e . i . j eu . m i . s eu
lash	l ae . s wi
donatus	d o . n a . t u . s eu
karin	k a . l i n
priestley	p eu . l i . s eu . t eu l . l i
reg	l e . j i
lille	l i l
michael	m i . s we l
debbie	d e . b i
togliatti	t o l . l i . a . t i
farrell	p ae . l eo l
jean	j a n
pakistan	p a . k i . s eu . t a n
tracy	t eu . l e . i . s i
mesquita	m e . s eu . k i . t a
read	l i . d eu
onsager	o n . s a . g eo
potsdam	p o . s eu . d a m
virgil	b eo . j i l
alt	a l . t eu
larkin	l a . k i n
bayley	b e . i . l e . i
middleton	m i . d eu l . t eo n
dixit	d i g . s i . t eu
asch	ae . s wi
buffalo	b eo . p eo l . l o
volta	b o l . t a
marsh	m a . s i
rodney	l o . d eu . n i
prishvin	p eu . l i . s yu . b i n
leonardo	l e . o . n a . l eu . d o
dion	d i . o ng
klopstock	k eu l . l o b . s yu . t o . k eu
khalil	k a l . l i l
cecil	s e . s i l
farber	p a . b eo
gustave	g u . s eu . t a . b eu
hutchison	h eo . ch i . s eu n
pourcel	p u . l eu . s e l
caldecott	k o l . d eo . k eo s
braine	b eu . l e . i n
valentino	b a l . l e n . t i . n o
carlsson	k a l . s o n
kai	k a . i
davenport	d ae . b eu n . p o . t eu
bernardo	b e . l eu . n a . l eu . d o
connaught	k o . n eo s
harald	h a . l a l . t eu
kraft	k eu . l a . p eu . t eu
hardy	h a . d i
re	l e
amanda	a . m a n . d a
cramer	k eu . l ae . m eo
debussy	d eu . b wi . s i
wend	we n . d eu
faraday	p ae . l eo . d i
dmitri	d eu . m i . t eu . l i
schweitzer	s yu . b a . i . ch eo
obando	o . b a n . d o
rios	l i . o . s eu
ross	l o . s eu
nirenberg	n i . l eo n . b eo . g eu
pergolesi	p e . l eu . g o l . l e . s i
dolph	d o l . p eu
dunlop	d eo n . l o b
dyer	d a . i . eo
wangchuck	wa ng . ch u . k eu
plato	p eu l . l a . t o n
stimson	s eu . t i m . s eu n
marr	m a . l eu
stravinsky	s eu . t eu . l a . b i n . s eu . k i
mira	m i . l a
kumar	k u . m a . l eu
merz	m e . l eu . ch eu
varro	b a . l o
arie	a . l i . e
howe	h a . u
pizarro	p i . s a . l o
albany	o l . b eo . n i
clint	k eu l . l i n . t eu
kuznets	k u . j eu . n e . ch eu
amelia	a . m e l . l i . a
quesada	k we . s eu . d a
shamir	s ya . m i . l eu
florence	p eu l . l o . l e n . s eu
ruo	l wo
ward	wo . d eu
long	l o ng
tora	t o . l a
horowitz	h o . l o . b i . ch eu
engelbert	e ng . g e l . b eo . t eu
reuben	l eu . u . b e n
oswald	o . s eu . b a l . t eu
cottbus	k o s . b u . s eu
jakarta	j a . k a . l eu . t a
kurt	k u . l eu . t eu
marquis	m a . l eu . k i . s eu
bordeaux	b o . l eu . d o
rossi	l o . s i
rhine	l a . i n
scheele	s ye l . l e
allah	a l . l a
newman	n yu . m eo n
indus	i n . d eo . s eu
constantine	k o ng . s eu . t a ng . t i n
aron	a . l o ng
willie	wi l . l i
roger	l o . j eo
sudbury	s eo . d eu . b e . l i
albania	a l . b a . n i . a
henley	h e n . l i
dollar	d a l . l eo
laura	l a . u . l a
springfield	s eu . p eu . l i ng . p i l . d eu
cheyenne	s ya . i . e n
ogilvy	o . g eu l . b i
otis	o . t i . s eu
morand	m o . l a ng
schonberg	s oe n . b e . l eu . k eu
daugherty	d o . h eo . t i
kerstin	k eo . s eu . t i n
svevo	s eu . b e . b o
stirling	s eu . t eo . l i ng
martinon	m a . l eu . t i . n o ng
australia	o . s eu . t eu . l e . i l . l i . a
lilongwe	l i l . l o ng . g we
shaheen	s yae . h i n
annette	a . n e . t eu
muscat	m u . s eu . k a . t eu
duvivier	d wi . b i . b i . e
glover	g eu l . l o . b eo
washington	wo . s i ng . t eo n
nurmi	n u . l eu . m i
cleveland	k eu l . l i . b eu l . l ae n . d eu
cassidy	k ae . s i . d i
majuro	m a . j u . l o
pirandello	p i . l a n . d e l . l o
leon	l e . o ng
pamela	p a . m e l . l a
nie	n ye
abram	a . b eu . l a m
pauker	p a . u . k e . l eu
sylvester	s i l . b e . s eu . t eo
wordsworth	wo . j eu . wo . s eu
gettysburg	g e . t i . j eu . b eo . g eu
huch	h u . h eu
lutz	l u . ch eu
arad	a . l a . d eu
brookes	b eu . l u g . s eu
huxley	h eo g . s eu l . l i
reynolds	l e . i . n o l . j eu
kathy	k ae . s i
luisa	l u . i . j a
david	d e . i . b i . d eu
gilels	g i l . l e l . s eu
dumas	d wi . m a
bebel	b e . b e l
royce	l o . i . s eu
pittsburgh	p i . ch i . b eo . g eu
cienfuegos	s i . e n . p u . e . g o . s eu
szell	s e l
bourget	b u . l eu . j e
jonathan	j o . n eo . s eo n
limerick	l i . m eo . l i g
crosby	k eu . l o . s eu . b i
chapsal	s ya . p eu . s a l
timoshenko	t i . m o . s we n . k o
jenkins	j e n . k i n . s eu
bajer	b a . ye . l eu
brazzaville	b eu . l a . j a . b i l
mariano	m a . l i . a . n o
lubin	l u . b i n
kirsten	k eo . s eu . t i n
cram	k eu . l ae m
caruso	k a . l u . s o
algeciras	a l . h e . s i . l a . s eu
bohr	b o . eo
buchanan	b yu . k ae . n eo n
beveridge	b e . b eo . l i . j i
dern	d eo n
sucre	s u . k eu . l e
walesa	b a . we n . s a
canton	g wa ng . d u ng
whittier	h wi . t i . eo
teagarden	t i . g a . d eu n
pigou	p i . g u
bert	b e . l eu . t eu
erich	e . l i . h i
liebermann	l i . b e . l eu . m a n
landry	l a ng . d eu . l i
hollingworth	h o l . l i ng . wo . s eu
buonarroti	b u . o . n a . l o . t i
gorchakov	g o . l eu . ch a . k o . p eu
nkrumah	eu n . k eu . l u . m a
faiz	p e . i . j eu
hurst	h eo . s eu . t eu
millikan	m i l . l i . k eo n
persson	p e . l eu . s o n
basseterre	b a . s eu . t e . l eu
algeria	a l . j e . l i
jobs	j a b . s eu
cain	k a . i n
gobat	g o . b a
gioberti	j o . b e . l eu . t i
waugh	wo
kreutzer	k eu . l o . i . ch eo
knightley	n a . i . t eu l . l i
radcliffe	l ae . d eu . k eu l . l i . p eu
oistrakh	o . i . s eu . t eu . l a . h eu
avvakum	a . b a . k u m
gerhard	g e . l eu . h a . l eu . t eu
workman	wo . k eu . m ae n
patagonia	p a . t a . g o . n i . a
glaser	g eu l . l e . i . j eo
argentina	a . l eu . h e n . t i . n a
pax	p a g . s eu
massachusetts	m ae . s a . ch u . s e . ch eu
lea	l e . a
lodge	l o . j i
myburgh	m a . i . b eo . g eu
hendrix	h e n . d eu . l i g . s eu
schumacher	s yu . m a . h eo
janet	j a . n e
reynaud	l e . n o
antonius	a n . t o . n i . u . s eu
bill	b i l
suslov	s u . s eu l . l o . p eu
casper	k ae . s eu . p eo
bethell	b e . d e l
rademacher	l a . d e . m a . h eo
pavel	p a . b e l
jamison	j e . i . m i . s eu n
beyer	b a . i . eo
abidjan	a . b i . j a ng
bianchi	b i . a ng . k i
muir	m yu . eo
abuja	a . b u . j a
william	wi l . l i . eo m
chausson	s yo . s o ng
canetti	k a . n e . t i
guyon	g wi . yo ng
munich	m wi n . h e n
peper	p e . p e . l eu
mengelberg	m e ng . g e l . b e . l eu . k eu
ashton	ae . s yu . t eo n
lepidus	l e . p i . d u . s eu
bloomington	b eu l . l u . m i ng . t eo n
scholes	s yo l . s eu
klaus	k eu l . l a . u . s eu
sanderson	s ae n . d eo . s eu n
andrzejewski	a n . j e . ye . p eu . s eu . k i
donne	d eo n
passow	p a . s yo . p eu
topeka	t o . p i . k a
eijkman	e . i . k eu . m a n
elzevir	e l . j e . b i . eo
romero	l o . m e . l o
babbage	b ae . b i . j i
thor	t o . l eu
andreu	a n . d eu . l e . u
swinburne	s eu . wi n . b eo n
bradley	b eu . l ae . d eu l . l i
clements	k eu l . l e . m eo n . ch eu
luxemburg	l u g . s e m . b u . l eu . k eu
hatton	h ae . t eu n
ambrosius	a m . b eu . l o . s i . u . s eu
kabul	k a . b u l
durant	d yu . l ae n . t eu
hartung	a . l eu . t u ng
montes	m o n . t e . s eu
marlin	m a l . l i n
richard	l i . ch eo . d eu
maloney	m eo l . l o . n i
torrence	t o . l eo n . s eu
robert	l o . b eo . t eu
hessen	h e . s e n
nono	n o . n o
ethan	i . s eo n
darryl	d ae . l i l
singer	s i ng . eo
kaiser	k a . i . j eo
tatum	t e . i . t eo m
ewing	yu . i ng
conway	k o n . we . i
armen	a . l eu . m e n
brenner	b eu . l e . n eo
kris	k eu . l i . s eu
gumplowicz	g u m . p eu l . l o . b i . ch i
sumner	s eo m . n eo
lott	l o s
georgette	j o . j e s
basque	b a . s eu . k eu
shadwell	s yae . d eu . we l
sutherland	s eo . d eo l . l ae n . d eu
tajo	t a . h o
auckland	o . k eu l . l ae n . d eu
mandela	m a n . d e l . l a
stephen	s eu . t i . b eu n
holbein	h o l . b a . i n
sigourney	s i . g eo . n i
huberman	h yu . b eo . m eo n
milosevic	m i l . l o . s ye . b i . ch i
stoney	s eu . t o . n i
lilly	l i l . l i
cornelis	k o . l eu . n e l . l i . s eu
arenas	a . l e . n a . s eu
rushdie	l u . s yu . d i
urbain	wi . l eu . b ae ng
hensen	h e n . j e n
prout	p eu . l a . u . t eu
ferrari	p e . l a . l i
kahn	k a n
mauritania	m o . l i . t a . n i . a
shlomo	s yu l . l o . m o
marrakech	m a . l a . k e . s i
cambodia	k a m . b o . d i . a
santorio	s a n . t o . l i . o
indonesia	i n . d o . n e . s i . a
lindberg	l i n . d eu . b eo . g eu
golding	g o l . d i ng
linton	l i n . t eo n
breyer	b eu . l e . i . eo
uno	u . n o
haugland	h e . u l . l a n
gromyko	g eu . l o . m i . k o
armin	a . l eu . m i n
ara	a . l a
lapp	l a . p eu
westerberg	b e . s eu . t e . l eu . b e . l i
knowles	n o l . s eu
moi	m o . i
benvenuto	b e n . b e . n u . t o
fahim	p a . h i m
magee	m ae . g i
lima	l i . m a
sinai	s i . n a . i
melissa	m e l . l i . s a
kee	k i
vivian	b i . b i . a n
hepplewhite	h e . p eu l . h wa . i . t eu
haas	h a . s eu
dyson	d a . i . s eu n
gottfried	g o . t eu . p eu . l i . t eu
ana	a . n a
hope	h o . p eu
bullock	b u l . l eo g
kirk	k eo . k eu
beaverbrook	b i . b eo . b eu . l u g
berchem	b eo . ch e m
rojas	l o . h a . s eu
tiberius	t i . b e . l i . u . s eu
donato	d o . n a . t o
etienne	e . t i . e n
loschmidt	l o . s yu . m i . t eu
bergson	b e . l eu . g eu . s o ng
cayenne	k a . ye n
rabinowitz	l a . b i . n o . b i . ch eu
renner	l e . n eo
junker	yu ng . k eo
grillo	g eu . l i l . l o
tussaud	t eo . s o
almond	a l . m o n . d eu
schulz	s yu l . ch eu
gustavo	g u . s eu . t a . b o
haley	h a l . l i
mario	m a . l i . o
prosper	p eu . l o . s eu . p e . l eu
seyni	s e . i . n i
freeman	p eu . l i . m eo n
rozier	l o . j i . e
nadine	n e . i . d i n
gassendi	g a . s a ng . d i
maistre	m e . s eu . t eu . l eu
montpellier	m o ng . p e l . l i . e
willcocks	wi l . k o g . s eu
nikolaeva	n i . k o l . l a . e . b a
foggia	p o . j i . a
sutter	s u . t eo
santana	s a n . t a . n a
masefield	m e . i . s eu . p i l . d eu
coen	k o . e n
dorn	d o n
carrera	k a . l e . l a
hazel	h e . i . j eu l
bernanos	b e . l eu . n a . n o . s eu
heckscher	h e . k eu . s ye . l eu
harley	h a l . l i
boz	b o . j eu
kirov	k i . l o . p eu
heijermans	h a . i . ye . l eu . m a n . s eu
erfurt	e . l eu . p u . l eu . t eu
ellesmere	e l . j eu . m i . eo
harriet	h ae . l i . eo s
batoni	b a . t o . n i
essex	e . s i g . s eu
patterson	p ae . t eo . s eu n
jeremias	ye . l e . m i . a . s eu
berlin	b e . l eu l . l i n
sexton	s e g . s eu . t eo n
geoffrey	j e . p eu . l i
chesterfield	ch e . s eu . t eo . p i l . d eu
antoinette	a ng . t u . a . n e . t eu
sitwell	s i . t eu . we l
benedetto	b e . n e . d e . t o
abreu	eo . b eu . l e . u
oskar	o . s eu . k a . l eu
gossen	g o . s e n
sara	s a . l a
wolff	b o l . p eu
michelet	m i . s yu l . l e
connecticut	k o . n e . t i . k eo s
juliette	j wi l . l i . e . t eu
exeter	e g . s eo . t eo
doolittle	d u l . l i . t eu l
valentine	b a l . l e n . t a . i n
bonomi	b o . n o . m i
nervo	n e . l eu . b o
holden	h o l . d eu n
asia	a . s i . a
cordelia	k o . d e l . l i . a
norma	n o . m a
achille	a . k i l . l e
stevens	s eu . t i . b eu n . s eu
dukas	d wi . k a
cass	k ae . s eu
simons	s a . i . m eo n . j eu
kees	k i . s eu
sardou	s a . l eu . d u
sterne	s eu . t eo n
neil	n i l
huysmans	wi . s eu . m a ng . s eu
fogazzaro	p o . g a . ch a . l o
marschner	m a . l eu . s yu . n eo
tolkien	t o l . k i n
morris	m o . l i . s eu
claude	k eu l . l a . u . d eu
poland	p o l . l a n . d eu
khabarovsk	h a . b a . l o . p eu . s eu . k eu
meadows	m i . d o . u . s eu
abend	a . b e n . d eu
marcel	m a . l eu . s e l
dora	d o . l a
sarney	s a . l eu . n e . i
usher	eo . s yeo
bukharin	b u . h a . l i n
padua	p a . d u . a
wartburg	b a . l eu . t eu . b u . l eu . k eu
tiso	t i . s o
eyre	e . eo
sigmund	s i . g eu . m eo n . d eu
haren	h a . l e n
longo	l o ng . g o
henie	h e . n i
harvey	h a . b i
chess	ch e . s eu
mello	m e l . l o
bardem	b a . d e m
blixen	b eu l . l i g . s e n
jordan	yo . l eu . d a n
betjeman	b e . ch eo . m eo n
sassoon	s eo . s u n
carpaccio	k a . l eu . p a . ch o
nikolaev	n i . k o l . l a . ye . p eu
anthony	a n . t o . n i . o
hall	h o l
abruzzi	a . b eu . l u . ch i
naiman	n a . i . m a n
shah	s ya . a
bacchus	b a . k eo . s eu
fini	p i . n i
salman	s a l . m a n
bowman	b o . m eo n
zapata	s a . p a . t a
texas	t e g . s a . s eu
caragiale	k a . l a . j i . a l . l e
east	d o ng . b a ng
gesell	g e . j e l
fisch	p i . s yeo
biagio	b i . a . j i . o
hicks	h i g . s eu
adams	ae . d eo m . s eu
abigail	ae . b i . g ae . i l
nerva	n e . l eu . b a
adam	a . d a m
richmond	l i . ch i . m eo n . d eu
meister	m e . i . s eu . t eo
hieronymus	h i . e . l o . n i . m u . s eu
bulgaria	b u l . g a . l i . a
fowler	p a . u l . l eo
voynich	b o . n i . ch i
julio	h u l . l i . o
caro	k a . l o
jennifer	j e . n i . p eo
hains	e ng . s eu
simeon	s i . m eu . o n
quin	k wi n
mergenthaler	m eo . g eo n . t a l . l eo
billings	b i l . l i ng . s eu
flanagan	p eu l . l ae . n eo . g eo n
busia	b u . s i . a
vladimir	b eu l . l a . d i . m i . l eu
sultan	s u l . t a n
bowie	b o . wi
berti	b e . l eu . d i
daniell	d a . n i . e l
ella	e l . l a
illinois	i l . l i . n o . i
livingston	l i . b i ng . s eu . t eo n
antoine	a ng . t u . a n
westinghouse	we . s eu . t i ng . h a . u . s eu
ram	l ae m
espronceda	e . s eu . p eu . l o n . s e . d a
einthoven	e . i n . t eu . h o . b e n
klitzing	k eu l . l i . ch i ng
gallo	g a l . l o
bales	b e . i l . j eu
dale	d e . i l
hannah	h ae . n a
elton	e l . t eu n
modigliani	m o . d i l . l i . a . n i
bentham	b e n . d a m
deakin	d i . k i n
veronese	b e . l o . n e . s e
rana	l a . n a
melinda	m e l . l i n . d a
wit	b i . t eu
nehru	n e . l u
koror	k o . l o . l eu
zeiss	ch a . i . s eu
rudolph	l u . d o l . p eu
colin	k o l . l ae ng
ludwig	l u . t eu . b i . h i
dilthey	d i l . t a . i
mckay	m ae g . k e . i
milestone	m a . i l . s eu . t o n
rudolf	l u . d o l . p eu
atlas	a . t eu l . l a . s eu
ives	a . i . b eu . j eu
prokofiev	p eu . l o . k o . p i . ye . p eu
sue	s wi
holliday	h o l . l i . d e . i
tilman	t i l . m a n
guinea_bissau	g i . n i . b i . s a . u
anwari	a n . wa . l i
barrie	b ae . l i
edmundo	e . d eu . m o n . d eu
boswell	b o . j eu . we l
disney	d i . j eu . n i
imbert	i m . b e . l eu . t eu
kiss	k i . s i
ventura	b e n . ch yu . l a
ellie	e l . l i
chauncey	ch e n . s i
brutus	b eu . l u . t u . s eu
paris	p a . l i
magnitogorsk	m a . g eu . n i . t o . g o . l eu . s eu . k eu
brynner	b eu . l i . n eo
shipley	s i . p eu l . l i
bremerhaven	b eu . l e . m eo . h a . p e n
millay	m i l . l e . i
babson	b ae b . s eu n
rumsey	l eo m . j i
dick	d i g
barca	b a . l eu . k a
judith	yu . d i . t eu
fenton	p e n . t eu n
gaza	g a . j a
umberto	u m . b e . l eu . t o
frey	p eu . l o . i
schleicher	s yu l . l a . i . h eo
scheidt	s ya . i . t eu
pudovkin	p u . d o . p eu . k i n
maclaren	m ae . k eu l . l ae . l eo n
rubin	l u . b i n
venter	b e n . t eo
tennant	t e . n eo n . t eu
dina	d i . n a
padgett	p ae . j e s
crashaw	k eu . l ae . s yo
austin	o . s eu . t i n
bradbury	b eu . l ae . d eu . b eo . l i
werner	b e . l eu . n eo
abba	a . b a
lem	l e m
bagehot	b ae . j eo s
frazer	p eu . l e . i . j eo
joni	j o . n i
wolker	b o l . k e . l eu
chad	ch a . d eu
michnik	m i . h eu . n i . k eu
julianus	yu l . l i . a . n u . s eu
magdalena	m a g . d a l . l e . n a
maximilian	m a g . s i . m i l . l i . a n
grande	g eu . l ae n . d eu
barkley	b a . k eu l . l i
rochester	l o . ch e . s eu . t eo
tiepolo	t i . e . p o l . l o
lund	l u n . d eu
shearer	s i . eo . l eo
bienville	b i . e n . b i l
riddick	l i . d i g
bromley	b eu . l o m . l i
goldman	g o l . d eu . m a ng
northumberland	n o . s eo m . b eo l . l ae n . d eu
kaschnitz	k a . s yu . n i . ch eu
ulrike	u l . l i . k eu
franklin	p eu . l ae ng . k eu l . l i n
quental	k we n . t a l
bettino	b e . t i . n o
hubbard	h eo . b eo . d eu
kraus	k eu . l a . u . s eu
white	h wa . i . t eu
pitt	p i . t eu
kiev	k i . ye . p eu
dagerman	d a . g e . l eu . m a n
tyler	t a . i l . l eo
huntsman	h eo n . ch eu . m eo n
tanner	t ae . n eo
ranasinghe	l a . n a . s i ng . h e
warburg	b a . l eu . b u . l eu . k eu
sweeney	s eu . wi . n i
edgeworth	e . j i . wo . s eu
urbano	eo l . b a . n o
marc	m a . l eu . k eu
jackie	j ae . k i
ontario	o n . t a . l i . o
hurley	h eo l . l i
hayat	h a . ya s
sulla	s u l . l a
ozenfant	o . j a ng . p a ng
oud	o . d eu
wayland	we . i l . l ae n . d eu
gozzi	g o . ch i
brenda	b eu . l e n . d a
haider	h a . i . d eo
jarry	j a . l i
flores	p eu l . l o . l e . s eu
pacino	p a . ch i . n o
margery	m a . j e . l i
lemaire	l eu . m e . l eu
pearson	p i . eo . s eu n
faye	p e . i
greenfield	g eu . l i n . p i l . d eu
dalcroze	d a l . k eu . l o . j eu
miriam	m i . l i . eo m
grosso	g eu . l o . s o
elliott	e l . l i . eo s
port_of_spain	p o . t eu . o . b eu . s eu . p e . i n
bartolommeo	b a . l eu . t o l . l o m . m e . o
heim	h a . i m
wole	wo l . l e
dunkirk	d wi ng . k e . l eu . k eu
eliade	e l . l i . a . d e
desnos	d e . s eu . n o . s eu
tunis	t wi . n i . s eu
freetown	p eu . l i . t a . u n
dvorak	d eu . b o . l eu . j a g
dowling	d a . u l . l i ng
audubon	o . d yu . b o n
leonard	l e . o . n a . d eu
deirdre	d e . eo . d eu . l eu
kaliningrad	k a l . l i . n i n . g eu . l a . d eu
brett	b eu . l e . t eu
sandi	s ae n . d i
boothroyd	b u . s eu . l o . i . d eu
detroit	d i . t eu . l o . i . t eu
charlotte	s ya l . l o . t eu
hegel	h e . g e l
owens	o . eo n . s eu
caceres	k a . s e . l e . s eu
seymour	s e . i . m u . eo
piazzi	p i . a . ch i
logan	l o . g eo n
galle	g a l
collins	k o l . l i n . s eu
utah	yu . t a
chabrier	s ya . b eu . l i . e
hensel	h e n . j e l
sale	s a . l eu
orenburg	o . l e n . b u . l eu . k eu
eggleston	e . g eu l . s eu . t eo n
bing	b i ng
vasilevskaya	b a . s i l . l e . p eu . s eu . k a . ya
blum	b eu l . l eo m
rosetta	l o . j e . t a
ethan	i . d eo n
golgi	g o l . j i
utrillo	yu . t eu . l i l . l o
wayne	we . i n
mohawk	m o . h o . k eu
lamarr	l a . m a
henriquez	e n . l i . k e . s eu
novak	n o . b a g
ochirbat	o . ch i . l eu . b a . t eu
teague	t i . g eu
kondo	k o n . d o
shropshire	s yu . l o b . s yeo
fiennes	p a . i n . j eu
eisenstaedt	a . i . j e n . s eu . t a . t eu
jugnauth	j u . g eu . n o . t eu
vasconcelos	b a . s eu . k o n . s e l . l o . s eu
warren	wo . l eo n
lilian	l i l . l i . a ng
horta	o . l eu . t a
tanzania	t a n . j a . n i . a
brzezinski	b eu . l e . j i n . s eu . k i
tennessee	t e . n e . s i
hermann	h e . l eu . m a n
rosa	l o . j a
brandt	b eu . l a n . t eu
perry	p e . l i
fuentes	p u . e n . t e . s eu
shelley	s ye l . l i
staub	s eu . t a . u b
burrows	b eo . l o . u . j eu
waksman	wa g . s eu . m eo n
hyatt	h a . i . eo s
manuel	m a . n u . e l
ord	o . d eu
chamberlain	ch e . i m . b eo l . l i n
belloc	b e l . l o g
blunden	b eu l . l eo n . d eo n
stakhanov	s eu . tt a . h a . n o . p eu
handel	h e n . d e l
nord	n o . d eu
phil	p i l
cranach	k eu . l a . n a . h eu
meredith	m e . l e . d i . s eu
cukor	k u . k eo
luce	l u . s eu
axel	a g . s e l
borchert	b o . l eu . h e . l eu . t eu
nicky	n i . k i
wittgenstein	b i . t eu . g e n . s yu . t a . i n
dorsey	d o . eo . s i
wesleyan	we . s eu l . l i
kaplan	k ae . p eu l . l a n
rush	l eo . s i
baade	b a . d e
winters	wi n . t eo . s eu
brown	b eu . l a . u n
lindsay	l i n . j i
whitelaw	h wa . i . t eu l . l o
swan	s eu . wa n
spain	s eu . p e . i n
gerd	g e . l eu . t eu
kornfeld	k o n . p i l . d eu
yorkshire	yo . k eu . s yeo
moreira	m o . l e . i . l a
egbert	e . g eu . b eo . t eu
escudero	e . s eu . k u . d e . l o
helene	h e l . l e . n e
gray	g eu . l e . i
lent	l e n . t eu
reid	l i . d eu
lars	l a . l eu . s eu
somerset	s eo . m eo . s i s
giauque	j i . o . k eu
daudet	d o . d e
laurent	l o . l a ng
gamba	g a m . b a
penelope	p e . n e l . l o . p e
santayana	s a n . t a . ya . n a
borodin	b o . l o . d i n
michel	m i . s ye l
octavia	o g . t a . b i . a
athens	a . t e . n e
vinogradoff	b i . n o . g eu . l a . d o . p eu
nimitz	n i . m i . ch eu
helsinki	h e l . s i ng . k i
ruska	l u . s eu . k a
levin	l e . b i n
preston	p eu . l e . s eu . t eo n
johnny	j o . n i
camilla	k a . m i l . l a
ravi	l a . b i
corradi	k o . l a . d i
stodola	s eu . t o . d o . l a
lusaka	l u . s a . k a
bergius	b e . l eu . g i . u . s eu
bujumbura	b u . j u m . b u . l a
blount	b eu l . l a . u . t eu
artsybashev	a . l eu . ch i . b a . s ye . p eu
ferris	p e . l i . s eu
mou	m eo . u
girard	j i . l a . d eu
slobodan	s eu l . l o . b o . d a n
yala	ya l . l a
carter	k a . t eo
bissau	b i . s a . u
hawke	h o . k eu
hassan	h a . s a n
hyde	h a . i . d eu
colman	k o l . m eo n
houssay	u . s a . i
crisp	k eu . l i . s eu . p eu
worthington	wo . s i ng . t eo n
enesco	e . n e . s eu . k o
benson	b e n . s eu n
sol	s o l
suttner	j u . t eu . n eo
lamour	l a . m u . l eu
ciriaco	k eu . l i . a . k o
cochin	k o . ch i n
strasburger	s yu . t eu . l a . s eu . b u . l eu . g eo
herring	h e . l i ng
samoa	s a . m o . a
uruguay	u . l u . g wa . i
strassmann	s yu . t eu . l a . s eu . m a n
ryzhkov	l i . s yu . k o . p eu
ford	p o . d eu
taube	t a . u . b eo
espy	e . s eu . p i
margot	m a . l eu . g o . t eu
leroy	l i . l o . i
jerzy	ye . j i
dobson	d o . b eu . s eu n
bellevue	b e l . l e . b yu
sheffield	s ye . p i l . d eu
malamud	m ae l . l eo . m eo . d eu
dordrecht	d o . l eu . t eu . l e . h i . t eu
walton	wo l . t eo n
haag	h e . i . g eu
wallon	wa l . l o ng
perth	p eo . s eu
ivan	i . b a n
gloucester	g eu l . l o . s eu . t eo
catilina	k a . t i l . l i . n a
gorky	g o . k i
lorna	l o . n a
barthes	b a . l eu . t eu
hendricks	h ae n . d eu . l i g . s eu
schwartz	s yu . wo . ch eu
arnaud	a . l eu . n o
haig	h e . i . g eu
elba	e l . b a
dominic	d o . m i . n i . k eu
ashcroft	ae . s yu . k eu . l o . p eu . t eu
hayes	h e . i . s eu
boulder	b o . u l . d eo
ugo	u . g o
hellman	h e l . m eo n
edel	e . d e l
bromfield	b eu . l o m . p i l . d eu
herschel	h eo . s yeo l
davisson	d e . i . b i . s eu n
jameson	j e . i m . s eu n
luanda	l u . a n . d a
rolando	l o l . l a n . d o
neef	n i . p eu
wheatley	wi . t eu l . l i
bryant	b eu . l a . i . eo n . t eu
carlin	k a l . l i n
grant	g eu . l ae n . t eu
santini	s a ng . t i . n i
port	p o . t eu
chile	ch i l . l e
atal	a . t a l
maillol	m a . yo l
kaj	k a . i
ralph	l ae l . p eu
cyndi	s i n . d i
judea	yu . d ae
friche	p eu . l i . ch e
menelaos	m e . n e l . l a . o . s eu
ponce	p o n . s eu
molly	m o l . l i
bogota	b o . g o . t a
israel	i . s eu . l a . e l
hamlin	h ae m . l i n
daimler	d e . i m . l eo
binding	b i n . d i ng
matthews	m ae . s yu . s eu
heseltine	h e . s eu l . t a . i n
leno	l e . n o
bernauer	b e . l eu . n a . wo
jacksonville	j ae g . s eu n . b i l
metternich	m e . t e . l eu . n i . h i
aberdeen	ae . b eo . d i n
qingxian	ch i ng . s ye n
symons	s i . m eo n . s eu
palgrave	p o l . g eu . l e . i . b eu
sacchetti	s a . k e . t i
izquierdo	i . s eu . k i . e . l eu . d o
napier	n e . i . p i . eo
arcos	a . l eu . k o . s eu
ammon	a . m o n
ricou	l i . k o . u
brindley	b eu . l i n . d eu l . l i
benares	b e . n a . l e . s eu
charlie	ch a l . l i
waltari	b a l . t a . l i
teitelbaum	t a . i . t e l . b a . u m
palikir	p a l . l a . k i . l eu
wood	u . d eu
lutoslawski	l u . t o . s eu l . l a . p eu . s eu . k i
brecht	b eu . l e . h i . t eu
hartle	h a . t eu l
bara	b a . l a
blakeslee	b eu l . l e . i . k eu . s eu l . l i
blanco	b eu l . l a ng . k o
resnick	l u . s eu . n i g
mortimer	m o . t i . m eo
schwitters	s yu . b i . t eo . s eu
phillpotts	p i l . p o . ch eu
andersen	a n . d e . l eu . s e n
jana	j a . n a
nouvel	n u . b e l
chamson	s ya ng . s o ng
guatemala	g wa . t e . m a l . l a
brant	b eu . l a n . t eu
miles	m a . i l . s eu
lowie	l o . wi
parini	p a . l i . n i
page	p e . i . j i
kremer	k eu . l e . m eo
weber	we . b eo
bilal	b i l . l a l
heller	h e l . l eo
unsworth	eo n . s eu . wo . s eu
sluter	s eu l . l wi . t e . l eu
guericke	g e . l i . k e
henning	h e . n i ng
alessandro	a l . l e . s a n . d eu . l o
rada	l a . d a
ricky	l i . k i
bonsels	b o n . j e l . s eu
gauguin	g o . g ae ng
dudley	d eo . d eu l . l i
almqvist	a l . l eu m . k eu . b i . s eu . t eu
pascal	p a . s eu . k a l
bouchard	b u . s ya . l eu
polly	p o l . l i
canova	k a . n o . b a
verne	b e . l eu n
ayala	a . ya l . l a
patty	p ae . t i
lieberman	l i . b eo . m eo n
agassi	ae . g eo . s i
blanc	b eu l . l a ng
korngold	k o n . g o l . d eu
natalia	n a . t a l . l i . a
riverside	l i . b eo . s a . i . d eu
gascoigne	g ae . s eu . k o . i n
grahame	g eu . l e . i . eo m
iliev	i l . l i . ye . p eu
rosalyn	l o . j eo l . l i n
whistler	h wi . s eu l . l eo
sankey	s ae ng . k i
tony	t o . n i
santiago	s a n . t i . a . g o
schultze	s yu l . ch e
wheelock	h wi l . l a g
appenzeller	a . p e n . j e l . l eo
wiley	wa . i l . l i
levi	l i . b a . i
walpole	wo l . p o l
ting	t i ng
chamberlin	ch e . i m . b eo l . l i n
guyau	g wi . yo
deniz	d e . n i . j eu
hatch	h ae . ch i
taunton	t o n . t eo n
kalinin	k a l . l i . n i n
hoyt	h o . i . t eu
bougainville	b u . g eo n . b i l
apelt	a . p e l . t eu
galland	g a l . l a ng
moritz	m o . l i . ch eu
hedge	h e . j i
kusch	k u . s i
malta	m o l . t a
cate	k e . i . t eu
adonis	a . d o . n i . s eu
quito	k i . t o
queens	k wi n . j eu
wallace	wo l . l a . s eu
aptidon	a b . t i . d o n
blackstone	b eu l . l ae g . s eu . t o n
ramstedt	l a m . s eu . t e . t eu
mussolini	m u s . s o l . l i . n i
lyle	l a . i l
arp	a . l eu . p eu
gropius	g eu . l o . p i . u . s eu
orban	o . l eu . b eo n
cartwright	k a . t eu . l a . i . t eu
reade	l i . d eu
amon	a . m o n
tata	t a . t a
dickson	d i g . s eu n
kendrew	k e n . d eu . l u
daniels	d a . n i . e l . j eu
basso	b a . s o
duke	d yu . k eu
jodie	j o . d i
albinoni	a l . b i . n o . n i
silone	s i l . l o . n e
elmer	e l . m eo
cali	k a l . l i
berkshire	b a . k eu . s yeo
negri	n e . g eu . l i
alexander	a l . l e g . s a n . d eu . l eu
christa	k eu . l i . s eu
derbyshire	d eo . b i . s yeo
lyons	l i . yo ng
seattle	s i . ae . t eu l
thatcher	d ae . ch eo
tudor	t u . d o . l eu
reinach	l a . i . n a . h eu
palmiro	p a l . m i . l o
quintana	j i n . t a . n a
nichols	n i . k o l . s eu
swaziland	s eu . wa . j i l . l a n . d eu
smithson	s eu . m i . s eu . s eu n
reilly	l a . i l . l i
durkheim	d wi . l eu . k e m
angle	ae ng . g eu l
bale	b e . i l
balch	b o l . ch i
terrace	t e . l a . s eu
huss	h u . s eu
palma	p a l . m a
osgood	o . s eu . g u s
burt	b eo . t eu
hull	h eo l
lie	l i
silva	s i l . b a
joel	yo . e l
tormod	t o . m o . d eu
pettersson	p e . t eo . s eu n
lex	l e g . s eu
ecker	e . k eo
sinclair	s i ng . k eu l . l e . eo
weder	we . d eo
solovyov	s o l . l o . b i . yo . p eu
cutler	k eo . t eu l . l eo
vinci	b i n . ch i
dicey	d a . i . s i
eames	i m . s eu
fulton	p u l . t eo n
kennedy	k e . n e . d i
flora	p eu l . l o . l a
edison	e . d i . s eu n
anderson	ae n . d eo . s eu n
chavez	ch a . b e . s eu
nascimento	n a . s i . m e n . t u
schiff	s wi . p eu
ingraham	i ng . g eu . l eo . h ae m
blair	b eu l . l e . eo
gretchen	g eu . l e . ch e n
kiefer	k i . p eo
pelegrin	p e l . l e . g eu . l i n
ute	u . t eu
bellow	b e l . l o
kansas	k ae n . j a . s eu
eugenio	e . u . j e . n i . o
dowland	d a . u l . l eo n . d eu
cato	k a . t o
mosca	m o . s eu . k a
rautio	l o . t i . o
suess	j wi . s eu
joffre	j o . p eu . l eu
steinbeck	s eu . t a . i n . b e g
dodds	d o . j eu
buswell	b eo . s eu . we l
dewey	d yu . i
zane	j e . i n
west	we . s eu . t eu
calvin	k a l . b ae ng
nerval	n e . l eu . b a l
lawton	l o . t eo n
jaffna	j a . p eu . n a
ji	j i
wiltshire	wi l . t eu . s yeo
geoffrey	j o . p eu . l i
koenigsberger	k wi . n i . s eu . b eo . g eo
stifter	s yu . t i . p eu . t eo
jongkind	yo ng . k i n . t eu
joachim	yo . a . k i m
constantinescu	k o n . s eu . t a n . t i . n e . s eu . k u
marett	m ae . l eo s
mahaffy	m a . h a . p i
yvette	i . b e . tt eu
rossetti	l o . s e . t i
mindy	m i n . d i
ribera	l i . b e . l a
couto	k o . t u
lean	l i n
burckhardt	b u . l eu . k eu . h a . l eu . t eu
freudenthal	p eu . l o . i . d e n . t a l
messier	m e . s i . e
angeles	e n . j e l . l e . s eu
cates	k e . i . ch eu
nobile	n o . b i l . l e
wieland	b i l . l a n . t eu
menger	m e ng . g eo
klein	k eu l . l a . i n
abdul	a b . d u l
seifert	s a . i . p e . l eu . t eu
polk	p o . k eu
marlowe	m a l . l o
soyinka	s o . i ng . k a
biden	b a . i . d eu n
smedley	s eu . m e . d eu l . l i
carvalho	k a . l eu . b a l . l yo
weinberg	wa . i n . b eo . g eu
dufy	d wi . p i
bart	b a . t eu
kessel	k e . s e l
heintze	h a . i . t eu . ch e
hals	h a l . s eu
wyoming	wa . i . o . m i ng
florey	p eu l . l o . l i
antony	a n . t o . n i
herman	h eo . m eo n
kielland	s ye l . l a n
barbara	b a . b eo . l a
ulanova	u l . l a . n o . b a
matamoros	m a . tt a . m o . l o . s eu
moissan	m u . a . s a ng
pirenne	p i . l e n
irkutsk	i . l eu . k u . ch eu . k eu
synge	s i ng
spaak	s eu . p a . k eu
weidman	wa . i . d eu . m eo n
nicol	n i . k o l
ott	o . t eu
galilei	g a l . l i l . l e . i
arminius	a . l eu . m i . n i . u . s eu
sombart	j o m . b a . l eu . t eu
polo	p o l . l o
kollwitz	k o l . b i . ch eu
torino	t o . l i . n o
mahendra	m a . h e n . d eu . l a
bruce	b eu . l u . s eu
bangui	b a ng . g i
ingram	i ng . g eu . l ae m
alvaro	a l . b a . l o
keon	k i . o n
anfinsen	a n . p i n . s eu n
stephenson	s eu . t i . b eu n . s eu n
dean	d i n
piccinni	p i . ch i n . n i
saavedra	s a . b e . d eu . l a
meyers	m e . i . eo . s eu
fabry	p a . b eu . l i
franz	p eu . l a n . ch eu
hofmann	h o . p eu . m a n
forst	p o . l eu . s eu . t eu
valeri	b a l . l e . l i
poulet	p u l . l e
wesley	we . s eu l . l i
lobo	l o . b o
ray	l e . i
sabri	s a . b eu . l i
kasper	k a . s eu . p eo
yorke	yo . k eu
lowry	l o . l i
alvin	ae l . b i n
goldberg	g o l . d eu . b eo . g eu
cherry	ch e . l i
laird	l e . eo . d eu
sennett	s e . n e s
shevchenko	s ye . p eu . ch e n . k o
gregg	g eu . l e . g eu
mays	m e . i . s eu
castiglione	k a . s eu . t i l . l i . o . n e
adil	a . d i l
barney	b a . n i
sheraton	s ye . l eo . t eo n
ensor	e n . s o . l eu
kruczkowski	k eu . l u . ch i . k o . p eu . s eu . k i
bonnie	b o . n i
branco	b eu . l a ng . k o
domingo	d o . m i ng . g o
gabon	g a . b o ng
sonora	s o . n o . l a
djibouti	j i . b u . t i
piero	p i . e . l o
edmond	e . d eu . m o ng
alison	ae l . l i . s eu n
sayce	s e . i . s eu
jacob	j a . k o b
boveri	b o . b e . l i
sydow	s i . d o
bridgeport	b eu . l i . j i . p o . t eu
demeter	d e . m e . t e . l eu
gusou	g u . ss eo . u
hamburg	h a m . b u . l eu . k eu
esposito	e . s eu . p o . s i . t o
senior	s i . n i . eo
napolitano	n a . p o l . l i . t a . n o
degas	d eu . g a
beardsley	b i . eo . j eu l . l i
vittorini	b i . t o . l i . n i
erastus	e . l a . s eu . t u . s eu
robson	l o b . s eu n
bieber	b i . b eo
kantor	k ae n . t eo
anja	a n . ya
videla	b i . d e l . l a
blackwell	b eu l . l ae g . we l
jouvet	j u . b e
kipling	k i . p eu l . l i ng
derby	d eo . b i
spiegel	s eu . p i . g e l
flynn	p eu l . l i n
vertov	b e . l eu . t o . p eu
stoss	s yu . t o . s eu
schwinger	s yu . wi ng . g eo
mccann	m ae g . k ae n
frankenstein	p eu . l a ng . k e n . s yu . t a . i n
vauvenargues	b o . b eu . n a . l eu . g eu
bernstein	b eo n . s eu . t a . i n
telford	t e l . p o . d eu
juliana	j u l . l i . a . n a
race	l e . i . s eu
schnabel	s yu . n a . b e l
landsteiner	l a n . t eu . s yu . t a . i . n eo
weyl	b a . i l
habib	h a . b i . b eu
nauru	n a . u . l u
frisch	p eu . l i . s yu
louis	l u . i
zak	j ae g
czech	ch e . k o
cauchy	k o . s i
baron	b a . l o n
peccei	p e . ch e . i
bloomberg	b eu l . l u m . b eo . g eu
banks	b ae ng . k eu . s eu
colt	k o l . t eu
kerr	k eo
scala	s eu . k a l . l a
durango	d u . l a ng . g o
vernon	b eo . n o n
fechner	p e . h i . n eo
tegucigalpa	t e . g u . s i . g a l . p a
celeste	s e l . l e . s eu . t eu
unamuno	u . n a . m u . n o
ehrenburg	e . l e n . b u . l eu . g eu
volga	b o l . g a
curtiz	k eo . t i . s eu
hertford	h a . t eu . p eo . d eu
hyderabad	h a . i . d e . l a . b a . d eu
couplet	k u . p eu l . l e
monod	m o . n o
hoel	h o . e l
carpenter	k a . p e n . t eo
herrick	h e . l i g
severin	s e . b eo . l i n
harden	h a . d eu n
tomsk	t o m . s eu . k eu
acton	ae g . t eu n
planck	p eu l . l a ng . k eu
foreman	p o . m eo n
clara	k eu l . l a . l a
vince	b i n . s eu
silvestre	s i l . b e . s eu . t eu . l eu
gustav	g u . s eu . t a . b eu
bouvet	b o . b i s
popov	p o . p o . p eu
berzelius	b e . l eu . s e l . l i . u . s eu
jan	ya n
caucasus	k o . k a . s eo . s eu
gladkov	g eu l . l a s . k o . p eu
baumgarten	b a . u m . g a . l eu . t e n
midas	m i . d a . s eu
souza	s u . j a
kok	k o . k eu
hasenclever	h a . j e n . k eu l . l e . b eo
iberia	i . b e . l i . a
susan	s u . j a n
smellie	s eu . m e l . l i
paramaribo	p a . l a . m a . l i . b o
gillespie	g i l . l e . s eu . p i
brightman	b eu . l a . i . t eu . m a n
matthew	m a . t ae
hopper	h o . p eo
maguire	m ae g . g wa . i . eo
whitaker	h wi . t ae . k eo
michie	m i . ch i . e
lesotho	l e . s o . t o
cleve	k eu l . l e . b e
jobim	j o . b i m
loftus	l o . p eu . t eo . s eu
rosemary	l o . j eu . m e . l i
trudeau	t eu . l wi . d o
springsteen	s eu . p eu . l i ng . s eu . t i n
errol	e . l eo l
ouagadougou	wa . g a . d u . g u
reiners	l a . i . n eo . j eu
ortiz	o . l eu . t i . s eu
sert	s eo . t eu
agrippa	a . g eu . l i . p a
kirpichnikov	k i . l eu . p i . ch i . n i . k o . p eu
peck	p e g
bauer	b a . u . eo
erasmus	e . l a . s eu . m u . s eu
bastian	b a . s eu . t i . a n
cresson	k eu . l e . s o ng
burgundy	b u . l eu . g o . n yu
cruz	k eu . l u . s eu
emily	e . m i l . l i
wyler	wa . i l . l eo
shields	s wi l . d eu
lugar	l u . g a
turkey	t eo . k i
sheila	s wi l . l a
poe	p o
werth	we l . s eu
hearn	h o n
camilo	k a . m i l . l o
gomulka	g o . m u . u . k a
steele	s eu . t i l
buisson	b wi . s o ng
nick	n i g
watkins	wa s . k i n . s eu
reggie	l e . j i
maccoby	m ae . k o . b i
kram	k eu . l ae m
savio	s a . b i . o
golden	g o l . d eu n
hering	h e . l i ng
albo	ae l . b o
ustinov	yu . s eu . t i . n o . p eu
gough	g o . p u
thorpe	s o . p eu
antunes	a n . t u . n e . s eu
ezra	e . s eu . l a
navarre	n a . b a . l eu
taglioni	t a l . l i . o . n i
guggenheim	g u . g e n . h a . i m
jude	yu . d a
muirhead	m yu . eo . h e . d eu
pearl	p eo l
marianne	m a . l i . a n . n eu
dobrolyubov	d o . b eu . l u l . l yu . b o . p eu
porto_novo	p o . l eu . t o . n o . b o
grimm	g eu . l i m
gonzalez	g o n . s a l . l e . s eu
burger	b eo . g eo
primakov	p eu . l i . m a . k o . p eu
wise	wa . i . j eu
ridley	l i . d eu l . l i
mongolia	m o ng . g o
montero	m o n . t e . l o
panama	p a . n a . m a
mcguire	m ae g . g wa . i . eo
gertrude	g e . l eu . t eu . l u . d eu
giulio	j u l . l i . o
johnnie	j o . n i
kutter	k u . t eo
beard	b i . eo . d eu
albani	a l . b a . n i
coiter	k o . i . t eo
ekaterina	ye . k a . t e . l i . n a
mount	m a . u n . t eu
lennox	l e . n o g . s eu
utrecht	wi . t eu . l e . h eu . t eu
hopkins	h o b . k i n . s eu
heisenberg	h a . i . j e n . b e . l eu . k eu
behring	b e . l i ng
zaragoza	s a . l a . g o . s a
geulincx	g oe l . l i ng . k eu . s eu
isler	a . i . s eu l . l eo
villon	b i . yo ng
audrey	o . d eu . l i
eliana	e l . l i . a . n a
turgot	t wi . l eu . g o
jon	yo n
hutchins	h eo . ch i n . s eu
locke	l o g
pattani	p a . t a . n i
schrieffer	s yu . l i . p eo
merriman	m e . l i . m eo n
jansky	j ae n . s eu . k i
fanning	p ae . n i ng
ambrose	ae m . b eu . l o . j eu
russel	l eo . s e l
downs	d a . u n . s eu
wagner	b a . g eu . n eo
fontane	p o n . t a . n e
erick	e . l i g
tura	t u . l a
danforth	d ae n . p o . s eu
maupertuis	m o . p e . l eu . t wi . i
campra	k a ng . p eu . l a
husserl	h u . s eo l
ramirez	l a . m i . l e . j eu
muzio	m u . ch i . o
kaunda	k a . u n . d a
ullman	u l . m a n
belize	b e l . l i . j eu
giancarlo	j i . a n . k a . l eu l . l o
camper	k a m . p e . l eu
haldane	h o l . d e . i n
arthur	a . l eu . t u . l eu
dolphin	d o l . p i n
hertwig	h e . l eu . t eu . b i . h i
carnarvon	k a . n a . b o n
veblen	b e . b eu l . l eo n
eric	e . l i g
kilby	k i l . b i
lippi	l i . p i
noyce	n o . i . s eu
potyomkin	p o . t yo m . k i n
mackintosh	m ae . k i n . t o . s i
cueva	k u . e . b a
aurelia	o . l e l . l i . a
mobile	m o . b a . i l
lockett	l o . k e s
anaheim	ae . n eo . h a . i m
gravatt	g eu . l a . b a . t eu
addington	ae . d i ng . t eo n
prata	p eu . l a . t a
chipman	ch i . p eu . m eo n
xenakis	k eu . s e . n a . k i . s eu
mildred	m i l . d eu . l e . d eu
toscanelli	t o . s eu . k a . n e l . l i
nossack	n o . s a . k eu
todd	t o . d eu
justin	j eo . s eu . t i n
garnet	g a . a . n e s
alejandro	a l . l e . h a n . d eu . l o
feldstein	p e l . d eu . s eu . t a . i n
lipton	l i b . t eo n
scherman	s ye . l eu . m a n
johnson	yo n . s o n
lugo	l u . g o
neverov	n e . b e . l o . p eu
cronaca	k eu . l o . n a . k a
nunn	n eo n
bush	b u . s i
roque	l o . k e
hubert	wi . b e . l eu
nahum	n a . h u m
dodson	d a s . s eu n
appleton	ae . p eu l . t eo n
turkmenistan	t u . l eu . k eu . m e . n i . s eu . t a n
barranquilla	b a . l a ng . k i . ya
welhaven	b e l . h a . b e n
mackinder	m ae . k i n . d eo
makin	m a . k i n
humphreys	h eo m . p eu . l i . s eu
gandhi	g a n . d i
andorra	a n . d o . l a
carroll	k ae . l o l
appia	a . p i . a
sokoloff	s o . k o l . l o . p eu
wolsey	u l . j i
hobhouse	h o b . h a . u . s eu
elie	e l . l i
denver	d e n . b eo
goldin	g o l . d i n
segal	s i . g a l
verona	b e . l o . n a
lippmann	l i . p eu . m a n
arena	a . l e . n a
oliver	o l . l i . b eo
goldoni	g o l . d o . n i
wolfrum	wo l . p eu . l eo m
negroponte	n e . g eu . l o . p o n . t e
sorge	s o . l eu . j u
tippett	t i . p e s
hammond	h ae . m o n . d eu
vento	b e n . t o
fernand	p e . l eu . n a ng
lautner	l o . t eu . n eo
lahore	l a . h o . l eu
delane	d i l . l e . i n
nagel	n a . g e l
dickinson	d i . k i n . s eu n
bland	b eu l . l ae n . d eu
dewar	d yu . eo
lombardy	l o m . b a . l eu . d i . a
ephesus	e . p e . s u . s eu
nico	n i . k o
bains	b e . i n . j eu
natorp	n a . t o . l eu . p eu
hofer	h o . p eo
pinto	p i n . t o
halls	h o l . s eu
wien	b i n
arroyo	a . l o . yo
stanley	s eu . t ae n . l i
voight	b o . i . t eu
barnet	b a . n e s
edvard	e . d eu . b a . l eu
bethlehem	b e . d eu l . l e . h e m
alfieri	a l . p i . e . l i
odets	o . d e . ch eu
mats	m ae . ch eu
joshua	yeo . h o . s u . a
lombroso	l o m . b eu . l o . s o
jidda	j i . d a
ethiopia	e . t i . o . p i . a
gorter	g o . l eu . t e . l eu
malaysia	m a l . l e . i . s i . a
ricken	l i . k e n
georgia	g eu . l u . j i . a
mendoza	m e n . d o . j a
kone	k o . n e
antwerp	ae n . t eu . wo . p eu
kinck	k i ng . k eu
george	g e . o . l eu . g e
yogi	yo . g i
riemenschneider	l i . m e n . s yu . n a . i . d eo
monnier	m o . n i . e
magyar	m a . j a . l eu
count	k a . u n . t eu
jamestown	j e . i m . s eu . t a . u n
cartan	k a . l eu . t a ng
salim	s a l . l i m
lama	l a . m a
jacobi	ya . k o . b i
souter	s u . t eo
fleet	p eu l . l i . t eu
basie	b e . i . s i
sarton	s a . t eo n
gadda	g a . d a
hebrides	h e . b eu . l i . d i . s eu
monk	m eo ng . k eu
celan	ch e l . l a n
britt	b eu . l i s
ide	i . d eu
gokhale	g o . k a l . l e
dix	d i g . s eu
samir	s a . m i . l eu
ohio	o . h a . i . o
haworth	h a . s eu
gaye	g e . i
noverre	n o . b e . l eu
catania	k a . t a . n i . a
rubio	l u . b i . o
jens	ye n . s eu
light	l a . i . t eu
kalimantan	k a l . l i . m a n . t a n
gleysteen	g eu l . l a . i . s eu . t i n
bergen	b e . l eu . g e n
waters	wo . t eo . s eu
reischauer	l a . i . s ya . wo
pottinger	p o . t i n . j eo
heckler	h e . k eu l . l eo
koirala	k o . i . l a l . l a
cuthbert	k eo . s eu . b eo . t eu
edgar	e . d eu . g a . l eu
duclos	d wi . k eu l . l o
winch	wi n . ch i
giuliani	j u l . l i . a . n i
hines	h a . i n . j eu
eunice	yu . n i . s eu
donat	d o . n a . t eu
terry	t e . l i
pisanello	p i . s a . n e l . l o
ling	l i ng
carlo	k a . l eu l . l o
porter	p o . t eo
sanz	s a n . s eu
zeno	j e . n o n
marcus	m a . l eu . k u . s eu
sabina	s a . b i . n a
reginald	l e . j eo . n eo l . d eu
abell	a . b e l
ramsey	l ae m . j i
bodo	b o . d o
tomas	t o . m a . s eu
chain	ch e . i n
pott	p o . t eu
canto	k a n . t o
beatrice	b e . a . t eu . l i . s eu
paxton	p ae g . s eu . t eo n
virginia	b eo . j i . n i . a
klemperer	k eu l . l e m . p e . l eo
avery	e . b eo . l i
blass	b eu . l e . s eu
luciano	l u . ch i . a . n o
defoe	d i . p o
anzengruber	a n . ch e n . g eu . l u . b eo
suffolk	s eo . p eo g
boer	b o . eo
kolja	k o l . l i . ya
latham	l e . i . d a m
mata	m a . t a
saxon	s ae g . s eu n
josep	h o . s e b
kanpur	k a n . p u . l eu
luchino	l u . k i . n o
lebanon	l e . b a . n o n
gelsenkirchen	g e l . j e n . k i . l eu . h e n
bothe	b o . t e
simpson	s i n . p eu . s eu n
herta	h e . l eu . t a
rabat	l a . b a . t eu
vesaas	b e . s o . s eu
verlaine	b e . l eu l . l e n
perrin	p e . l ae ng
polanyi	p o l . l a . n i
ryan	l a . i . eo n
northcliffe	n o . s eu . k eu l . l i . p eu
ferrara	p e . l a . l a
sebastian	s eo . b ae . s eu . ch eo n
thomsen	t o m . s e n
wharton	wa . t eu n
elizabeth	e l . l i . j a . b e . s eu
bosworth	b o . j eu . wo . s eu
lot	l o s
edith	e . d i . t eu
feuchtwanger	p o . i . h i . t eu . b a ng . g eo
issabel	i . j a . b e l
condo	k o n . d o
anne	a n . n e
milos	m i l . l o . s eu
bruant	b eu . l wi . a ng
yvon	i . b o ng
obrecht	o . b eu . l e . h i . t eu
hamilton	h ae . m i l . t eo n
horn	h o . l eu n
skryabin	s eu . k eu . l ya . b i n
peron	p e . l o n
kellogg	k e l . l o . g eu
morton	m o . t eo n
rodenbach	l o . d e n . b a . h eu
hofstadter	h o . p eu . s eu . t ae . t eo
jennings	j e . n i ng . s eu
mike	m a . i . k eu
maputo	m a . p u . t o
gras	g eu . l a . s eu
ker	k eo
cecchetti	ch e . k e . t i
doisy	d o . i . j i
lancaster	l ae ng . k eo . s eu . t eo
herne	h e . l eu . n e
voigt	p o . k eu . t eu
konrad	k o n . l a . t eu
mai	m a . i
torrens	t o . l eo n . s eu
diller	d i l . l eo
krzysztof	k eu . s i . s yu . t o . p eu
hamm	h a m
pino	p i . n o
forester	p o . l e . s eu . t eo
loren	l o . l e n
algiers	a l . j e
hacks	h a g . s eu
twardowski	t eu . wa . l eu . d o . p eu . s eu . k i
raven	l e . i . b eu n
phelps	p e l . p eu . s eu
perrault	p e . l o
ashley	ae . s yu l . l i
gattuso	g a . t u . s o
ingenhousz	i ng . g e n . h o . u . s eu
maior	m a . i . o . l eu
arther	a . s eo
hoche	o . s yu
hugh	h yu
maki	m a . k i
lyell	l a . i . e l
scheler	s ye l . l eo
christ	g u . s e . j u
dawson	d o . s eu n
loewe	l oe . b e
zeman	j e . m a n
donen	d o . n eo n
masur	m a . j u . eo
malcolm	m ae l . k eo m
deaver	d i . b eo
gurley	g eo l . l i
canaro	k a . n a . l o
kamen	k e . i . m eo n
diesel	d i . j e l
mencken	m e ng . k e n
madsen	m ae . d eu . s eu n
feinberg	p a . i n . b eo . g eu
gephardt	g e . p a . t eu
rakhmaninov	l a . h eu . m a . n i . n o . p eu
siegen	j i . g e n
dario	d a . l i . o
huntsville	h eo n . ch eu . b i l
verrocchio	b e . l o . k i . o
knies	k eu . n i . s eu
sal	s a l
alexis	a l . l e g . s i
indianapolis	i n . d i . ae . n a . p o l . l i . s eu
stoyanov	s eu . t o . ya . n o . p eu
lomonosov	l o . m o . n o . s o . p eu
walter	b a l . t eo
hans	h a n . s eu
lynd	l i n . d eu
reading	l e . d i ng
noronha	n o . l o . n ya
milo	m i l . l o
kapp	k a . p eu
sakharov	s a . h a . l o . p eu
red	l e . d eu
wanda	wa n . d a
ockeghem	o . k e . g e m
sylvia	s i l . b i . a
gibbon	g i . b eo n
flaxman	p eu l . l ae g . s eu . m eo n
bianco	b i . a n . k o
albano	a l . b a . n o
jacqueline	j ae . k eu l . l i n
masters	m a . s eu . t eo . s eu
felder	p e l . d eo
henk	h e ng . k eu
helmholtz	h e l . l eu m . h o l . ch eu
carmichael	k a . m a . i . k eu l
ancona	a n . k o . n a
makarov	m a . k a . l o . p eu
hinshelwood	h i n . s yeo l . u . d eu
acapulco	a . k a . p u l . k o
alfonsin	a l . p o n . s i n
montpelier	m o n . t eu . p i l . l i . eo
doherty	d o . h eo . t i
burbank	b eo . b ae ng . k eu
romania	l u . m a . n i . a
lipmann	l i . p eu . m eo n
macedonia	m a . k e . d o . n i . a
sperling	s eu . p eo l . l i ng
montreuil	m o ng . t eu . l eu . yu
heinz	h a . i n . ch eu
jade	j e . i . d eu
barone	b a . l o . n e
donaldson	d o . n a l . d eu . s eu n
manchester	m ae n . ch e . s eu . t eo
portinari	p o . l eu . t i . n a . l i
ernest	eo . n i . s eu . t eu
gleim	g eu l . l a . i m
cremer	k eu . l i . m eo
alban	a l . b a n
brodsky	b eu . l o . d eu . s eu . k i
dembinski	d e m . b i n . s eu . k i
philadelpia	p i l . l a . d e l . p i . a
alberta	a l . b a . t a
southey	s a . u . d i
clapton	k eu l . l ae b . t eu n
eustachio	yu . s eu . t a . k i . o
greenspan	g eu . l i n . s eu . p eo n
jonsson	j o n . s eu n
trier	t eu . l i . eo
woodworth	u . d eu . wo . s eu
felice	p e l . l i . s eu
violet	b a . i . o l . l e s
littleton	l i . t eu l . t eo n
coleridge	k o l . l i . j i
diana	d i . a . n a
cornelio	k o . l eu . n e l . l i . o
prescott	p eu . l e . s eu . k eo s
wisconsin	wi . s eu . k o n . s i n
omar	o . m a
sami	s a . m i
opitz	o . p i . ch eu
cigna	s i . g eu . n a
simrock	j i m . l o . k eu
carpentier	k a . l eu . p e n . t i . e . l eu
rio	l i . u
mecklenburg	m e . k eu l . l e n . b u . l eu . k eu
kuhn	k u n
del	d e l
lum	l eo m
kemble	k e m . b eu l
bolzano	b o l . ch a . n o
mercator	m e . l eu . k a . t o . l eu
gaultier	g o . t i . e
graaf	g eu . l a . p eu
samarkand	s a . m a . l eu . k a n . t eu
newton	n yu . t eo n
brennan	b eu . l e . n eo n
berenson	b e . l eo n . s eu n
rosetti	l o . s e . t i
dallas	d ae l . l eo . s eu
schott	s yo . t eu
ioffe	yo . p e
dalin	d a l . l i n
stowe	s eu . t o
varga	b a . l eu . g a
solvay	s o l . b e . i
arghezi	a . l eu . g e . j i
frederik	p eu . l e . d e . l i . k eu
johnstown	j o n . s eu . t a . u n
tyndale	t i n . d eu l
haskell	h a . s eu . k e l
allen	ae l . l eo n
antananarivo	a n . t a . n a . n a . l i . b o
namibia	n a . m i . b i . a
stockman	s eu . t o . k eu . m eo n
lyly	l i l . l i
strafford	s eu . t eu . l ae . p eo . d eu
giraudoux	j i . l o . d u
bath	b a . s eu
muris	m yu . l i . s eu
mueller	m yu l . l eo
magdeburg	m a . g eu . d e . b u . l eu . k eu
rucker	l eo . k eo
grigorovich	g eu . l i . g o . l o . b i . ch i
alva	a l . b a
leicester	l e . s eu . t eo
macmillan	m ae g . m i l . l a n
drinkwater	d eu . l i ng . k eu . wo . t eo
most	m o . s eu . t eu
banda	b a n . d a
stalin	s eu . t a l . l i n
schumann	s yu . m a n
doppler	d o . p eu l . l eo
chandler	ch ae n . d eu l . l eo
bunche	b eo n . ch i
sommerfield	s eo m . m eo . p i l . d eu
bernal	b eo . n eo l
sazonov	s a . j o . n o . p eu
rudi	l u . d i
auriol	o . l i . o l
chamai	ch a . m a . i
northrop	n o . s eu . l eo b
charleston	ch a l . s eu . t eo n
baldwin	b o l . d eu . wi n
cudworth	k eo . d eu . wo . s eu
copernicus	k o . p e . l eu . n i . k u . s eu
waterloo	wo . t eo l . l u
clive	k eu l . l a . i . b eu
peyton	p e . i . t eu n
kessler	k e . s eu l . l eo
georgi	g e . o . l eu . g i
remy	l e . m i
gabriele	g a . b eu . l i . e l . l e
amber	ae m . b eo
quant	k wo n . t eu
achilles	a . k i l . l e . s eu
sperry	s eu . p e . l i
sobrero	s o . b eu . l e . l o
picasso	p i . k a . s o
birch	b eo . ch i
casella	k a . s e l . l a
malkin	m a l . k i n
chelmsford	ch e l . l eu m . s eu . p eo . d eu
yitzhak	i . ch eu . h a . k eu
gail	g e . i l
savoie	s a . b u . a
homer	h o . m eo
turco	t u . l eu . k o
balzac	b a l . j a . k eu
zoran	j o . l a n
ames	e . i m . s eu
varela	b a . l e . l a
darko	d a . l eu . k o
augustus	a . u . g u . s eu . t u . s eu
coker	k o . k eo
nolde	n o l . d e
forlani	p o l . l a . n i
enver	e n . b e . l eu
buckley	b eo . k eu l . l i
zamboni	j a m . b o . n i
schmitz	s yu . m i . ch eu
feetham	p i . s ae m
goethals	g o . s eo l . s eu
uccello	u . ch e l . l o
laurens	l o . l a ng . s eu
masson	m a . s o ng
moyse	m o . i . j eu
vijay	b i . j e . i
zahn	j ae n
aitken	e . i . k i n
sofia	s o . p i . a
clough	k eu l . l a . p eu
din	d i n
law	l o
clearwater	k eu l . l i . eo . wo . t eo
norman	n o . l eu . m a n
guldberg	g u l . d eu . b e . l eu . g eu
habermas	h a . b eo . m a . s eu
dobriansky	d o . b eu . l i . eo n . s eu . k i
giorgio	j o . l eu . j o
helmut	t eu
negro	n i . g eu . l o
scorsese	s eu . k o l . s e . i . j i
kirsch	k i . l eu . s wi
tahiti	t a . h i . t i
malebranche	m a l . b eu . l a ng . s yu
huntington	h eo n . t i ng . t eo n
matisse	m a . t i . s eu
rey	l e . i
janusz	ya . n u . s i
maupassant	m o . p a . s a ng
louisiana	l u . i . j i . ae . n a
gillette	j i l . l e s
bessemer	b e . s e . m eo
bok	b o g
cossa	k o . s a
haydn	h a . i . d eu n
avraham	a . b eu . l a . h a m
elgin	e l . g i n
dahl	d a l
brady	b eu . l ae . d i
kostov	k o . s eu . t o . p eu
nicholas	n i . k o l . l a . s eu
hofmeister	h o . p eu . m a . i . s eu . t eo
eisenstadt	a . i . j e n . s yu . t a . t eu
lina	l i . n a
tamm	t a m
heckman	h e . k eu . m eo n
westwood	we . s eu . t eu . u . d eu
potts	p o . ch eu
farouk	p a . l u . k eu
ferdianand	p e . l eu . d i . n a n . d eu
brisbane	b eu . l i . j eu . b eo n
rawlings	l o l . l i ng . s eu
haeckel	h e . k e l
featherstone	p i . d eo . s eu . t o n
poisson	p u . a . s o ng
marlon	m a l . l o n
gaitskell	g e . i . ch eu . k e l
holmes	h o m . s eu
kristin	k eu . l i . s eu . t i n
ambler	ae m . b eu l . l eo
erhard	e . l eu . h a . l eu . t eu
keiser	k a . i . j eo
mal	m a l
pippin	p i . p i n
bowyer	b a . u . eo
proust	p eu . l u . s eu . t eu
altman	o l . t eu . m eo n
faust	p a . u . s eu . t eu
bering	b e . l i ng
sweden	s eu . we . d e n
barry	b ae . l i
frankfurt	p eu . l a ng . k eu . p u . l eu . t eu
drexler	d eu . l e g . s eu l . l eo
helm	h e l . l eu m
topelius	t o . p e l . l i . u . s eu
garry	g e . l i
schreker	s yu . l e . k eo
rudy	l u . d i
gibbons	g i . b eo n . s eu
byron	b a . i . l eo n
pozzo	p o . j o
kemp	k e m . p eu
ioan	i . o . a n
hanslick	h a n . s eu l . l i . k eu
maxim	m ae g . s i m
belcher	b e l . ch eo
perkins	p eo . k i n . s eu
eleanor	e l . l i . n eo
gouled	g u l . l e . d eu
lacombe	l a . k o m
hugo	wi . g o
rob	l o b
dubcek	d u . b eu . ch e . k eu
ephraim	e . p eu . l a . i m
corbin	k o . b i n
christoph	k eu . l i . s eu . t o . p eu
boston	b o . s eu . t eo n
hill	h i l
freytag	p eu . l a . i . t a . k eu
gallagher	g ae l . l eo . g eo
burgess	b eo . j i . s eu
pitman	p i . t eu . m eo n
chambers	ch e . i m . b eo . s eu
drozdova	d eu . l o . j eu . d o . b a
eamon	e . i . m eo n
gromaire	g eu . l o . m e . l eu
ante	a n . t e
bast	b a . s eu . t eu
claudius	k eu l . l a . u . d i . u . s eu
pupin	p u . p i n
ethel	e . d e l
luke	l u g . k eu
kivi	k i . b i
clausen	k eu l . l o . j e n
witz	b i . ch eu
lyon	l i . o ng
hasler	h a . s eu l . l eo
guadalupe	g wa . d a l . l u . p e
merton	m eo . t eu n
chantal	s ya n . t a l
abbe	a . b e
shoemaker	s yu . m e . i . k eo
olaf	o l . l a . p eu
fontana	p o n . t a . n a
eminescu	e . m i . n e . s eu . k u
voroshilov	b o . l o . s i l . l o . p eu
chautemps	s yo . t a ng
nansen	n a n . s e n
edouard	e . d u . a . l eu
patti	p ae . t i
mandel	m ae n . d e l
longfellow	l o ng . p e l . l o
kapitsa	k a . p i . ch a
pavlov	p a . b eu l . l o . p eu
waterbury	wo . t eo . b e . l i
roux	l u
tucci	t u . ch i
binoche	b i . n o . s yu
kauffmann	k a . u . p eu . m a n
beverly	b i . b eo . l i
eriksson	e . l i g . s o n
montesquieu	m o ng . t e . s eu . k i . oe
kerschensteiner	k e . l eu . s ye n . s yu . t a . i . n eo
bayer	b a . i . eo
gesner	g e . s eu . n eo
jonson	j o n . s eu n
frederick	p eu . l e . d e . l i g
hilferding	h i l . p eo . d i ng
gamble	g ae m . b eu l
hesse	h e . s e
bode	b o . d e
mousa	m u . s a
petrus	b e . d eu . l o
titus	d i . d o . s eo
dunn	d eo n
perrier	p e . l i . e
colonna	k o l . l o n . n a
guinea	g i . n i
ponchielli	p o n . k i . e l . l i
perez	p e . l e . j eu
allende	a . ye n . d e
aslan	a . s eu l . l a n
sumarokov	s u . m a . l o . k o . p eu
watts	wa . t eu
bracton	b eu . l ae g . t eo n
sharif	s ya . l i . p eu
waage	b o . g e
vic	b i g
kellermann	k e l . l eo . m a n
holz	h o l . ch eu
beck	b e g
dorothy	d o . l o . s i
julia	j u l . l i . a
ariosto	a . l i . o . s eu . t o
grenada	g eu . l e . n a . d a
carnap	k a . l eu . n a b
iskandar	i . s eu . k a n . d a l
corsica	k o . l eu . s i . k a
cabrera	k a . b eu . l e . l a
krogh	k eu . l o . g eu
pisa	p i . s a
chernenko	ch e . l eu . n e n . k o
becker	b e . k eo
carole	k ae . l o l
yvonne	i . b o n . n eu
thiers	t i . e . l eu
ob	o . b eu
madrid	m a . d eu . l i . d eu
alexander	a l . l e g . s a n . d eo
chippendale	ch i . p e n . d e . i l
fernandez	p e . l eu . n a n . d e . s eu
zeyer	jj eo . ye . eo l
feynman	p a . i n . m eo n
grossman	g eu . l o . s eu . m eo n
bishkek	b i . s yu . k e . k eu
zeeland	j e l . l a n . d eu
bluff	b eu l . l eo . p eu
noto	n o . t o
larsson	l a . l eu . s o n
abilene	ae . b i l . l i n
sid	s i . d eu
pevsner	p e . p eu . s eu . n eo
vigano	b i . g a . n o
sor	s o . l eu
poli	p o l . l i
sienkiewicz	s ye ng . k i . e . b i . ch i
hume	h yu m
truman	t eu . l u . m eo n
edi	e . d i
peggy	p e . g i
sidney	s i . d eu . n i
paolo	p a . o l . l o
edmund	e . d eu . m eo n . d eu
helga	h e l . g a
rietveld	l i . t eu . b e l . t eu
alfons	a l . p o n . s eu
schneider	s yu . n a . i . d eo
namur	n a . m u . l eu
renault	l eu . n o
xavier	j a . b i . e . l eu
jenny	j e . n i
sommer	j o . m eo
kigali	k i . g a l . l i
dodd	d a . d eu
palme	p a l . m e
poiseuille	p o . a . j eu . i . yu
lesser	l e . s eo
lana	l a . n a
sherriff	s ye . l i . p eu
stuart	s eu . t yu . eo . t eu
antonescu	a n . t o . n e . s eu . k u
norton	n o . t eo n
alder	a l . d eo
entebbe	e n . t e . b e
lennart	l e n . n a . l eu . t eu
georgina	j o . l eu . j i . n a
everhart	e . b eo . h a . t eu
ware	we . eo
rachel	l a . h e l
babs	b a b . s eu
dodge	d a . j i
simic	s i . m i . ch i
melanie	m e l . l a . n i
lourdes	l u . l eu . d eu
waterford	wo . t eo . p eo . d eu
glenda	g eu l . l e n . d a
leone	l e . o . n e
brunei	b eu . l u . n a . i
hopp	h o . p eu
karen	k a . l e n
grekov	g eu . l e . k o . p eu
hedy	h e . d i
wyatt	wa . i . eo s
laurie	l o . l i
zhdanov	j u . d a . n o . p eu
warga	wa . g a
muskogee	m u . s eu . k o . g i
beauvoir	b o . b u . a . l eu
hemingway	h e . m i ng . we . i
abercromby	ae . b eo . k eu . l o m . b i
roberto	l o . b e . l eu . t o
angelo	a n . j e l . l o
armando	a . l eu . m a n . d o
whitehead	h wa . i . t eu . h e . d eu
vieuxtemps	b i . oe . t a ng
earle	eo l
stokes	s eu . t o . k eu . s eu
raj	l a . j i
brundage	b eu . l eo n . d i . j i
alma	a l . m a
blackett	b eu l . l ae . k i s
cadiz	k a . d i . s eu
beverley	b e . b eo l . l i
guardini	g wa . l eu . d i . n i
balenciaga	b a l . l e n . s i . a . g a
amontons	a . m o ng . t o ng
welty	we l . t i
kemal	k e . m a l
cambridge	k e . i m . b eu . l i . j i
pirelli	p i . l e l . l i
karajan	k a . l a . ya n
brock	b eu . l o g
edna	e . d eu . n a
bushman	b u . s i . m eo n
josephine	j o . s e . p i n
lilli	l i l . l i
manrique	m a n . l i . k e
johan	yo . h a n
mistral	m i . s eu . t eu . l a l
lundberg	l u n . d eu . b e . l i
tan	t a n
galtung	g a l . t u ng
manuela	m a . n u . e l . l a
chandrasekhar	ch a n . d eu . l a . s e . k a . l eu
loewi	l oe . b i
danieli	d a . n i . e l . l i
milan	m i l . l a . n o
frances	p eu . l ae n . s i . s eu
ryszard	l i . s eu . j a . d eu
kruger	k eu . l wi . g eo
newlands	n yu . l ae n . j eu
saran	s a . l a n
kohn	k o n
menon	m e . n o n
mendes	m e n . d e . s eu
ionesco	i . o . n e . s eu . k o
falkland	p o . k eu l . l ae n . d eu
donnay	d o . n e
capra	k ae . p eu . l a
akron	ae . k eu . l eo n
hasse	h a . s e
wilhelm	b i l . h e l . l eu m
gottlieb	g o . t eu l . l i . b eu
heiberg	h e . i . b e . l eu . g eu
eberhard	e . b e l . h a . l eu . t eu
brockman	b eu . l o . k eu . m a n
damon	d e . i . m eo n
frantisek	p eu . l a n . t i . s e g
seamus	s ye . i . m eo . s eu
heckel	h e . k e l
krasheninnikov	k eu . l a . s ye . n i n . n i . k o . p eu
saunders	s eo n . d eo . s eu
portsmouth	p o . ch eu . m eo . s eu
youngstown	yeo ng . s eu . t a . u n
norbert	n o . l eu . b e . l eu . t eu
chaucer	ch o . s eo
maxine	m ae g . s i n
piranesi	p i . l a . n e . s i
amiens	a . m i . ae ng
dekker	d e . k eo
galvani	g a l . b a . n i
fridtjof	p eu . l i . d eu . s yo . p eu
bailey	b e . i l . l i
gabrielle	g a . b eu . l i . e l
steinheil	s yu . t a . i n . h a . i l
bliss	b eu l . l i . s eu
kyd	k i . d eu
aldington	o l . d i ng . t eo n
kinnear	k eo . n i . eo
michigan	m i . s i . g a n
jeanne	j a n
parish	p ae . l i . s wi
rockingham	l a g . k i ng . h ae m
swift	s eu . wi . p eu . t eu
gago	g a . g o
hay	h e . i
lillian	l i l . l i . eo n
lothar	l o . t a . eo
gleizes	g eu l . l e . i . j eu
kaye	k e . i
korn	k o n
blythe	b eu l . l i . d eu
clemens	k eu l . l e . m e n . s eu
visconti	b i . s eu . k o n . t i
bostic	b o . s eu . t i g
caprivi	k a . p eu . l i . b i
freiburg	p eu . l a . i . b u . l eu . k eu
griffis	g eu . l i . p i . s eu
mander	m a n . d e . l eu
crawford	k eu . l o . p eo . d eu
card	k a . d eu
colmar	k o l . m a . l eu
moseley	m o . j eu l . l i
habakkuk	h a . b a g . g u g
jepsen	j e . p eu . s eu n
ehrlich	e . l eu l . l i . h i
maseru	m a . s e . l u
dali	d a l . l i
laforgue	l a . p o . l eu . g eu
lim	l i m
sickingen	j i . k i ng . g e n
lissajous	l i . s a . j u
denmark	d e n . m a . k eu
nachtigal	n a . h eu . t i . g a l
floyd	p eu l . l o . i . d eu
servais	s e . l eu . b e
lewin	l e . b i n
dawkins	d o . k i n . s eu
diane	d a . i . a n
carducci	k a . l eu . d u . ch i
barton	b a . t eo n
shaftesbury	s yae . p eu . ch eu . b e . l i
carrillo	k a . l i l . l o
oakeshott	o . k eu . s yeo . t eu
bergman	b eo . g eu . m eo n
asser	a . s e . l eu
willy	b i l . l i
isola	i . s o l . l a
mach	m a . h a
adani	a . d a . n i
gareth	g ae . l i . s eu
chatterjee	ch a . t eo . j i
burnham	b eo n . h ae m
meany	m i . n i
asam	a . j a m
hendrikx	h e n . d eu . l i g . s eu
nattier	n a . t i . e
mounier	m u . n i . e
klimt	k eu l . l i m . t eu
peshawar	p e . s ya . wa . l eu
hahn	a n
benn	b e n
schinkel	s i ng . k e l
shane	s we . i n
gennady	g e n . n a . d i
zanetti	s a . n e . t i
nafis	n a . p i . s eu
jung	yu ng
steger	s yu . t e . g eo
christian	k eu . l i . s eu . ch eo n
schutz	s yu . ch eu
onassis	o . n a . s i . s eu
gauss	g a . u . s eu
wittenberg	b i . t e n . b e . l eu . k eu
hildebrand	h i l . d e . b eu . l a n . d eu
amelie	a . m e l . l i . e
colette	k o l . l e . t eu
bridget	b eu . l i . j i . t eu
angora	a ng . g o . l a
molnar	m o l . n a
gunderson	g eo n . d eo . s eu n
johansson	yo . h a n . s o n
azevedo	a . j e . b e . d o
stirner	s yu . t i . l eu . n eo
iain	i . eo n
sem	s e m
irma	i . l eu . m a
theresa	t e . l e . s a
angus	ae ng . g eo . s eu
gheorghiu	g e . o . l eu . g yu
goncourt	g o ng . k u . l eu
somalia	s o . m a l . l i . a
kaverin	k a . b e . l i n
ragusa	l a . g u . s a
karl	k a . l eu l
jammes	j a m
bo	b o
linda	l i n . d a
kandahar	k a n . d a . h a . l eu
mari	m a . l i
frunze	p eu . l u n . j e
nukualofa	n u . k u . a l . l o . p a
augusta	o . g eo . s eu . t a
banach	b a . n a . h eu
rowan	l o . eo n
rathenau	l a . t e . n a . u
davidoff	d ae . b i . d o . p eu
rabin	l a . b i n
howell	h a . we l
browne	b eu . l a . u n
willard	wi l . l eo . d eu
holley	h o l . l i
chichester	ch i . ch e . s eu . t eo
carlton	k a l . t eu n
afghanistan	a . p eu . g a . n i . s eu . t a n
bondi	b o n . d i
meinecke	m a . i . n e . k e
curtius	k u . l eu . t i . u . s eu
donald	d o . n eo l . d eu
kummer	k u . m eo
georges	j e . o . l eu . j e . s eu
rohrer	l o . l eo
petra	p e . t eu . l a
adolphe	a . d o l . p eu
virchow	p i . l eu . h o
glass	g eu l . l a . s eu
tansley	t ae n . s eu l . l i
segni	s e . n i
carney	k a . n i
vesuvius	b e . s u . b i . o
dirichlet	d i . l i . k eu l . l e
torsten	t o l . s eu . t eo n
bojer	b o . ye . l eu
veronica	b e . l o . n i . k a
behn	b e n
sammy	s ae . m i
balmer	b a l . m eo
capuana	k a . p u . a . n a
miguel	m i . g e l
henrik	h e n . l i . k eu
inge	i ng
wright	l a . i . t eu
pisano	p i . s a . n o
uribe	u . l i . b e
pelliot	p e l . l i . o
glasgow	g eu l . l ae . s eu . g o
mandalay	m a n . d a l . l e . i
lai	l a . i
kiribati	k i . l i . b a . s i
melanchthon	m e l . l a n . h i . t o n
vecellio	b e . ch e l . l i . o
hutton	h eo . t eo n
joe	j o
eugen	o . i . g e n
perm	p e . l eu m
chung	j eo ng
nairobi	n a . i . l o . b i
christopher	k eu . l i . s eu . t o . p eo
akhmatova	a . h eu . m a . t o . b a
kolmogorov	k o l . m o . g o . l o . p eu
dietrich	d i . t eu . l i . s i
montoya	m o n . t o . ya
hasan	h a . s a n
karsavina	k a . l eu . s a . b i . n a
shufeldt	s yu . p e l . t eu
zwingli	ch eu . b i ng . g eu l . l i
aaron	a . l o n
molander	m o l . l a n . d eo
somare	s o . m a . l e
scalia	s eu . k ae l . l i . a
noske	n o . s eu . k e
mille	m i l
richie	l i . ch i
steel	s eu . t i l
nottingham	n o . t i ng . eo m
goldwyn	g o l . d eu . wi n
capa	k a . p a
missouri	m i . j u . l i
downing	d a . u . n i ng
pirie	p a . i . l i
schopenhauer	s yo . p e n . h a . wo
ava	e . b a
meryl	m e . l i l
neruda	n e . l u . d a
mayhew	m e . i . h yu
giusti	j u . s eu . t i
schwerin	s yu . b e . l i n
renan	l eu . n a ng
pea	p e . n ya
barron	b ae . l o n
prim	p eu . l i m
renzo	l e n . j o
capote	k eo . p o . t i
gunther	g eo n . s eo
filipov	p i l . l i . p o . p eu
pullman	p u l . m eo n
baumeister	b a . u . m a . i . s eu . t eo
honorius	h o . n o . l i . u . s eu
aldrin	o l . d eu . l i n
gance	g a ng . s eu
nestor	n e . s eu . t o . l eu
grove	g eu . l o . b eu
rita	l i . t a
botsford	b o . ch eu . p o . d eu
millar	m i l . l eo
montevideo	m o n . t e . b i . d e . o
berlioz	b e . l eu l . l i . o . j eu
gairdner	g e . eo . d eu . n eo
calderon	kk a l . d e . l o n
sullivan	s eo l . l i . b eo n
iceland	a . i . s eu l . l a n . d eu
mathieu	m a . t i . oe
bisset	b i . s e s
bertie	b eo . t i
mogadishu	m o . g a . d i . s yu
portman	p o . t eu . m a n
proudhon	p eu . l u . d o ng
serao	s e . l a . o
arab	a . l a b
galsworthy	g o l . j eu . wo . d i
horst	h o . l eu . s eu . t eu
passy	p a . s i
holst	h o l . s eu . t eu
gower	g a . wo
ober	o . b eo
thomson	t o m . s eu n
ernestine	eo . n i . s eu . t i n
nubia	n u . b i . a
moshe	m o . s ye
zeppelin	ch e . p e l . l i n
coppola	k o . p eu l . l a
chagall	s ya . g a l
champaigne	s a ng . p a . n yu
bronte	b eu . l o n . t e
king	k i ng
hewlett	h yu . l e s
glauber	g eu l . l a . u . b eo
morley	m o l . l i
cosa	k o . s a
minnie	m i . n i
bikila	b i . k i l . l a
starr	s eu . t a
dart	d a . t eu
rodin	l o . d ae ng
healey	h i l . l i
fedin	p e . d i n
manning	m ae . n i ng
kulik	k u l . l i . k eu
erskine	eo . s eu . k i n
bonhoeffer	b o n . h oe . p eo
ellison	e l . l i . s eu n
ines	i . n e . s eu
grotius	g eu . l o . t i . u . s eu
goldstein	g o l . d eu . s eu . t a . i n
milles	m i l . l e . s eu
weinheber	b a . i n . h e . b eo
rohmer	l o . m e . l eu
milne	m i l . l eu n
peter	b e . d eu . l o
pyongyang	p yeo ng . ya ng
arber	a . l eu . b eo
zimmern	j i m . m e . l eu n
meunier	m oe . n i . e
castro	k a . s eu . t eu . l o
einhorn	a . i n . h o n
mathis	m ae . t i . s eu
lanier	l eo . n i . eo
tosti	t o . s eu . t i
athanasius	a . t a . n a . s i . u . s eu
carver	k a . b eo
michal	m a . i . k eu l
hancock	h ae n . k o g
eugene	yu . j i n
marta	m a . l eu . t a
sansovino	s a n . s o . b i . n o
annapolis	a . n a . p o l . l i . s eu
pons	p o ng . s eu
thomasius	t o . m a . j i . u . s eu
janine	j e . n i n
karimi	k a . l i . m i
alfred	a l . p eu . l e . d eu
richardson	l i . ch eo . d eu . s eu n
spyri	s yu . p i . l i
cairnes	k e . eo n . s eu
susanne	j u . j a . n e
seyfert	s i . p eo . t eu
lenin	l e . n i n
charpentier	s ya . l eu . p a ng . t i . e
moreau	m o . l o
weismann	b a . i . s eu . m a n
key	k e . i
gaetano	g a . e . t a . n o
lanning	l ae . n i ng
laud	l o . d eu
bernheim	b e . l eu n . h a . i m
lynda	l i n . d a
walsh	wa l . s i
sam	s ae m
dayton	d e . i . t eo n
vermeer	b e . l eu . m e . l eu
arias	a . l i . a . s eu
rosset	l o . s e . t eu
manger	m ae ng . g eo
sergio	s e . l eu . j o
stella	s eu . t e l . l a
dowiyogo	d o . wi . yo . g o
meisheng	m e . i . s eo ng
hanover	h a . n o . b eo
fran	p eu . l a n
mecca	m e . k a
binswanger	b i n . s eu . b a ng . g eo
bundy	b eo n . d i
marot	m a . l o
dumont	d wi . m o ng
herren	h e . l e n
medford	m ae . d eu . p o . d eu
marjatta	m a . l eu . ya . t a
jonah	yo . n a
karelia	k a . l e l . l i . a
pfeffer	p e . p eo
baylor	b ae . i l . l eo
seth	s e s
vicente	b i . s e n . t e
stratford	s eu . t eu . l ae s . p o . d eu
pontryagin	p o n . t eu . l ya . g i n
voss	p o . s eu
devonshire	d e . b eo n . s yeo
summers	s eo . m eo . s eu
mucha	m u . h a
bui	b u . i
langland	l ae ng . g eu l . l eo n . d eu
gore	g o . eo
jacobus	ya . k o . b wi . s eu
quasimodo	k wa . s i . m o . d o
weidenreich	b a . i . d e n . l a . i . h i
siewert	s i . wo . t eu
cronin	k eu . l o . n i n
mraz	m eu . l a . j eu
bilbao	b i l . b a . o
khan	k a n
fritz	p eu . l i . ch eu
garland	g a l . l eo n . d eu
stiglitz	s eu . t i . g eu l . l i . ch eu
mona	m o . n a
pinel	p i . n e l
magda	m a . g eu . d a
clapeyron	k eu l . l a . p e . l o ng
nunes	n u . n i . s eu
korneichuk	k o . l eu . n e . i . ch u . k eu
cohan	k o . h ae n
fortune	p o . ch eo n
pound	p a . u n . d eu
peruzzi	p e . l u . ch i
arrhenius	a . l e . n i . u . s eu
galbraith	k ae l . b eu . l e . i . s eu
volpi	b o l . p i
bergmann	b e . l eu . k eu . m a n
whale	we . i l
nanny	n ae . n i
sahara	s a . h a . l a
sully	s wi l . l i
voisin	b eu . wa . j ae ng
wilde	wa . i l . d eu
kalman	k a l . m a n
olga	o l . g a
bobby	b o . b i
berkley	b eo . k eu l . l i
dreyfus	d eu . l e . p wi . s eu
herzog	h e . eo . ch o . k eu
purcell	p eo . s e l
busch	b u . s yu
mills	m i l . s eu
hammer	h a . m eo
