holstein	h o l . s eu . t a . i n
jacobsen	ya . k o b . s e n
spohr	s yu . p o . eo
sachs	s ae g . s eu
amado	a . m a . d o
borodin	b o . l o . d i n
lem	l e m
athanasius	a . t a . n a . s i . u . s eu
bouts	b o . ch eu
warsaw	b a . l eu . s ya . b a
beattie	b i . t i
marisa	m a . l i . s a
cesar	s e . s a . l eu
bosanquet	b o . s a ng . k e
rietveld	l i . t eu . b e l . t eu
unamuno	u . n a . m u . n o
india	i n . d i . a
daley	d e . i l . l i
poter	p o . t eo
underwood	eo n . d eo . u . d eu
perot	p e . l o
kremer	k eu . l e . m eo
wallach	b a l . l a . h eu
neef	n i . p eu
alonso	a l . l o n . s o
karelia	k a . l e l . l i . a
sherriff	s ye . l i . p eu
rojas	l o . h a . s eu
mauriac	m o . l i . a g
simi	s i . m i
barrios	b a . l i . o . s eu
scalia	s eu . k ae l . l i . a
chiesa	k i . e . s a
beth	b e . s eu
alba	a l . b a
soupault	s u . p o
ob	o . b eu
aruba	a . l u . b a
ramstedt	l a m . s eu . t e . t eu
farina	p a . l i . n a
debs	d e . b eu . s eu
newcomen	n yu . k eo . m eo n
barlach	b a . l eu l . l a . h eu
filippo	p i l . l i . p o
josef	yo . s e . p eu
ellison	e l . l i . s eu n
besson	b e . s o ng
rugby	l eo g . b i
sperling	s eu . p eo l . l i ng
edmonton	e . d eu . m eo n . t eo n
otto	o . t o
philipp	p i l . l i . p eu
sarney	s a . l eu . n e . i
norton	n o . t eo n
hawkins	h o . k i n . s eu
tallahassee	t ae l . l eo . h ae . s i
nafis	n a . p i . s eu
azhari	a . j a . l i
friedman	p eu . l i . d eu . m a n
fibiger	p i . b i . g e . l eu
cary	k ae . l i
leoncavallo	l e . o n . k a . b a l . l o
chichester	ch i . ch e . s eu . t eo
frankenstein	p eu . l a ng . k e n . s yu . t a . i n
vic	b i g
fern	p eo n
jaffna	j a . p eu . n a
berenson	b e . l eo n . s eu n
burgundy	b u . l eu . g o . n yu
frantisek	p eu . l a n . t i . s e g
stella	s eu . t e l . l a
moll	m o l
salomon	s a l . l o . m o n
magendie	m a . j a ng . d i
dawn	d o n
grasse	g eu . l ae . s eu
glenn	g eu l . l e n
roy	l o . i
harlow	h a l . l o
maas	m a . s eu
octavio	o g . t a . b i . o
blanco	b eu l . l a ng . k o
clearwater	k eu l . l i . eo . wo . t eo
hoskins	h o . s eu . k i n . s eu
seattle	s i . ae . t eu l
amy	e . i . m i
ellesmere	e l . j eu . m i . eo
svend	s eu . b e n
mandeville	m ae n . d eo . b i l
blanchard	b eu l . l a ng . s ya . l eu
tricia	t eu . l i . s i . a
chan	ch ae n
farrell	p ae . l eo l
fonvizin	p o n . b i . j i n
kautsky	k a . u . ch eu . k i
heinrich	h a . i n . l i . h i
mariano	m a . l i . a . n o
torres	t o . l e . s eu
havana	a . b a . n a
pirenne	p i . l e n
hunter	h eo n . t eo
svevo	s eu . b e . b o
renner	l e . n eo
poli	p o l . l i
arce	a . l eu . s e
meany	m i . n i
susie	s u . j i
caldwell	k o l . d eu . we l
baron	b a . l o n
dorothy	d o . l o . s i
bienville	b i . e n . b i l
kauffmann	k a . u . p eu . m a n
weizmann	b a . i . ch eu . m a n
padilla	p a . d i l . l a
ahern	eo . h eo n
joost	yo . s eu . t eu
wislicenus	b i . s eu l . l i . ch e . n u . s eu
sutton	s eo . t eo n
cabral	k a . b eu . l a l
boyer	b o . i . eo
mount	m a . u n . t eu
runeberg	l u . n e . b e . l i
mitra	m i . t eu . l a
zimmer	ch i . m eo
ronge	l o ng . i
rohrer	l o . l eo
rouse	l o . j eu
sophie	s o . p i
aaron	a . l o n
robyn	l o . b i n
eichmann	a . i . h i . m a n
owens	o . eo n . s eu
mitscherlich	m i . ch eo . l i . h i
brendan	b eu . l e n . d eo n
nicholson	n i . k eo l . s eu n
cesarotti	ch e . s a . l o . t i
combs	k o m . s eu
marin	m a . l ae ng
swaziland	s eu . wa . j i l . l a n . d eu
ramus	l a . m u . s eu
berkshire	b a . k eu . s yeo
honiara	h o . n i . a . l a
arghezi	a . l eu . g e . j i
rosalyn	l o . j eo l . l i n
epirus	e . p i . l u . s eu
overbeck	o . b eo . b e . k eu
lipchitz	l i b . s i . ch eu
clint	k eu l . l i n . t eu
clausewitz	k eu l . l a . u . j e . b i . ch eu
christchurch	k eu . l a . i . s eu . t eu . ch eo . ch i
stone	s eu . t o n
agnelli	a . n ye l . l i
hamilton	h ae . m i l . t eo n
tupolev	t u . p o l . l e . p eu
dobriansky	d o . b eu . l i . eo n . s eu . k i
kolmogorov	k o l . m o . g o . l o . p eu
chantal	s ya n . t a l
kapitsa	k a . p i . ch a
vittorini	b i . t o . l i . n i
dalton	d a l . t o n
