aaf	อ เ- _M . อ เ- _M . อ เ-- ฟ _L
aaron	อ แ- _M . ร -อ- น _M
abe	อ เ-- บ _L
abegg	อ เ-อ _M . บ -ิ- ก _L
abigail	อ แ- _M . บ -ิ _L . ก เ- _M . ล เ- _M
abilene	อ แ- _M . บ -ิ _L . ล -ี- น _M
abingdon	อ แ- _M . บ -ิ- ง _M . ด เ-ิ- น _M
ablon	อ เอิ- บ _L . อ เ-ิ- บ _L . ล เ-ิ- น _M
abramson	อ เ- _M . บ เ- _M . ร -ิ- ม _M . ส -ั- น _R
abzug	อ แอ็- บ _L . อ แ-็- บ _L . ซ -ั- ก _H
ac	อ เ- _M . ซ -ี _M
acebo	อ เ- _M . ซ เ-อ _M . บ โ- _M
acetic	อ แ- _M . ซ -ิ _H . ต -ิ- ก _L
acetic	อ แ- _M . ซ -ี _M . ต -ิ- ก _L
acetone	อ แ- _M . ซ -ิ _H . ต โ-- น _M
acetone	อ แ- _M . ซ -ิ _H . ท โ-- น _M
acetylene	อ แ- _M . ซ -ี _M . ท -ิ _H . ล -ี- น _M
acheron	อ แอ็- ก _L . อ แ-็- ก _L . ค เ-ิ- น _M . ร เ-ิ- น _M
acheson	อ แ- _M . ช -ิ _H . ส -ั- น _R
acheson	อ แ- _M . ช เ-อ _M . ส -ั- น _R
acid	อ แ- _M . ซ -ิ- ด _H
acklin	อ แอ็- ก _L . อ แ-็- ก _L . ล -ิ- น _M
acme	อ แ-- ก _L . ม เ- _M
act	อ แอ็- ก _L . อ แ-็- ก _L
actin	อ แ-- ก _L . ท -ิ- น _M
acting	อ แ-- ก _L . ต -ิ- ง _M
actinium	อ แ-- ก _L . ต -ิ _L . น เ-ีย- ม _M
actinium	อ แ-- ก _L . ท -ิ _H . น เ-ีย- ม _M
action	อ แ-- ก _L . ช -ั- น _M
active	อ แ-- ก _L . ท -ิ- ฟ _H
active	อ แ-- ก _L . ท -ี- ฟ _F
activity	อ แ-- ก _L . ท -ิ _H . ว -ิ _H . ต -ี _M
acton	อ แ-- ก _L . ต -ั- น _M
acu	อ เ- _M . ซ -ี _M . ย -ู _M
ad	อ แ-- ด _L
adam	อ แ- _M . ด -ั- ม _M
adamic	อ แ-- ด _L . ด แ- _M . ม -ิ- ก _H
quincy	ค -ิ- น _M . ว -ิ- น _M . ซ -ี _M
adamson	อ แ- _M . ด เ-ิ- ม _M . ส -ั- น _R
adb	อ เ- _M . ด -ี _M . บ -ี _M
adc	อ เ- _M . ด -ี _M . ซ -ี _M
adde	อ แอ็- ด _L . อ แ-็- ด _L
addison	อ แ-- ด _L . ด -ิ _L . ส -ั- น _R
addison	อ แอ็- ด _L . อ แ-็- ด _L . ด เ-อ _M . ส -ั- น _R
additive	อ แ-- ด _L . ด -ิ _L . ท -ิ- ฟ _H
ade	อ เ-- ด _L
aden	อ เ- _M . ด เ-- น _M
adiabatic	อ แ- _M . ด เ-ีย _M . บ แ- _M . ต -ิ- ก _L
adin	อ เ-อ _M . ด -ิ- น _M
adkinson	อ แ-- ด _L . ค -ิ- น _M . ส -ั- น _R
adkisson	อ แ-- ด _L . ค -ิ _H . ส -ั- น _R
adp	อ เ- _M . ด -ี _M . พ -ี _M
adrian	อ เ- _M . ด เ-ีย- น _M . ร เ-ีย- น _M
adrien	อ เ- _M . ด เ-ีย- น _M . ร เ-ีย- น _M
adrienne	อ เ- _M . ด เ-ีย- น _M . ร เ-ีย- น _M
adt	อ เ- _M . ด -ี _M . ท -ี _M
advection	อ แ-- ด _L . ว เ-- ก _F . ช -ั- น _M
advisory	อ แ-- ด _L . ว ไ- _M . ซ -อ _M . ร -ี _M
affinity	อ แ-- ฟ _L . ฟ -ิ _H . น -ิ _H . ท -ี _M
affleck	อ แ-- ฟ _L . ฟ -ิ- ก _H . ล -ิ- ก _H
again	อ - _L . ก เ-- น _M
agnew	อ แ-- ก _L . น -ิว _M
agnew	อ แอ็- ก _L . อ แ-็- ก _L . น -ู _M
ago	อ - _L . ก โ- _M
agrihan	อ -า- ก _L . ร -ี _M . ฮ -ั- น _M
agron	อ แอ็- ก _L . อ แ-็- ก _L . ร -อ- น _M
ague	อ แอ็- ก _L . อ แ-็- ก _L
aherne	อ เ-อ _M . ฮ เ-- น _M
ahlem	อ -อ _M . ล เ-ิ- ม _M
ai	อ เ- _M . อ ไ- _M
aidan	อ ไ- _M . ด -ั- น _M
aileen	อ เ- _M . ล -ี- น _M
aime	อ เ-- ม _M
ain	อ เ-- น _M
airy	อ แ- _M . ร -ี _M
aitchison	อ เ- _M . ช -ี _M . ส -ั- น _R
akin	อ - _L . ค -ิ- น _M
alain	อ แ- _M . ล เ-- น _M
alan	อ แ- _M . ล -ั- น _M
alanson	อ แ- _M . ล -ั- น _M . ส -ั- น _R
josef	ย โ- _M . ซ เ-- ฟ _F
madeleine	ม แ- _M . ด เ- _M . ล -ี- น _M
k	ค เ- _M
madeleine	ม แ- _M . ด เ- _M . ล เ-- น _M
alcan	ล แ- _M . ค แ-- น _M
aleck	อ เ-อ _M . ล เ-็- ก _H
alene	อ - _L . ล -ี- น _M
alexia	อ - _L . ล เ-็- ก _H . ซ เ-ีย _M
alexiou	อ แ- _M . ล เ-็- ก _H . ซ -ู _M
muhammad	ม -ุ _H . ฮ -ั- ม _M . ม -ั- ด _L
alicia	อ - _L . ล -ิ _H . ซ เ-ีย _M
alick	อ เ-อ _M . ล -ิ- ก _H
alien	อ เ- _M . ล เ-ีย- น _M
aliphatic	อ แ- _M . ล -ิ _H . ฟ แ- _M . ต -ิ- ก _L
alison	อ แ- _M . ล -ิ _H . ส -ั- น _R
allain	อ - _L . ล เ-- น _M
allanson	อ เ-อ _M . ล เ-ิ- น _M . ส -ั- น _R
alleyne	อ แ- _M . ล เ-- น _M
alling	อ - _L . ล -ิ- ง _M
aluminum	อ - _L . ล -ู _M . ม -ิ _H . น -ั- ม _M
aly	อ เ- _M . ล -ี _M
amelia	อ - _L . ม เ-อ _M . ล เ-ีย _M
amen	อ เ- _M . ม เ-- น _M
american	อ - _L . ม เ- _M . ร -ิ _H . ก -ั- น _M
amick	อ แ- _M . ม -ิ- ก _H
amine	อ แ- _M . ม -ี- น _M
amino	อ - _L . ม -ิ _H . น โ- _M
amino	อ แ- _M . ม -ิ _H . น โ- _M
ammonia	อ แ-- ม _M . ม โ- _M . น เ-ีย _M
ammonification	อ แ-- ม _M . ม โ- _M . น -ิ _H . ฟ -ิ _H . ค เ- _M . ช -ั- น _M
amphineuran	อ แ-- ม _M . ฟ -ิ _H . น -ิว _M . ร แ-- น _M
amphiprotic	อ แ-- ม _M . ฟ -ิ _H . ร โ- _M . พ โ- _M . ต -ิ- ก _L
amplitude	อ แ-- ม _M . ล -ิ _H . พ -ิ _H . จ -ู- ด _L
amram	อ แ-- ม _M . ร แ-- ม _M
amy	อ เ- _M . ม -ี _M
anabolism	อ แ- _M . น แ- _M . บ -อ _M . ล -ิ _H . ซ -ึ- ม _M
anaerobic	อ แ-- น _M . อ แ- _M . ร โ- _M . บ -ิ- ก _L
anaerobic	อ แ- _M . น แ- _M . ร โ- _M . บ -ิ- ก _L
anchovy	อ แ-- น _M . ช โ- _M . ว -ี _M
andesine	อ แ-- น _M . ด -ี _M . ซ -ี- น _M
julie	จ -ู _M . ล -ี _M
andy	อ แ-- น _M . ด -ี _M
ane	อ เ-- น _M
aneurin	อ เอิ- น _M . อ เ-ิ- น _M . ร -ิ- น _M
angel	อ แ-- ง _M . ก เ- _M . ล เ- _M
angelo	อ แ-- น _M . จ เ- _M . ล โ- _M
angioch	อ แ-- น _M . จ -ิ _L . อ -อ- ก _L
anglican	อ แ-- ง _M . ก -ิ _L . ล -ิ _L . ค -ั- น _M
anglo	อ แ-- ง _M . ก โ- _M . ล โ- _M
animation	อ แ- _M . น -ิ _H . ม เ- _M . ช -ั- น _M
anion	อ แ-- น _M . อ ไ- _M . อ - น _M
anion	อ แ-- น _M . อ ไ- _M . อ -อ- น _M
anne	อ -า- น _M
anne	อ -า- น _M . น เ-อ _M
annie	อ แ-- น _M . น -ี _M
anoxic	อ แ- _M . น -็อ- ก _H . ซ -ิ- ก _H
ansi	อ แ-- น _M . ซ -ี _M
anson	อ แ-- น _M . ส -ั- น _R
anson	อ แ-- น _M . ซ เ-ิ- น _M
anthea	อ แ-- น _M . ท เ-ีย _M
antheridium	อ แ-- น _M . ท เ-อ _M . ร -ิ _H . ด เ-ีย- ม _M
anthony	อ แ-- น _M . ท โ- _M . น -ี _M
anthozoan	อ แ-- น _M . ท โ- _M . ซ โ- _M . อ แ-- น _M
anti	อ แ-- น _M . ต -ิ _L
antiauxin	อ แ-- น _M . ต -ิ _L . อ -อ- ก _L . ซ -ิ- น _M
antibody	อ แ-- น _M . ต -ิ _L . บ -อ _M . ด -ี _M
anticodon	อ แ-- น _M . ต -ิ _L . ค โ- _M . ด -อ- น _M
antigen	อ แ-- น _M . ต -ิ _L . จ เ-- น _M
antimeridian	อ แ-- น _M . ต -ิ _L . ม เ- _M . ร -ิ _H . ด เ-ีย- น _M
antimonson	อ แ-- น _M . ต -ิ _L . ม -อ- น _M . ส -ั- น _R
antimony	อ แ-- น _M . ต -ิ _L . ม โ- _M . น -ี _M
antimony	อ แ-- น _M . ท -ิ _H . ม โ- _M . น -ี _M
antineutron	อ แ-- น _M . ต -ิ _L . น -ิว _M . ร -อ- น _M . ต -อ- น _M
antipleion	อ แ-- น _M . ต -ิ _L . ล ไ- _M . พ ไ- _M . อ -อ- น _M
antipodes	อ แ-- น _M . ต -ิ _L . ป โ-- ด _L
antipodes	อ แ-- น _M . ต -ิ _L . พ โ-- ด _F
antiproton	อ แ-- น _M . ต -ิ _L . ร โ- _M . ป โ- _M . ต -อ- น _M
antoine	อ -อ- ง _M . ต -ว- น _M
antonia	อ แ-- น _M . ท โ- _M . น เ-ีย _M
antonio	อ -อ- ง _M . ต โ- _M . น -ี _M . ย โ- _M
antonio	อ แ-- น _M . ท โ- _M . น -ี _M . อ โ- _M
antony	อ -อ- ง _M . ต โ- _M . น -ี _M
antony	อ แ-- น _M . ท โ- _M . น -ี _M
aortic	อ เ-อ _M . อ - _L . ต -ิ- ก _L
apec	อ เ- _M . ป เ-- ก _L
aphelion	อ แ- _M . ฟ -ี _M . ล เ-ีย- น _M
apogean	อ แ- _M . พ โ- _M . จ เ-ีย- น _M
apogee	อ แ- _M . พ โ- _M . จ -ี _M
appel	อ แ- _M . ล เ- _M . พ เ- _M
aram	อ เ- _M . ร แ-- ม _M
aromatic	อ แ- _M . ร โ- _M . ม แ- _M . ต -ิ- ก _L
asaph	อ แ- _M . ซ เ-ิ- ฟ _F
asencio	อ - _L . ซ เ-็- น _M . ซ -ี _M . อ โ- _M
frederick	ฟ เ- _M . ร เ- _M . ด เ- _M . ร -ิ- ก _H
isaac	อ ไ- _M . ซ แ-- ก _F
jacob	จ เ- _M . ค -็อ- บ _H
athene	อ แ- _M . ท -ิ- น _M
atm	อ เ- _M . ท -ี _M . อ เอ็- ม _M . อ เ-็- ม _M
atp	อ เ- _M . ท -ี _M . พ -ี _M
aubretia	อ -อ- บ _L . ร -ี _M . ช เ-ีย _M
aubyn	อ -อ _M . บ -ิ- น _M
auction	อ -อ- ก _L . ช -ั- น _M
auden	อ -อ _M . ด เ-- น _M
aurelia	อ -อ _M . ร -ี _M . ล เ-ีย _M
auric	อ -อ _M . ร -ิ- ก _H
aurin	อ -อ _M . ร -ิ- น _M
jane	จ เ-- น _M
authen	อ -อ _M . ท เ-ิ- น _M
autism	อ -อ _M . ท -ิ _H . ซ -ึ- ม _M
auto	อ -อ _M . ต โ- _M
automatic	อ -อ _M . ต โ- _M . ม เ- _M . ต -ิ- ก _L
autosome	อ -อ _M . ต โ- _M . ซ โ-- ม _M
auxin	อ -อ- ก _L . ซ -ิ- น _M
av	อ เ- _M . ว -ี _M
avakian	อ เ-อ _M . ว เ- _M . ค -ี _M . อ เอิ- น _M . อ เ-ิ- น _M
avery	อ เ- _M . ว เ- _M . ร -ี _M
ayn	อ เ-- น _M
babington	บ เ- _M . บ -ิ- ง _M . ต -ั- น _M
bacino	บ -อ _M . ช -ี _M . น โ- _M
back	บ แ-็- ก _L
backe	บ แ-็- ก _L
backgammon	บ แ-็- ก _L . ก แ-- ม _M . ม -อ- น _M
backhoe	บ แ-็- ก _L . ฮ โ- _M
backpack	บ แ-็- ก _L . พ แ-็- ก _H
bacm	บ -ี _M . อ เ- _M . ซ -ี _M . อ เอ็- ม _M . อ เ-็- ม _M
bacon	บ เ- _M . ค -อ- น _F
bact	บ -ี _M . อ เ- _M . ซ -ี _M . ท -ี _M
bactria	บ แ-- ก _L . ร เ-ีย _M . ต เ-ีย _M
bad	บ แ-- ด _L
badenoch	บ เ- _M . ด เ-อ _M . น เ-ิ- ก _F
badminton	บ แ-- ด _L . ม -ิ- น _M . ต -ั- น _M
badminton	บ แ-็- ด _L . ม -ิ- น _M . ต -ั- น _M
baerg	บ แ- _M . ร -ึ- ก _H
baffin	บ แ-- ฟ _L . ฟ -ิ- น _M
bagge	บ แ-็- ก _L
bailie	บ เ- _M . ล -ี _M
bain	บ เ-- น _M
baine	บ เ-- น _M
bajek	บ แ- _M . ย เ-็- ก _H
bakery	บ เ- _M . ก เ-อ _M . ร -ี _M
bakke	บ แ-็- ก _L
bakken	บ แ-็- ก _L . ค เ-ิ- น _M
balanchine	บ แ- _M . ล -ั- น _M . ช -ี- น _M
balk	บ -็อ- ก _L
balogh	บ แ- _M . ล โ- _M
honore	อ -อ _M . น -อ _M . ร เ- _M
de	ด เ-อ _M
bam	บ แ-- ม _M
ban	บ แ-- น _M
bandon	บ แ-- น _M . ด -อ- น _M
bandoneon	บ แ-- น _M . ด โ- _M . น -ี _M . อ -อ- น _M
bane	บ เ-- น _M
bang	บ แ-- ง _M
banjo	บ แ-- น _M . จ โ- _M
banting	บ แ-- น _M . ต -ิ- ง _M
barach	บ เ-อ _M . ร -ั- ก _H
barea	บ แ- _M . ร เ-ีย _M
baritone	บ แ- _M . ร -ิ _H . ท โ-- น _M
barium	บ แ- _M . ร เ-ีย- ม _M
barone	บ เ-อ _M . ร โ-- น _M
baryon	บ แ- _M . ร -ิ _H . อ -อ- น _M
barytone	บ แ- _M . ร -ิ _H . ท โ-- น _M
basic	บ เ- _M . ส -ิ- ก _L
basie	บ เ- _M . ซ -ี _M
basing	บ เ- _M . ซ -ิ- ง _M
batho	บ แ- _M . ท เ-อ _M
bau	บ โ- _M
baud	บ -อ- ด _L
baughman	บ -อ _M . ม เ-ิ- น _M
baum	บ โ-- ม _M
bawn	บ -อ- น _M
bayh	บ เ- _M
bayne	บ เ-- น _M
bbc	บ -ี _M . บ -ี _M . ซ -ี _M
bcc	บ -ี _M . ซ -ี _M . ซ -ี _M
bcd	บ -ี _M . ซ -ี _M . ด -ี _M
beak	บ -ิ- ก _L
beam	บ -ี- ม _M
beaman	บ -ี _M . ม เ-ิ- น _M
bean	บ -ี- น _M
beane	บ -ิ- น _M
beaudin	บ โ- _M . ด แ-- น _M
beaujolais	บ โ- _M . ช โ- _M . ล เ- _M
beaulac	บ โ- _M . ล แ-็- ก _H
beauty	บ -ิว _M . ต -ี _M
beauvais	บ โ- _M . ว เ- _M
simone	ซ -ี _M . ม -อ- น _M
beavan	บ เ- _M . ว แ-- น _M
beck	บ เ-็- ก _L
beck	บ เ-- ก _L
c	ซ -ี _M
beckel	บ เ- _M . ค เ- _M . ล เ- _M
beckham	บ เ-- ก _L . ฮ แ-- ม _M
david	ด เ- _M . ว -ิ- ด _H
beckman	บ เ-็- ก _L . ม เ-ิ- น _M
becky	บ เ-- ก _L . ก -ี _M
bedrich	บ เ-- ด _L . ร -ิ- ก _H
bee	บ -ี _M
beebe	บ -ี _M . บ -ี _M
beebee	บ -ี _M . บ -ี _M
beef	บ -ี- ฟ _L
beethoven	บ เ- _M . ท โ- _M . ฟ เ-- น _M
ludwig	ล -ุ- ด _H . ว -ิ- ก _H
van	ฟ -า- น _M
begin	บ เ- _M . ก -ิ- น _M
begonia	บ -ิ _L . ก โ- _M . น เ-ีย _M
beguine	บ -ิ _L . ก -ิ- น _M
beguine	บ -ี _M . ก -ิ- น _M
behan	บ -ี _M . ฮ -ั- น _M
behm	บ เ-- ม _M
beinecke	บ ไ- _M . น -ิ- ก _H
belafonte	บ เ- _M . ล เ-อ _M . ฟ -อ- น _M . ท -ี _M
belen	บ เ- _M . ล เ-ิ- น _M
belin	บ เ- _M . ล -ิ- น _M
giovanni	จ โ- _M . ว -ั- น _M . น -ี _M
vincenzo	ว -ิ- น _M . ซ เ-- น _M . ซ โ- _M
ben	บ เ-- น _M
benham	บ เ-- น _M . ฮ เ-ิ- ม _M
benioff	บ เ- _M . น -ี _M . อ -อ- ฟ _L
benito	บ เ- _M . น -ิ _H . ต โ- _M
bennison	บ เ-- น _M . น -ิ _H . ส -ั- น _R
benso	บ เ-- น _M . ซ โ- _M
benson	บ เ-- น _M . ส -ั- น _R
bentham	บ เ-- น _M . ท -ั- ม _M
benton	บ เ-- น _M . ต -ั- น _M
benzene	บ เ-- น _M . ซ -ิ- น _M
benzine	บ เ-- น _M . ซ -ิ- น _M
beranek	บ เ- _M . ร เ-อ _M . น -ิ- ก _H
berenson	บ เ- _M . ร -ิ- น _M . ส -ั- น _R
berenson	บ เ- _M . ร เ-- น _M . ส -ั- น _R
henri	ฮ เ-- น _M . ร -ี _M
beria	บ เ- _M . ร เ-ีย _M
bering	บ เ- _M . ร -ิ- ง _M
bethea	บ เ- _M . ท เ-ีย _M
bevin	บ เ- _M . ว -ิ- น _M
bi	บ ไ- _M
biberaj	บ -ี _M . บ เ-อ _M . ร ไ- _M
biceps	บ ไ- _M . ซ เ-- บ _F
bielak	บ -ี _M . ล เ-ิ- ก _F
bien	บ เ-ีย- น _M
bienvenue	บ เ-ีย- ง _M . ว เ-อ _M . น -ู _M
bigelow	บ -ิ _L . ก เ-อ _M . ล โ- _M
bikini	บ -ิ _L . ก -ิ _L . น -ี _M
bikini	บ -ิ _L . ก -ี _M . น -ี _M
bilan	บ ไ- _M . ล เ-ิ- น _M
bilirubin	บ -ิ _L . ล -ิ _H . ร -ู _M . บ -ิ- น _M
billen	บ -ี _M . ล เ-ิ- น _M
binchy	บ -ิ- น _M . ช -ี _M
bing	บ -ิ- ง _M
bingham	บ -ิ- ง _M . ฮ เ-ิ- ม _M
binton	บ -ิ- น _M . ต -ั- น _M
biorhythm	บ ไ- _M . อ โ- _M . ร -ิ _H . ท -ึ- ม _M
bipin	บ ไ- _M . พ -ิ- น _M
biprism	บ ไ- _M . ร -ึ _L . ป -ึ _L . ซ -ึ- ม _M
bison	บ ไ- _M . ซ -ั- น _M
jacqueline	จ แ-็- ก _L . ก เ-อ _M . ล -ี- น _M
bitumen	บ -ิ _L . ท -ู _M . ม เ-- น _M
blouin	บ โ- _M . ว -ิ- น _M
bmp	บ -ี _M . อ เอ็- ม _M . อ เ-็- ม _M . พ -ี _M
bnf	บ -ี _M . อ เอ็- น _M . อ เ-็- น _M . อ เ-- ฟ _L
boag	บ โ-- ก _L
boak	บ โ-- ก _L
bobo	บ โ- _M . บ โ- _M
boccherini	บ -อ- ก _L . ก เ- _M . ร -ี _M . น -ี _M
luigi	ล -ุย _M . จ -ี _M
bod	บ -ี _M . อ โ- _M . ด -ี _M
bodd	บ -็อ- ด _L
bodde	บ -็อ- ด _L
bode	บ โ-- ด _L
bodegon	บ โ- _M . ด เ- _M . ก -อ- น _M
bodin	บ โ- _M . ด -ิ- น _M
bodmin	บ -็อ- ด _L . ม -ิ- น _M
boe	บ โ- _M
boericke	บ -อ _M . อ เ- _M . ร -ิ- ก _H
bog	บ -็อ- ก _L
bogey	บ โ- _M . ก -ี _M
boghead	บ -็อ- ก _L . ฮ เ-- ด _F
bogie	บ โ- _M . ก -ี _M
bogy	บ โ- _M . ก -ี _M
bohem	บ โ- _M . ฮ เ-- ม _M
bohemia	บ โ- _M . ฮ -ี _M . ม เ-ีย _M
bohm	บ -อ- ม _M
bohorok	บ โ- _M . ฮ โ- _M . ร -อ- ก _F
boileau	บ -อย _M . ล โ- _M
boivin	บ -อย _M . ว แ-- น _M
boke	บ โ-- ก _L
buddy	บ -ั- ด _L . ด -ี _M
bolen	บ โ- _M . ล เ-ิ- น _M
bolero	บ โ- _M . ล เ- _M . ร โ- _M
boleyn	บ โ- _M . ล -ิ- น _M
boling	บ โ- _M . ล -ิ- ง _M
bolitho	บ โ- _M . ล -ี _M . ท เ-อ _M
bolivia	บ โ- _M . ล -ิ _H . ว เ-ีย _M
bonavia	บ -อ _M . น เ- _M . ว เ-ีย _M
bone	บ โ-- น _M
bonnet	บ -อ _M . น เ- _M
bonnie	บ -อ- น _M . น -ี _M
bonomo	บ -อ _M . น เ-อ _M . ม โ- _M
bonsai	บ -อ- น _M . ซ ไ- _M
bonzo	บ -ั- น _M . ซ โ- _M
bookie	บ -ู _M . ก -ี _M
boolean	บ -ู _M . ล -ี- น _M
boom	บ -ู- ม _M
boomerang	บ -ู- ม _M . ม เ-อ _M . ร แ-- ง _M
boomerang	บ -ู _M . ม เ-อ _M . ร แ-- ง _M
boon	บ -ู- น _M
borek	บ -อ _M . ร -ิ- ก _H
borlaug	บ -อ _M . ร -็อ- ก _H
boron	บ -อ _M . ร -อ- น _M
boron	บ โ- _M . ร -อ- น _M
bouman	บ -ู _M . ม แ-- น _M
boutin	บ -ู _M . ต แ-- น _M
boutique	บ -ู _M . ต -ิ- ก _L
bow	บ โ- _M
bowdon	บ โ- _M . ด เ-ิ- น _M
bowe	บ โ- _M
bowie	บ โ- _M . ว -ี _M
bown	บ โ-- น _M
bowne	บ โ-- น _M
boychuk	บ -อย _M . ช เ-ิ- ก _F
boye	บ -อย _M
boykin	บ -อย _M . ค -ิ- น _M
bpm	บ -ี _M . พ -ี _M . อ เอ็- ม _M . อ เ-็- ม _M
bpt	บ -ี _M . พ -ี _M . ท -ี _M
braddick	บ แ-- ด _L . ด -ิ- ก _L
braque	บ -็ _L . ร -า- ก _F
braun	บ -็ _L . ร -าว _M
toni	ท โ- _M . น -ี _M
bream	บ -็ _L . ร -ี- ม _M
breede	บ -็ _L . ร -ี- ด _F
breen	บ -็ _L . ร -ิ- น _M
brew	บ -็ _L . ร -ิว _M
leonid	ล เ- _M . อ โ- _M . น -ิ- ด _H
brickwedde	บ -็ _L . ร -ิ- ก _H . ว เ-็- ด _H
brief	บ -ี- ฟ _L . ร -ี- ฟ _L
briem	บ -็ _L . ร -ี- ม _M
brigham	บ -็ _L . ร -ิ- ก _H . ฮ แ-- ม _M
brigid	บ -็ _L . ร -ิ _H . จ -ิ- ด _L
britain	บ -ิ _L . ร -ิ _L . ต เ-- น _M
britten	บ -็ _L . ร -ิ _H . ท เ-ิ- น _M
brizendine	บ -็ _L . ร -ิ _H . ซ เ-- น _M . ด -ี _M . น -ี _M
broccoli	บ -อ- ก _L . ร -อ- ก _L . ค โ- _M . ล -ี _M
brocoli	บ -อ- ก _L . ร -อ- ก _L . ค โ- _M . ล -ี _M
emily	อ เ- _M . ม -ิ _H . ล -ี _M
bronwyn	บ เ- _M . ร -ิ- น _M . ว -ิ- น _M
brook	บ -็ _L . ร -ุ- ก _H
brooklyn	บ -็ _L . ร -ุ- ก _H . ล -ิ- น _M
broom	บ -็ _L . ร -ู- ม _M
broomhead	บ -็ _L . ร -ู- ม _M . ฮ เ-- ด _F
broun	บ -็ _L . ร -ู- น _M
jackson	จ แ-็- ก _L . ส -ั- น _R
brownie	บ -็ _L . ร -าว _M . น -ี _M
browning	บ -็ _L . ร -าว _M . น -ิ- ง _M
bruche	บ -็ _L . ร -ั- ก _H
bruegel	บ -็ _L . ร -ู _M . ก เ- _M . ล เ- _M
bruff	บ -็ _L . ร -ั- ฟ _H
brumby	บ -็ _L . ร -ั- ม _M . บ -ิ _L
brun	บ -็ _L . ร -ั- น _M
brune	บ -็ _L . ร -ู- น _M
brunei	บ -ู _M . ร -ู _M . น ไ- _M
brunizem	บ -็ _L . ร -ู _M . น -ิ _H . ซ เ-- ม _M
brunn	บ -็ _L . ร -ั- น _M
bruno	บ -ู _M . ร -ู _M . น โ- _M
brunson	บ -็ _L . ร -ั- น _M . ส -ั- น _R
bruree	บ -็ _L . ร -ู _M . ร -ี _M
bryna	บ -็ _L . ร -ี _M . น เ-อ _M
btu	บ -ี _M . ท -ี _M . ย -ู _M
buben	บ -ิว _M . บ เ-ิ- น _M
buchen	บ -ั- ก _L . ค เ-ิ- น _M
buchman	บ -ั- ก _L . ม เ-ิ- น _M
buck	บ -ั- ก _L
bucking	บ -ั- ก _L . ก -ิ- ง _M
bucklin	บ -ั- ก _L . ล -ิ- น _M
buckling	บ -ั- ก _L . ล -ิ- ง _M
budi	บ -ู _M . ด -ี _M
budlong	บ -ั- ด _L . ล -อ- ง _M
buffhan	บ -ั- ฟ _L . ฮ -ั- น _M
bullough	บ -ุ _L . ล โ- _M
bulow	บ -ิว _M . ล โ- _M
bun	บ -ั- น _M
bunn	บ -ั- น _M
bunny	บ -ั- น _M . น -ี _M
bunsen	บ -ั- น _M . ซ เ-- น _M
bunsen	บ -ุ- น _M . ซ เ-- น _M
bunsen	บ -ุ- น _M . ส เ-- น _R
bunyan	บ -ั- น _M . ย -ั- น _M
michelangelo	ม -ี _M . ก เ- _M . ล -ั- น _M . จ เ- _M . ล โ- _M
buran	บ -ุ _L . ร -า- น _M
buren	บ -ิว _M . ร เ-- น _M
van	ว แ-- น _M
burian	บ -ิว _M . ร เ-ีย- น _M
buroshi	บ -ุ _L . ร โ- _M . ช -ิ _H
burrough	บ เ-อ _M . ร โ- _M
burundi	บ -ุ _L . ร -ุ- น _M . ด -ี _M
busy	บ -ิ _L . ซ -ี _M
butane	บ -ิว _M . ท เ-- น _M
buzek	บ -ู _M . ซ เ-็- ก _H
byam	บ ไ- _M . อ เอิ- ม _M . อ เ-ิ- ม _M
bye	บ -าย _M
byng	บ -ิ- ง _M
byram	บ -ี _M . ร เ-ิ- ม _M
caan	ค -า- น _M
cabin	ค เ- _M . บ -ิ- น _M
cad	ค แ-- ด _F
caddy	ค แ-- ด _F . ด -ี _M
cadman	ค แ-- ด _F . ม เ-ิ- น _M
caen	ก -็อ- ง _M
cafeteria	ค แ- _M . ฟ เ- _M . ท -ี _M . ร เ-ีย _M
cafiero	ค แ- _M . ฟ -ี _M . อ เ- _M . ร โ- _M
cahan	ค แ- _M . ฮ เ-ิ- น _M
cahoon	ค เ-อ _M . ฮ -ู- น _M
cai	ซ -ี _M . อ เ- _M . อ ไ- _M
cain	ค เ-- น _M
caine	ค เ-- น _M
cairo	ค ไ- _M . ร โ- _M
caisson	ค เ- _M . ซ -อ- ง _M
cal	ค แ- _M . ล แ- _M
calcic	ค แ- _M . ล แ- _M . ซ -ิ- ก _H
calcium	ค แ- _M . ล แ- _M . ซ เ-ีย- ม _M
cale	ค เ- _M . ล เ- _M
caleb	ค เ- _M . ล เ-ิ- บ _F
calhoun	ค แ- _M . ล แ- _M . ฮ -ู- น _M
calio	ค แ- _M . ล -ี _M . อ โ- _M
callaghan	ค แ- _M . ล แ- _M . ล เ-อ _M . ฮ แ-- น _M
callen	ค แ- _M . ล แ- _M . ล เ-ิ- น _M
callick	ค แ- _M . ล แ- _M . ล -ิ- ก _H
callison	ค แ- _M . ล แ- _M . ล -ี _M . ส -ั- น _R
callow	ค แ- _M . ล แ- _M . ล โ- _M
calorie	ค แ- _M . ล -อ _M . ร -ี _M
cam	ค แ-- ม _M
cambium	ค แ-- ม _M . บ เ-ีย- ม _M
camden	ค แ-- ม _M . ด เ-ิ- น _M
cameron	ค แ- _M . ม เ- _M . ร -อ- น _M
cameroon	ค แ- _M . ม เ-อ _M . ร -ู- น _M
cameroun	ค แ- _M . ม เ-อ _M . ร -ู- น _M
campaigne	ค แ-- ม _M . พ เ-- น _M
camping	ค แ-- ม _M . ป -ิ- ง _M
campo	ก -ั- ม _M . ป โ- _M
can	ค แ-- น _M
canavan	ค แ-- น _M . น เ-อ _M . ว แ-- น _M
candy	ค แ-- น _M . ด -ี _M
cane	ค เ-- น _M
canham	ค แ-- น _M . ฮ เ-ิ- ม _M
canning	ค แ-- น _M . น -ิ- ง _M
canoe	ค แ- _M . น -ู _M
canteen	ค แ-- น _M . ท -ี- น _M
canyon	ค แ-- น _M . ย -อ- น _M
capelin	ค แ- _M . ล เ-ิ- น _M . พ เ-ิ- น _M
capell	ค -อ _M . ล เ- _M . ป เ- _M
capon	ค เ- _M . ป -อ- น _M
merisi	ม เ- _M . ร -ี _M . ซ -ี _M
caribbean	ค แ- _M . ร -ิ- บ _H . บ เ-ีย- น _M
caribou	ค แ- _M . ร -ิ _H . บ -ู _M
carin	ค แ- _M . ร -ิ- น _M
simon	ซ ไ- _M . ม -อ- น _M
hoagy	ฮ โ- _M . ก -ี _M
carolan	ค แ- _M . ร -อ _M . ล แ-- น _M
king	ค -ิ- ง _M
caroline	ค แ- _M . ร โ- _M . ล -ิ- น _M
carolyn	ค แ- _M . ร โ- _M . ล -ิ- น _M
vikki	ว -ิ- ก _H . ก -ี _M
carrion	ค เ- _M . ร เ-ีย- น _M
carrow	ค แ- _M . ร โ- _M
carry	ค แ- _M . ร -ี _M
cary	ค แ- _M . ร -ี _M
casad	ค แ- _M . ซ เ-ิ- ด _F
casein	ค เ- _M . ซ -ี- น _M
cashin	ค แ- _M . ช -ิ- น _M
casimir	ค แ- _M . ซ -ี _M . ม เ-ีย _M
cason	ค แ- _M . ส -ั- น _R
catabolism	ค แ- _M . ท แ- _M . บ -อ _M . ล -ิ _H . ซ -ึ- ม _M
phoebe	ฟ -ี _M . บ -ี _M
catherine	ค แ- _M . ท เ-อ _M . ร -ิ- น _M
catherine	ค แ- _M . ท เ-อ _M . ร -ี- น _M
caton	ค แ- _M . ต เ-ิ- น _M
catron	ค แ- _M . ท เ- _M . ร -ิ- น _M
cauchy	ค โ- _M . ช -ี _M
cauchy	ค โ- _M . ซ -ี _M
cavan	ค แ- _M . ว เ-ิ- น _M
cavanagh	ค แ- _M . ว เ-ิ- น _M . น แ-็- ก _H
cavanaugh	ค แ- _M . ว เ-อ _M . น -อ _M
cave	ค เ-- ฟ _F
cbod	ซ -ี _M . บ -ี _M . อ โ- _M . ด -ี _M
cc	ซ -ี _M . ซ -ี _M
ccd	ซ -ี _M . ซ -ี _M . ด -ี _M
cctv	ซ -ี _M . ซ -ี _M . ท -ี _M . ว -ี _M
ccu	ซ -ี _M . ซ -ี _M . ย -ู _M
cd	ซ -ี _M . ด -ี _M
cdma	ซ -ี _M . ด -ี _M . อ เอ็- ม _M . อ เ-็- ม _M . อ เ- _M
cebu	ซ เ- _M . บ -ู _M
cech	ซ เ-็- ก _H
cecilia	ซ -ิ _H . ซ -ี _M . ล เ-ีย _M
cecilia	ซ เ- _M . ซ -ี _M . ล เ-ีย _M
cecily	ซ -ิ _H . ซ -ี _M . ล -ี _M
cecily	ซ เ- _M . ซ -ิ _H . ล -ี _M
cedric	ซ เ-- ด _F . ร -ิ- ก _H
celery	ซ เ- _M . ล เ- _M . ร -ี _M
celery	ซ เ- _M . ล เ-อ _M . ร -ี _M
celia	ซ -ี _M . ล เ-ีย _M
benvenuto	บ เ-- น _M . ว เ- _M . น -ู _M . ต โ- _M
celtic	ค เ- _M . ล เ- _M . ต -ิ- ก _L
centigram	ซ เ-- น _M . ต -ิ _L . ก -ั- ม _M . ร -ั- ม _M
centigramme	ซ เ-- น _M . ต -ิ _L . ก -ั- ม _M . ร -ั- ม _M
centum	ค เ-- น _M . ต -ุ- ม _M
cerebrum	ซ เ- _M . ร -ี- บ _F . ร -ั- ม _M
cerium	ซ -ี _M . ร เ-ีย- ม _M
cesium	ซ -ี _M . ซ เ-ีย- ม _M
cetane	ซ -ี _M . ท เ-- น _M
ceylon	ซ -ี _M . ล -อ- น _M
cg	ซ -ี _M . จ -ี _M
cgi	ซ -ี _M . จ -ี _M . อ ไ- _M
chad	ช -า- ด _F
chadwick	ช แ-- ด _F . ว -ิ- ก _H
chain	ช เ-- น _M
champignon	ช แ-- ม _M . ป -ี _M . ย -อ- ง _M
champion	ช แ-- ม _M . ป เ-ีย- น _M
champlin	ช แ-- ม _M . ล -ิ- น _M . พ -ิ- น _M
chancery	ช -า- น _M . ซ เ-อ _M . ร -ี _M
chaperon	ช แ- _M . ป เ-อ _M . ร โ-- น _M
chaperone	ช แ- _M . ป เ-อ _M . ร โ-- น _M
chave	ช เ-- ฟ _F
check	ช เ-็- ก _H
cheek	ช -ี- ก _F
chef	ช เ-- ฟ _F
cheff	ช เ-- ฟ _F
cheke	ช -ิ- ก _H
chekhov	ช เ- _M . ค -อ- ฟ _F
anton	อ แ-- น _M . ต -ั- น _M
chemo	ค -ี _M . ม โ- _M
cherokee	ช เ- _M . ร โ- _M . ก -ี _M
cherub	ช เ- _M . ร -ั- บ _H
cheyenne	ช ไ- _M . อ เ-- น _M
chi	ค ไ- _M
chic	ช -ิ- ก _H
chick	ช -ิ- ก _H
chicory	ช -ิ _H . ค -อ _M . ร -ี _M
chile	ช -ิ _H . ล -ี _M
chili	ช -ิ _H . ล -ี _M
chimpanzee	ช -ิ- ม _M . ป แ-- น _M . ซ -ี _M
ching	ช -ิ- ง _M
chinn	ช -ิ- น _M
chinook	ช -ิ _H . น -ุ- ก _H
chinook	ช -ี _M . น -ุ- ก _H
chinoy	ช -ี _M . น -อย _M
chitin	ค ไ- _M . ต -ิ- น _M
chitin	ค ไ- _M . ท -ิ- น _M
chiton	ค ไ- _M . ต -ั- น _M
chlorine	ค -อ _M . ล -อ _M . ร -ี- น _M
chlororganic	ค -อ _M . ล -อ _M . ร โ- _M . ก แ- _M . น -ิ- ก _H
noam	น โ-- ม _M
chopin	ช โ- _M . ป แ-- ง _M
frederic	ฟ เ- _M . ร เ- _M . ด เ- _M . ร -ี- ก _F
chorion	ค -อ _M . ร -ิ _H . อ -อ- น _M
chorizo	ช โ- _M . ร -ิ _H . ซ โ- _M
chown	ช โ-- น _M
choy	ช -อย _M
christen	ค -ี _M . ร -ี _M . ซ เ-ิ- น _M
chromaffin	ค โ- _M . ร โ- _M . ม แ-- ฟ _F . ฟ -ิ- น _M
chromosome	ค โ- _M . ร โ- _M . ม โ- _M . ซ โ-- ม _M
chubb	ช -ั- บ _H
chuck	ช -ั- ก _H
chukchee	ช -ุ- ก _H . ช -ี _M
cia	ซ -ี _M . อ ไ- _M . อ เ- _M
cicero	ซ -ิ _H . ซ เ- _M . ร โ- _M
cif	ซ -ี _M . อ ไ- _M . อ เ-- ฟ _L
ciliate	ซ -ิ _H . ล -ิ _H . อ เ-- ด _L
cim	ซ -ี _M . อ ไ- _M . อ เอ็- ม _M . อ เ-็- ม _M
cindy	ซ -ิ- น _M . ด -ี _M
cinnamon	ซ -ิ- น _M . น เ- _M . ม -อ- น _M
cio	ซ -ี _M . อ ไ- _M . อ โ- _M
cirillo	ซ -ี _M . ร -ี _M . ล โ- _M
ciro	ซ -ี _M . ร โ- _M
citron	ซ -ี _M . ท เ- _M . ร -ิ- น _M
city	ซ -ิ _H . ต -ี _M
cizek	ช -ิ _H . ซ เ-็- ก _H
tom	ท -อ- ม _M
eric	อ เ- _M . ร -ิ- ก _H
clason	ค แ- _M . ล แ- _M . ส -ั- น _R
claud	ค -็อ- ด _H . ล -็อ- ด _H
claude	ค -อ- ด _F . ล -อ- ด _F
claudine	ค -อ _M . ล -อ _M . ด -ี- น _M
clave	ค -ี- ฟ _F . ล -ี- ฟ _F
clawson	ค -อ _M . ล -อ _M . ส -ั- น _R
clean	ค -ี- น _M . ล -ี- น _M
clee	ค -ี _M . ล -ี _M
cleeve	ค -ี- ฟ _F . ล -ี- ฟ _F
clement	ก เ- _M . ล เ- _M . ม -อ- ง _M
clementine	ค เ- _M . ล เ- _M . ม -็อ- ง _M . ต -ี- น _M
cleo	ค -ี _M . ล -ี _M . อ โ- _M
clerihew	ค เ- _M . ล เ- _M . ร -ิ _H . ฮ -ิว _M
cleverly	ค เ- _M . ล เ- _M . ว เ-อ _M . ล -ี _M
cliffe	ค -ี- ฟ _F . ล -ี- ฟ _F
clifton	ค -ิ- ฟ _H . ล -ิ- ฟ _H . ต -ั- น _M
clinic	ค -ิ _H . ล -ิ _H . น -ิ- ก _H
clinton	ค -ิ- น _M . ล -ิ- น _M . ต -ั- น _M
clio	ค -ี _M . ล -ี _M . อ โ- _M
cloisonne	ก -ัว _M . ล -ัว _M . ซ -อ- น _M . น เ- _M
clough	ค -ู- ฟ _F . ล -ู- ฟ _F
club	ค -ั- บ _H . ล -ั- บ _H
clubb	ค -ั- บ _H . ล -ั- บ _H
clune	ค -ู- น _M . ล -ู- น _M
clung	ค -ั- ง _M . ล -ั- ง _M
cng	ซ -ี _M . อ เอ็- น _M . อ เ-็- น _M . จ -ี _M
cnn	ซ -ี _M . อ เอ็- น _M . อ เ-็- น _M . อ เอ็- น _M . อ เ-็- น _M
co	ค โ- _M
coad	ค โ-- ด _F
cobbing	ค -อ- บ _F . บ -ิ- ง _M
cobden	ค -อ- บ _F . ด เ-- น _M
cobo	ค โ- _M . บ โ- _M
coby	ค โ- _M . บ -ี _M
cocaine	ค โ- _M . ค เ-- น _M
cochlea	ค -อ _M . ค เ-ีย _M . ล เ-ีย _M
eddie	อ เ-- ด _L . ด -ี _M
joe	จ โ- _M
cod	ค -็อ- ด _H
codd	ค -อ- ด _F
code	ค โ-- ด _F
codec	ค โ- _M . ด เ-- ก _L
codon	ค โ- _M . ด -อ- น _M
coe	ค โ- _M
coffin	ค -อ- ฟ _F . ฟ -ิ- น _M
cohan	ค โ- _M . ฮ เ-ิ- น _M
cohen	ค โ- _M . ฮ เ-- น _M
cohu	ค -อ _M . ฮ -ู _M
colden	ค โ- _M . ล โ- _M . ด เ-ิ- น _M
coleman	ค โ- _M . ล โ- _M . ม เ-ิ- น _M
coleman	ค โ- _M . ล โ- _M . ม แ-- น _M
coleraine	ค โ- _M . ล เ-อ _M . ร เ-- น _M
colgan	ก โ- _M . ล โ- _M . ก เ-ิ- น _M
colin	ค -อ _M . ล -ิ- น _M
collinson	ค -อ _M . ล -ิ- น _M . ส -ั- น _R
colm	ค โ-- ม _M
colman	ค โ- _M . ล โ- _M . ม เ-ิ- น _M
colombo	ค โ- _M . ล -ั- ม _M . บ โ- _M
colony	ค โ- _M . ล โ- _M . น -ี _M
colson	ค โ- _M . ล โ- _M . ส -ั- น _R
columbia	ค โ- _M . ล -ั- ม _M . บ เ-ีย _M
columbium	ค โ- _M . ล -ั- ม _M . บ เ-ีย- ม _M
colvin	ค โ- _M . ล โ- _M . ว -ิ- น _M
com	ค -อ- ม _M
com	ซ -ี _M . อ โ- _M . อ เอ็- ม _M . อ เ-็- ม _M
comden	ค -อ- ม _M . ด เ-- น _M
come	ค -ั- ม _M
comecon	ค โ- _M . ม เ- _M . ค -อ- น _M
commando	ค -อ- ม _M . ม -า- น _M . ด โ- _M
common	ค -อ- ม _M . ม เ-ิ- น _M
commune	ค -อ- ม _M . ม -ู- น _M
communication	ค -อ- ม _M . ม -ิว _M . น -ิ _H . ค เ- _M . ช -ั- น _M
communism	ค -อ- ม _M . ม -ิว _M . น -ิ _H . ซ -ึ- ม _M
como	ค โ- _M . ม โ- _M
comoro	ค โ- _M . ม โ- _M . ร โ- _M
competition	ค -อ- ม _M . พ -ิ _H . ท เ- _M . ช -ั- น _M
conakry	ก โ- _M . น -า- ก _F . ร -ี _M
conakry	ค โ- _M . น -า- ก _F . ร -ี _M
condominium	ค -อ- น _M . ด โ- _M . ม -ิ _H . น เ-ีย- ม _M
conduction	ค -อ- น _M . ด -ั- ก _L . ช -ั- น _M
cone	ค โ-- น _M
congo	ค -อ- ง _M . ก โ- _M
congregation	ค -อ- ง _M . ก -ี _M . ร -ี _M . ก เ- _M . ช -ั- น _M
congreve	ค -อ- น _M . ก -ี- ฟ _L . ร -ี- ฟ _L
conic	ค โ- _M . น -ิ- ก _H
jimmy	จ -ิ- ม _M . ม -ี _M
connie	ค -อ- น _M . น -ี _M
conrad	ค -อ- น _M . ร -า- ด _F
joseph	จ โ- _M . ซ เ-- ฟ _F
sam	ซ แ-- ม _M
coolie	ก -ุ _L . ล -ี _M
cop	ซ -ี _M . อ โ- _M . พ -ี _M
copenhagen	ค โ- _M . ป เ-- น _M . ฮ เ- _M . ก เ-- น _M
le	ล เ-อ _M
coroutine	ค โ- _M . ร -ู _M . ท -ี- น _M
coupe	ค -ู _M . ป เ- _M
cowboy	ค -าว _M . บ -อย _M
cpm	ซ -ี _M . พ -ี _M . อ เอ็- ม _M . อ เ-็- ม _M
cpu	ซ -ี _M . พ -ี _M . ย -ู _M
cream	ค -ี- ม _M . ร -ี- ม _M
creative	ค -ี _M . ร -ี _M . อ เ- _M . ท -ิ- ฟ _H
creative	ค -ี _M . ร -ี _M . อ เ- _M . ท -ี- ฟ _F
crimea	ค ไ- _M . ร ไ- _M . ม เ-ีย _M
croatia	ค โ- _M . ร โ- _M . อ เ- _M . ช เ-ีย _M
croce	ค โ- _M . ร โ- _M . ช เ- _M
jim	จ -ิ- ม _M
croissant	ก -ัว _M . ร -ัว _M . ซ -อ- ง _M
cromlech	ค -อ- ม _M . ร -อ- ม _M . ล เ-- ก _F
croton	ก โ- _M . ร โ- _M . ต -ั- น _M
crusade	ค -ู _M . ร -ู _M . ซ เ-- ด _F
crusade	ค -ู _M . ร -ู _M . ส เ-- ด _L
cryophilic	ค -ี _M . ร -ี _M . อ โ- _M . ฟ -ิ _H . ล -ิ- ก _H
ctt	ซ -ี _M . ท -ี _M . ท -ี _M
cubic	ค -ิว _M . บ -ิ- ก _L
cubism	ค -ิว _M . บ -ิ _L . ซ -ึ- ม _M
cue	ค -ิว _M
cuisine	ก -ุย _M . ซ -ี- น _M
cuisine	ค -ิ _H . ว -ิ _H . ซ -ี- น _M
cuisine	ค -ี _M . ว -ี _M . ซ -ี- น _M
cunningham	ค -ั- น _M . น -ิ- ง _M . ฮ แ-- ม _M
cupid	ค -ิว _M . ป -ิ- ด _L
cupid	ค -ิว _M . พ -ิ- ด _H
curie	ค -ู _M . ร -ี _M
curium	ค -ู _M . ร เ-ีย- ม _M
curium	ค เ-อ _M . ร เ-ีย- ม _M
cusack	ค -ู _M . ซ แ-็- ก _H
cusec	ค -ิว _M . ซ เ-- ก _F
cutin	ค -ิว _M . ท -ิ- น _M
cwm	ค -ั- ม _M
cyclomatic	ซ ไ- _M . ค โ- _M . ล โ- _M . ม เ- _M . ต -ิ- ก _L
cynthia	ซ -ิ- น _M . ท เ-ีย _M
cyprian	ซ -ี _M . ร เ-ีย- น _M . พ เ-ีย- น _M
cyrene	ซ ไ- _M . ร -ี _M . น -ี _M
czech	ช เ-็- ก _H
daan	ด -า- น _M
dac	ด -ี _M . อ เ- _M . ซ -ี _M
dack	ด แ-็- ก _L
daemon	ด -ี _M . ม -อ- น _M
daf	ด -ี _M . อ เ- _M . อ เ-- ฟ _L
daf	ด แ-- ฟ _L
daff	ด แ-- ฟ _L
dafoe	ด แ- _M . ฟ โ- _M
dague	ด -็อ- ก _L
daily	ด เ- _M . ล -ี _M
dain	ด เ-- น _M
dairy	ด แ- _M . ร -ี _M
daisy	ด เ- _M . ซ -ี _M
dalke	ด เ- _M . ล -ึ- ก _H
daly	ด เ- _M . ล -ี _M
dame	ด เ-- ม _M
damon	ด เ- _M . ม เ-ิ- น _M
dan	ด แ-- น _M . น -ี _M
dandelion	ด แ-- น _M . ด -ิ _L . ล เ-ีย- น _M
dandy	ด แ-- น _M . ด -ี _M
dane	ด เ-- น _M
danny	ด แ-- น _M . น -ี _M
dante	ด -ั- น _M . ต เ- _M
danzig	ด -า- น _M . ซ -ิ- ก _H
danzig	ด แ-- น _M . ซ -ิ- ก _H
daphne	ด แ-- ฟ _L . น -ี _M
daquino	ด -ั- ก _L . ค -ิ- น _M . ว -ิ- น _M . น โ- _M
daron	ด เ- _M . ร -อ- น _M
dat	ด -ี _M . อ เ- _M . ท -ี _M
dative	ด เ- _M . ท -ิ- ฟ _H
dau	ด โ- _M
daube	ด โ-- บ _L
daum	ด -อ- ม _M
daumier	ด โ- _M . ม -ี _M . ย เ- _M
daun	ด -อ- น _M
dave	ด เ-- ฟ _L
davidoff	ด เ- _M . ว -ี _M . ด -อ- ฟ _L
davidson	ด เ- _M . ว -ิ- ด _H . ส -ั- น _R
davidson	ด เ- _M . ว -ิ- ด _H . ซ เ-ิ- น _M
bowen	บ โ- _M . ว เ-- น _M
jack	จ แ-็- ก _L
davison	ด เ- _M . ว -ิ _H . ซ เ-ิ- น _M
davy	ด เ- _M . ว -ี _M
dc	ด -ี _M . ซ -ี _M
dcf	ด -ี _M . ซ -ี _M . อ เ-- ฟ _L
ddt	ด -ี _M . ด -ี _M . ท -ี _M
kooning	ค -ู _M . น -ิ- ง _M
dea	ด -ี _M
deam	ด -ี- ม _M
dean	ด -ี- น _M
deane	ด -ิ- น _M
deb	ด เ-- บ _L
debbie	ด เ-- บ _L . บ -ี _M
debby	ด เ-- บ _L . บ -ี _M
debenham	ด เ-อ _M . บ -ิ- น _M . ฮ เ-ิ- ม _M
deblois	ด เ-- บ _L . ล -ู _M
debo	ด -ี _M . บ โ- _M
debreu	ด -ี- บ _L . ร -ู _M
debussy	ด เ-อ _M . บ -ู _M . ซ -ี _M
debye	ด เ- _M . บ -าย _M
deci	ด เ- _M . ซ -ิ _H
decigram	ด เ- _M . ซ -ิ _H . ก -ั- ม _M . ร -ั- ม _M
decigramme	ด เ- _M . ซ -ิ _H . ก -ั- ม _M . ร -ั- ม _M
deck	ด เ-- ก _L
dee	ด -ี _M
deejay	ด -ี _M . จ เ- _M
definitive	ด เ- _M . ฟ -ิ _H . น -ิ _H . ท -ี- ฟ _F
defoe	ด -ิ _L . ฟ โ- _M
defoe	ด เ- _M . ฟ โ- _M
degraff	ด เ- _M . ก เ-ิ- ฟ _L . ร เ-ิ- ฟ _L
degree	ด -ี- ก _L . ร -ี _M
deighton	ด เ- _M . ต -ั- น _M
eugene	อ เ-อ _M . ช แ-- น _M
delaney	ด เ-อ _M . ล เ- _M . น -ี _M
delavan	ด เ- _M . ล เ-อ _M . ว เ-ิ- น _M
delivery	ด -ิ _L . ล -ิ _H . ว เ-อ _M . ร -ี _M
delivery	ด เ- _M . ล -ิ _H . ว เ-อ _M . ร -ี _M
delong	ด เ-อ _M . ล -อ- ง _M
deloraine	ด เ-อ _M . ล -อ _M . ร เ-- น _M
deman	ด -ี _M . ม เ-ิ- น _M
deming	ด เ- _M . ม -ิ- ง _M
demo	ด -ี _M . ม โ- _M
democracy	ด -ิ _L . ม -อ _M . ค เ- _M . ร เ- _M . ซ -ี _M
democratic	ด เ- _M . ม โ- _M . ค เ- _M . ร เ- _M . ต -ิ- ก _L
den	ด เ-- น _M
dene	ด -ี- น _M
dene	ด เ-- น _M
deneb	ด เ- _M . น เ-็- บ _H
denecke	ด เ- _M . น เ-ิ- ก _F
denham	ด เ-อ _M . น เ-ิ- ม _M
denham	ด เ- _M . น แ-- ม _M
denike	ด เ- _M . น -ิ- ก _H
denikin	ด เ- _M . น -ี _M . ก -ิ- น _M
denim	ด เ- _M . น -ิ- ม _M
denis	ด เ-อ _M . น -ี _M
denison	ด เ- _M . น -ี _M . ส -ั- น _R
dennehy	ด เ-- น _M . น -ี _M . ฮ -ี _M
dennison	ด เ-- น _M . น -ิ _H . ส -ั- น _R
denny	ด เ-- น _M . น -ี _M
robyn	ร -อ _M . บ -ิ- น _M
dension	ด เ-- น _M . ช เ-ิ- น _M
denson	ด เ-- น _M . ส -ั- น _R
deoxyribonucleic	ด -ี _M . อ -อ- ก _L . ซ -ิ _H . ร ไ- _M . บ โ- _M . น -ิว _M . ค -ิ _H . ล -ิ _H . อ อิ- ก _L
deque	ด เ-- ก _L
derek	ด -ี _M . ร เ-- ก _F
bo	บ โ- _M
derick	ด เ- _M . ร -ิ- ก _H
deroche	ด เ- _M . ร เ-ิ- ก _F
rene	ร เ-อ _M . น เ- _M
deschamps	ด เ- _M . ช -อ- ง _M
desonia	ด เ- _M . ซ โ- _M . น เ-ีย _M
desoria	ด -ิ _L . ซ -อ _M . ร เ-ีย _M
deuterium	ด -ิว _M . ท -ี _M . ร เ-ีย- ม _M
deuterium	ด -ิว _M . ท เ-อ _M . ร เ-ีย- ม _M
deuteron	ด -ิว _M . ท เ-อ _M . ร -อ- น _M
deuton	ด -ิว _M . ต -อ- น _M
devane	ด -ี _M . ว เ-- น _M
devaughn	ด เ- _M . ว -อ- น _M
devcon	ด เ-- ฟ _L . ค เ-ิ- น _M
devereux	ด เ- _M . ว เ-อ _M . ร เ-อ _M
devid	ด เ- _M . ว -ิ- ด _H
devin	ด เ- _M . ว -ิ- น _M
devlin	ด เ-- ฟ _L . ล -ิ- น _M
devoe	ด -ี _M . ว โ- _M
devoy	ด เ- _M . ว -อย _M
dew	ด -ิว _M
dewe	ด -ู _M
di	ด ไ- _M
diane	ด ไ- _M . อ แ-- น _M
dichotic	ด ไ- _M . ค โ- _M . ต -ิ- ก _L
dick	ด -ิ- ก _L
dicke	ด -ิ- ก _L
dickie	ด -ิ- ก _L . ก -ี _M
dickson	ด -ิ- ก _L . ส -ั- น _R
die	ด -าย _M
diefenbach	ด -ี _M . ฟ -ิ- น _M . บ -ั- ก _L
dieffenbach	ด -ี _M . ฟ -ิ- น _M . บ -ั- ก _L
dielectric	ด ไ- _M . อ อิ _L . ล เ-็- ก _H . ร -ิ- ก _L . ต -ิ- ก _L
diem	ด เ-ีย- ม _M
ngo	ง โ- _M
dighton	ด ไ- _M . ต -ั- น _M
digraph	ด ไ- _M . ก -า- ฟ _L . ร -า- ฟ _L
dim	ด -ิ- ม _M
dimmick	ด -ี _M . ม -ิ- ก _H
ding	ด -ิ- ง _M
diode	ด ไ- _M . อ โ-- ด _L
dion	ด -ิ _L . อ -อ- น _M
celine	ซ เ- _M . ล -ี- น _M
dioxin	ด ไ- _M . อ -อ- ก _L . ซ -ิ- น _M
dipole	ด ไ- _M . ล โ- _M . พ โ- _M
dirac	ด -ิ _L . ร แ-- ก _F
directory	ด ไ- _M . ร เ-- ก _F . ท -อ _M . ร -ี _M
dirichlet	ด -ี _M . ร -ี _M . ค เ- _M . ล เ- _M
diven	ด ไ- _M . ว เ-ิ- น _M
dj	ด -ี _M . จ เ- _M
djibouti	จ -ิ _L . บ -ู _M . ต -ี _M
djibuti	จ -ิ _L . บ -ู _M . ต -ี _M
dnpao	ด -ี _M . อ เอ็- น _M . อ เ-็- น _M . พ -ี _M . อ เ- _M . อ โ- _M
do	ด -ี _M . อ โ- _M
doab	ด โ- _M . อ -า- บ _L
dobb	ด -็อ- บ _L
dobrin	ด -ั- บ _L . บ -็ _L . ร -ิ- น _M
dobson	ด -อ- บ _L . ส -ั- น _R
dock	ด -็อ- ก _L
baby	บ เ- _M . บ -ี _M
dohm	ด -อ- ม _M
doily	ด -อย _M . ล -ี _M
dolan	ด โ- _M . ล เ-ิ- น _M
dom	ด -อ- ม _M
domain	ด โ- _M . ม เ-- น _M
doman	ด -ู _M . ม เ-ิ- น _M
dome	ด โ-- ม _M
domike	ด -อ _M . ม -ิ- ก _H
domingo	ด โ- _M . ม -ิ- ง _M . ก โ- _M
dominic	ด -อ _M . ม -ิ _H . น -ิ- ก _H
dominican	ด โ- _M . ม -ิ _H . น -ิ _H . ก -ั- น _M
dominick	ด -อ _M . ม เ-อ _M . น -ิ- ก _H
domino	ด โ- _M . ม -ิ _H . น โ- _M
dominoes	ด โ- _M . ม -ิ _H . น โ- _M
domm	ด -อ- ม _M
donagh	ด -อ _M . น แ- _M
donahue	ด -อ- น _M . น เ-อ _M . ฮ -ิว _M
done	ด -ั- น _M
donegan	ด -อ _M . น -ิ _H . ก แ-- น _M
donelan	ด -อ _M . น -ี _M . ล แ-- น _M
dong	ด -อ- ง _M
donimo	ด โ- _M . ม -ิ _H . น โ- _M
doniphan	ด -อ _M . น -ิ _H . ฟ เ-ิ- น _M
donoho	ด -อ- น _M . น เ-อ _M . ฮ โ- _M
donohue	ด -อ _M . น เ-อ _M . ฮ -ิว _M
donough	ด -อ _M . น เ-ิ- ฟ _F
doolin	ด -ู _M . ล -ิ- น _M
doone	ด -ู- น _M
doran	ด -อ _M . ร แ-- น _M
doreen	ด -อ _M . ร -ี- น _M
dorene	ด -อ _M . ร -ี- น _M
dorian	ด -อ _M . ร เ-ีย- น _M
dorothea	ด -อ _M . ร เ-อ _M . ท เ-ีย _M
dorothea	ด โ- _M . ร โ- _M . ท เ-ีย _M
dorothy	ด -อ _M . ร -อ _M . ท -ี _M
dorothy	ด -อ _M . ร โ- _M . ท -ี _M
dorothy	ด โ- _M . ร โ- _M . ท -ี _M
tommy	ท -อ- ม _M . ม -ี _M
doug	ด -ั- ก _L
dough	ด โ- _M
dove	ด โ-- ฟ _L
dowding	ด -าว _M . ด -ิ- ง _M
downing	ด -าว _M . น -ิ- ง _M
dowson	ด -าว _M . ส -ั- น _R
dpd	ด -ี _M . พ -ี _M . ด -ี _M
dqa	ด -ี _M . ค -ิว _M . อ เ- _M
dqis	ด -ี _M . ค -ิว _M . อ ไ- _M
dqos	ด -ี _M . ค -ิว _M . อ โ- _M
duane	ด -ู _M . อ เ-- น _M
dublin	ด -ั- บ _L . ล -ิ- น _M
dubois	ด -ู _M . บ -ัว _M
guy	ก -ี _M
pene	ป แ-- ง _M
dubuffet	ด -ู _M . บ -ู _M . ฟ เ- _M
jean	ช -อ- ง _M
ducane	ด -ู _M . ค เ-- น _M
duck	ด -ั- ก _L
dudok	ด เ-อ _M . ด -อ- ก _L
due	ด -ิว _M
dufferin	ด -ั- ฟ _L . ฟ -ิ- น _M . ร -ิ- น _M
duguid	ด -ั- ก _L . ว -ิ- ด _H
duin	ด -ู- น _M
dulin	ด -ู _M . ล -ิ- น _M
duly	ด -ู _M . ล -ี _M
dumaine	ด เ-อ _M . ม เ-- น _M
dumm	ด -ั- ม _M
dummy	ด -ั- ม _M . ม -ี _M
dumpy	ด -ั- ม _M . ป -ี _M
dun	ด -ั- น _M
duncan	ด -ั- ง _M . ค -ั- น _M
duncan	ด -ั- ง _M . ค แ-- น _M
duncan	ด -ั- น _M . ค แ-- น _M
dunham	ด -ั- น _M . ฮ เ-ิ- ม _M
duo	ด -ู _M . อ โ- _M
duodenum	ด -ู _M . อ -อ _M . ด -ิ _L . น -ั- ม _M
dupuy	ด เ-อ _M . พ ไ- _M
durack	ด -ู _M . อ เ-อ _M . ร แ-็- ก _H
durain	ด -ู _M . ร เ-- น _M
duran	ด -ู _M . ร แ-- น _M
durham	ด เ-อ _M . ร -ั- ม _M
duro	ด -ู _M . ร โ- _M
durrow	ด -อ _M . ร โ- _M
duryea	ด -ู _M . ร เ-ีย _M
dushanbe	ด -ู _M . ช -า- น _M . บ เ- _M
dvd	ด -ี _M . ว -ี _M . ด -ี _M
dyadic	ด ไ- _M . อ แ- _M . ด -ิ- ก _L
dylan	ด -ิ _L . ล แ-- น _M
dylan	ด -ิ _L . ล -ั- น _M
dyno	ด ไ- _M . น โ- _M
eamon	อ เ- _M . ม -อ- น _M
eamon	อ เ- _M . ม -ั- น _M
eard	อ เ-- ด _L
ebcdic	อ เ-- บ _L . ซ -ี _M . ด -ิ- ก _L
echlin	อ เอ็- ก _L . อ เ-็- ก _L . ล -ิ- น _M
eck	อ เอ็- ก _L . อ เ-็- ก _L
eckhoff	อ เอ็- ก _L . อ เ-็- ก _L . ฮ -อ- ฟ _F
ed	อ เ-- ด _L
eddison	อ เอ็- ด _L . อ เ-็- ด _L . ด -ี _M . ส -ั- น _R
eddy	อ เ-- ด _L . ด -ี _M
eddy	อ เอ็- ด _L . อ เ-็- ด _L . ด -ี _M
edelin	อ เ- _M . ด เ-อ _M . ล -ิ- น _M
edison	อ เ- _M . ด -ิ _L . ส -ั- น _R
a	อ เ- _M
edlin	อ เ-- ด _L . ล -ิ- น _M
edlund	อ เ-- ด _L . ล เ-ิ- น _M
edmonson	อ เอ็- ก _L . อ เ-็- ก _L . ม เ-ิ- น _M . ส -ั- น _R
edson	อ เ-- ด _L . ส -ั- น _R
edwood	อ เอ็- ด _L . อ เ-็- ด _L . ว -ู- ด _F
edwyn	อ เอ็- ด _L . อ เ-็- ด _L . ว -ิ- น _M
effingham	อ เ- _M . ฟ -ิ- ง _M . ฮ แ-- ม _M
efron	อ เ-- ฟ _L . ร -อ- น _M
eggnog	อ เ-- ก _L . น -็อ- ก _H
egloff	อ เ-- ก _L . ล -อ- ฟ _F
ehrich	อ เ- _M . ร -ิ- ก _H
eid	อ เ-- ด _L
eide	อ เ-- ด _L
eileen	อ ไ- _M . ล -ี- น _M
ekin	อ เ- _M . ก -ิ- น _M
ekman	อ เอ็- ก _L . อ เ-็- ก _L . ม -า- น _M
electric	อ อิ _L . ล เ-็- ก _H . ร -ิ- ก _L . ต -ิ- ก _L
elihu	อ เ- _M . ล -ิ _H . ฮ -ิว _M
elihu	อ เ- _M . ล -ี _M . ฮ -ู _M
ellin	อ เ- _M . ล -ิ- น _M
elling	อ เ- _M . ล -ิ- ง _M
ellingson	อ เ- _M . ล -ิ- ง _M . ส -ั- น _R
embry	อ เ-- ม _M . บ -็ _L . ร -ี _M
emery	อ เ- _M . ม เ-อ _M . ร -ี _M
emig	อ เ- _M . ม -ิ- ก _H
emilia	อ เ- _M . ม -ี _M . ล เ-ีย _M
emilio	อ เ- _M . ม -ี _M . ล เ-ียว _M
emison	อ เ- _M . ม -ี _M . ส -ั- น _R
emlyn	อ เ-- ม _M . ล -ิ- น _M
emme	อ เ-- ม _M
emmerich	อ เ- _M . ม เ-อ _M . ร -ิ- ก _H
emon	อ เ- _M . ม เ-ิ- น _M
emrick	อ เ-- ม _M . ร -ิ- ก _H
endymion	อ เ-- น _M . ด -ี _M . ม เ-ีย- น _M
engel	อ เ-- ง _M . ก เ- _M . ล เ- _M
engh	อ เ-- ง _M
engineering	อ เ-- น _M . จ -ิ _L . น เ-ีย _M . ร -ิ- ง _M
enid	อ เ- _M . น -ิ- ด _H
entity	อ เ-- น _M . ท -ิ _H . ต -ี _M
epitaxy	อ เ- _M . พ -ิ _H . ท แ-- ก _F . ซ -ี _M
erich	อ เ- _M . ร -ิ- ก _H
erickson	อ เ- _M . ร -ิ- ก _H . ส -ั- น _R
ericson	อ เ- _M . ร -ิ- ก _H . ส -ั- น _R
erik	อ เ- _M . ร -ิ- ก _H
erikson	อ เ- _M . ร -ิ- ก _H . ส -ั- น _R
eritrea	อ เ- _M . ร -ิ _H . ท เ-ีย _M . ร เ-ีย _M
esek	อ เ- _M . ซ เ-็- ก _H
essien	อ เ- _M . ซ -ิ- น _M
etang	อ เ- _M . ต -อ- ง _M
etesians	อ เ- _M . ท -ี _M . ซ เ-ีย- น _M
ethiopian	อ เ- _M . ท -ิ _H . อ โ- _M . ป เ-ีย- น _M
ethylene	อ เ- _M . ท -ิ _H . ล -ี- น _M
etic	อ เ- _M . ต -ิ- ก _L
eugenia	ย -ู _M . จ -ี _M . น เ-ีย _M
eulerian	ย -ู _M . ล เ- _M . ร เ-ีย- น _M
euphemia	ย -ู _M . ฟ -ี _M . ม เ-ีย _M
euro	ย -ู _M . ร โ- _M
europium	ย -ู _M . ร โ- _M . ป เ-ีย- ม _M
europium	ย -ู _M . ร โ- _M . พ เ-ีย- ม _M
evanson	อ เ- _M . ว เ-ิ- น _M . ส -ั- น _R
eveline	อ เ- _M . ว เ-อ _M . ล -ิ- น _M
evelyn	อ เ-- ฟ _L . ล -ิ- น _M
evelyn	อ เ- _M . ว เ- _M . ล -ี- น _M
evenson	อ เ- _M . ว -ิ- น _M . ส -ั- น _R
everingham	อ เ- _M . ว เ-อ _M . ร -ิ- ง _M . ฮ แ-- ม _M
evolution	อ เ- _M . ว โ- _M . ล -ู _M . ช -ั- น _M
evoy	อ เ- _M . ว -อย _M
eye	อ -าย _M
f	อ เ-- ฟ _L
fabian	ฟ เ- _M . บ เ-ีย- น _M
fabrizio	ฟ -า- บ _F . ร -ิ _H . ซ -ี _M . อ โ- _M
factory	ฟ แ-็- ก _H . ท -อ _M . ร -ี _M
fade	ฝ เ-- ด _L
fade	ฟ เ-- ด _F
fagen	ฟ แ-็- ก _H . ก เ-ิ- น _M
fagg	ฟ แ-็- ก _H
fahey	ฟ แ- _M . ฮ -ี _M
fahy	ฟ เ- _M . ฮ -ี _M
fail	ฟ เ- _M . ล เ- _M
faine	ฟ เ-- น _M
faison	ฟ เ- _M . ส -ั- น _R
fake	ฟ เ-- ก _F
fallin	ฟ แ- _M . ล แ- _M . ล -ิ- น _M
fallon	ฟ แ- _M . ล แ- _M . ล เ-ิ- น _M
fallow	ฟ แ- _M . ล โ- _M
family	ฟ แ- _M . ม -ิ _H . ล -ี _M
fan	ฟ แ-- น _M
fancy	ฟ แ-- น _M . ซ -ี _M
fane	ฟ เ-- น _M
fanning	ฟ แ-- น _M . น -ิ- ง _M
faq	อ เ-- ฟ _L . อ เ- _M . ค -ิว _M
faribault	ฟ แ- _M . ร -ี _M . บ โ- _M
faw	ฟ -อ _M
fazan	ฟ เ-อ _M . ซ -ั- น _M
fbi	อ เ-- ฟ _L . บ -ี _M . อ ไ- _M
fede	ฟ -ี- ด _F
fee	ฟ -ี _M
feedback	ฟ -ี- ด _F . บ แ-- ก _L
feel	ฟ -ิว _M
feike	ฟ -ิ- ก _H
fein	ฟ เ-- น _M
felicity	ฟ เ- _M . ล -ิ _H . ซ -ิ _H . ต -ี _M
fell	ฟ เ- _M . ล เ- _M
femto	ฟ เ-- ม _M . ต โ- _M
fenn	ฟ เ-- น _M
fenno	ฟ เ-- น _M . น โ- _M
fern	ฟ เ-ิ- น _M
feron	ฟ เ- _M . อ เ-อ _M . ร -อ- น _M
few	ฟ -ิว _M
ffb	อ เ-- ฟ _L . อ เ-- ฟ _L . บ -ี _M
fgd	อ เ-- ฟ _L . จ -ี _M . ด -ี _M
fi	ฟ ไ- _M
fiba	อ เ-- ฟ _L . อ ไ- _M . บ -ี _M . อ เ- _M
fick	ฟ -ิ- ก _H
ficke	ฟ -ิ- ก _H
fickian	ฟ -ิ- ก _H . ก เ-ีย- น _M
fid	อ เ-- ฟ _L . อ ไ- _M . ด -ี _M
fidelia	ฟ -ี _M . ด -ี _M . ล เ-ีย _M
fie	ฟ -ี _M
fiero	ฟ -ี _M . ร โ- _M
fifo	ฟ ไ- _M . ฟ โ- _M
figge	ฟ -ิ- ก _H
figi	ฟ -ิ _H . จ -ิ _L
fiji	ฟ -ิ _H . จ -ิ _L
filipinos	ฟ -ิ _H . ล -ิ _H . ป -ิ _L . น โ- _M
fin	ฟ -ิ- น _M
finegan	ฟ -ิ _H . น -ิ _H . ก แ-- น _M
finishing	ฟ -ิ _H . น -ิ _H . ช -ิ- ง _M
finneran	ฟ -ิ- น _M . น เ-อ _M . ร แ-- น _M
fino	ฟ -ิ _H . น โ- _M
finucane	ฟ -ิ _H . น เ-อ _M . ค เ-- น _M
fisu	ฟ -ิ _H . ซ -ู _M
flack	ฟ แ-็- ก _H . ล แ-็- ก _H
flagg	ฟ แ-็- ก _H . ล แ-็- ก _H
flavin	ฟ เ- _M . ล เ- _M . ว -ิ- น _M
dan	ด แ-- น _M
fleig	ฟ -ิ- ก _H . ล -ิ- ก _H
fleming	ฟ เ- _M . ล เ- _M . ม -ิ- ง _M
ian	อ เอีย- น _M . อ เ-ีย- น _M
flew	ฟ -ู _M . ล -ู _M
flick	ฟ -ิ- ก _H . ล -ิ- ก _H
flo	ฟ โ- _M . ล โ- _M
flocculation	ฟ -็อ- ก _H . ล -็อ- ก _H . ค -ู _M . ล เ- _M . ช -ั- น _M
flood	ฟ -ั- ด _H . ล -ั- ด _H
florio	ฟ -อ _M . ล -อ _M . ร -ิ _H . อ โ- _M
floyd	ฟ -อย _M . ล -อย _M
flug	ฟ -ั- ก _H . ล -ั- ก _H
fluke	ฟ -ุ- ก _H . ล -ุ- ก _H
flum	ฟ -ั- ม _M . ล -ั- ม _M
fluorine	ฟ -ู _M . ล -ู _M . อ -อ _M . ร -ี- น _M
foam	ฟ โ-- ม _M
fock	ฟ -ั- ก _H
focke	ฟ -็อ- ก _H
foden	ฟ โ- _M . ด เ-ิ- น _M
foehn	ฟ เ-ิ- น _M
fogg	ฟ -็อ- ก _H
foglia	ฟ -อ _M . ก เ-ีย _M . ล เ-ีย _M
fohn	ฟ เ-ิ- น _M
red	ร เ-- ด _F
folsom	ฟ โ- _M . ล โ- _M . ซ เ-ิ- ม _M
fondue	ฟ -อ- ง _M . ด -ู _M
fong	ฟ -อ- ง _M
fonteyn	ฟ -อ- น _M . ท -ิ- น _M
foram	ฟ -อ _M . ร แ-- ม _M
henry	ฮ เ-- น _M . ร -ี _M
jodie	จ โ- _M . ด -ี _M
foucault	ฟ -ู _M . ก โ- _M
foy	ฟ -อย _M
foye	ฟ -อย _M
piero	ป -ี _M . อ เ- _M . ร โ- _M
franco	ฟ -ั- ง _M . ร -ั- ง _M . ก โ- _M
helen	ฮ เ- _M . ล เ-- น _M
frear	ฟ เ-ีย _M . ร เ-ีย _M
frederic	ฟ เ- _M . ร เ- _M . ด เ-อ _M . ร -ิ- ก _H
frederick	ฟ เ- _M . ร เ- _M . ด เ- _M . ร -ี- ก _F
frederick	ฟ เ- _M . ร เ- _M . ด เ-อ _M . ร -ิ- ก _H
frederickson	ฟ เ- _M . ร เ- _M . ด เ-อ _M . ร -ิ- ก _H . ส -ั- น _R
free	ฟ -ี _M . ร -ี _M
freed	ฟ -ี- ด _F . ร -ี- ด _F
freeman	ฟ -ี _M . ร -ี _M . ม เ-ิ- น _M
freeman	ฟ -ี _M . ร -ี _M . ม แ-- น _M
freeon	ฟ -ี _M . ร -ี _M . อ -อ- น _M
freon	ฟ -ี _M . ร -ี _M . อ -อ- น _M
fri	ฟ -ี _M . ร -ี _M
frideric	ฟ -ิ _H . ร -ิ _H . ด เ- _M . ร -ิ- ก _H
friede	ฟ -ิ- ด _H . ร -ิ- ด _H
friedlich	ฟ -ิ- ด _H . ร -ิ- ด _H . ล -ิ- ก _H
friedman	ฟ -ี- ด _F . ร -ี- ด _F . ม แ-- น _M
frierson	ฟ เ-ีย _M . ร เ-ีย _M . ส -ั- น _R
frito	ฟ -ี _M . ร -ี _M . ท โ- _M
frog	ฟ -็อ- ก _H . ร -็อ- ก _H
frohlich	ฟ โ- _M . ร โ- _M . ล -ิ- ก _H
fromm	ฟ -อ- ม _M . ร -อ- ม _M
frothingham	ฟ -อ _M . ร -อ _M . ท -ิ- ง _M . ฮ แ-- ม _M
froude	ฟ -ู- ด _F . ร -ู- ด _F
fry	ฟ -าย _M . ร -าย _M
fta	อ เ-- ฟ _L . ท -ี _M . อ เ- _M
ftu	อ เ-- ฟ _L . ท -ี _M . ย -ู _M
fugitive	ฟ -ู _M . จ -ี _M . ท -ี- ฟ _F
fuji	ฟ -ู _M . จ -ิ _L
fuji	ฟ -ู _M . ย -ี _M
fume	ฟ -ู- ม _M
fumigation	ฟ -ู _M . ม -ิ _H . ก เ- _M . ช -ั- น _M
furan	ฟ -ู _M . ร แ-- น _M
fusain	ฟ -ิว _M . ซ เ-- น _M
fusion	ฟ -ิว _M . ช -ั- น _M
fuson	ฟ -ู _M . ส -ั- น _R
fusulinid	ฟ -ิว _M . ซ -ู _M . ล -ิ _H . น -ิ- ด _H
fyre	ฟ ไ- _M . ร เ-อ _M
g	จ -ี _M
kenny	ค เ-- น _M . น -ี _M
gabb	ก แ-็- บ _L
gac	จ -ี _M . อ เ- _M . ซ -ี _M
gadd	ก แ-- ด _L
gade	ก เ-- ด _L
gadolinium	ก แ- _M . ด โ- _M . ล -ิ _H . น เ-ีย- ม _M
gaede	ก -ิ- ด _L
gahan	ก แ- _M . ฮ เ-ิ- น _M
gahn	ก แ-- น _M
gajan	ก -อ _M . จ -อ- น _M
gaje	ก เ-ย _M
gal	ก แ- _M . ล แ- _M
galahad	ก แ- _M . ล เ-อ _M . ฮ แ-- ด _F
galea	ก เ- _M . ล เ-ีย _M
galilee	ก แ- _M . ล -ิ _H . ล -ี _M
gallery	ก แ- _M . ล แ- _M . ล เ-อ _M . ร -ี _M
galli	ก แ- _M . ล แ- _M . ล -ี _M
gallico	ก แ- _M . ล -ี _M . ค โ- _M
gallienne	ก แ- _M . ล แ- _M . ล -ี _M . อ เ-- น _M
gallium	ก แ- _M . ล แ- _M . ล เ-ีย- ม _M
gallivan	ก แ- _M . ล แ- _M . ล -ี _M . ว เ-ิ- น _M
gallon	ก แ- _M . ล แ- _M . ล -อ- น _M
gallons	ก แ- _M . ล แ- _M . ล -อ- น _M
galvanic	ก แ- _M . ล แ- _M . ว แ- _M . น -ิ- ก _H
gambia	ก แ-- ม _M . บ เ-ีย _M
game	ก เ-- ม _M
gane	ก เ-- น _M
gangtok	ก -ั- ง _M . ต -็อ- ก _L
gao	จ -ี _M . อ เ- _M . อ โ- _M
garabedian	ก แ- _M . ร เ-อ _M . บ -ิ _L . ด เ-ีย- น _M
abram	อ เ-- บ _L . ร -า- ม _M
judy	จ -ู _M . ด -ี _M
garrow	ก เ- _M . ร โ- _M
gary	ก แ- _M . ร -ี _M
gasolene	ก แ- _M . ซ โ- _M . ล -ี- น _M
gaughan	ก -อ _M . อ เอิ- น _M . อ เ-ิ- น _M
gauguin	ก โ- _M . ก แ-- ง _M
gaulle	ก โ- _M . ล โ- _M
gauvin	ก โ- _M . ว แ-- น _M
gazin	ก เ- _M . ซ -ิ- น _M
gdp	จ -ี _M . ด -ี _M . พ -ี _M
gear	ก เ-ีย _M
geelong	ก -ี _M . ล -อ- ง _M
geffen	ก เ-- ฟ _L . ฟ เ-- น _M
gehrig	ก แ- _M . ร -ิ- ก _H
gelman	ก เ- _M . ล เ- _M . ม เ-ิ- น _M
gene	จ -ี- น _M
gene	ย -ี- น _M
generation	จ เ- _M . น เ-อ _M . ร เ- _M . ช -ั- น _M
genevieve	จ เ-- น _M . น เ- _M . ว -ี- ฟ _F
geng	จ เ-- ง _M
genn	จ เ-- น _M
geo	ย -ี _M . อ -อ _M
geode	จ -ี _M . อ โ-- ด _L
geodesy	จ -ี _M . อ -อ _M . ด เ- _M . ซ -ี _M
geodesy	ย -ี _M . อ -อ _M . ด เ- _M . ซ -ี _M
geophone	จ -ี _M . อ โ- _M . ฟ โ-- น _M
georef	จ -ี _M . อ -อ _M . ร เ-- ฟ _F
georef	ย -ี _M . อ -อ _M . ร เ-- ฟ _F
boy	บ -อย _M
geranium	จ เ-อ _M . ร เ- _M . น เ-ีย- ม _M
geraud	จ เ-อ _M . ร โ-- ด _F
gerig	จ เ- _M . ร -ิ- ก _H
geronimo	จ เ- _M . ร -อ _M . น -ิ _H . ม โ- _M
geronimo	จ เ- _M . ร โ- _M . น -ิ _H . ม โ- _M
ghibli	ก -ิ- บ _L . ล -ิ _H
ghibli	ก -ิ- บ _L . ล -ี _M
gholson	ก โ- _M . ล โ- _M . ส -ั- น _R
giannini	จ -า- น _M . น -ี _M . น -ี _M
p	พ -ี _M
gibbon	ก -ิ- บ _L . บ -อ- น _M
gibli	ก -ิ- บ _L . ล -ิ _H
gibli	ก -ิ- บ _L . ล -ี _M
gibson	ก -ิ- บ _L . ส -ั- น _R
gide	ช -ี- ด _F
giesecke	ก -ี _M . ซ -ิ- ก _H
gif	จ -ิ- ฟ _L
gignoux	ก -ี _M . น -ู _M
gim	ก -ิ- ม _M
gimmick	ก -ิ- ม _M . ม -ิ- ก _H
gimson	ก -ิ- ม _M . ส -ั- น _R
ging	จ -ิ- ง _M
gingerich	ก -ิ- ง _M . ก เ-อ _M . ร -ิ- ก _H
ginn	จ -ิ- น _M
ginny	จ -ิ- น _M . น -ี _M
ginseng	จ -ิ- น _M . ซ เ-- ง _M
giro	ก -ี _M . ร โ- _M
giuliano	จ -ู _M . ล เ-ีย- น _M . น โ- _M
glacier	ก เ- _M . ล เ- _M . ซ เ-ีย _M
glasheen	ก เ-อ _M . ล เ-อ _M . ช -ิ- น _M
glaucophane	ก -อ _M . ล -อ _M . ค โ- _M . ฟ เ-- น _M
gleed	ก -ี- ด _L . ล -ี- ด _L
gleeman	ก -ี _M . ล -ี _M . ม แ-- น _M
gleization	ก -ี _M . ล -ี _M . ซ เ- _M . ช -ั- น _M
gleyzation	ก -ี _M . ล -ี _M . ซ เ- _M . ช -ั- น _M
glia	ก เ-ีย _M . ล เ-ีย _M
glidden	ก -ิ- ด _L . ล -ิ- ด _L . ด เ-- น _M
gloria	ก -อ _M . ล -อ _M . ร เ-ีย _M
glue	ก -ู _M . ล -ู _M
glycerin	ก -ี _M . ล -ี _M . ซ เ-อ _M . ร -ี- น _M
glycerine	ก -ี _M . ล -ี _M . ซ เ-อ _M . ร -ี- น _M
glycogen	ก ไ- _M . ล ไ- _M . ค โ- _M . จ เ-- น _M
glynn	ก -ิ- น _M . ล -ิ- น _M
gm	จ -ี _M . อ เอ็- ม _M . อ เ-็- ม _M
gmo	จ -ี _M . อ เอ็- ม _M . อ เ-็- ม _M . อ โ- _M
gmp	จ -ี _M . อ เอ็- ม _M . อ เ-็- ม _M . พ -ี _M
gmt	จ -ี _M . อ เอ็- ม _M . อ เ-็- ม _M . ท -ี _M
gnam	น แ-- ม _M
gnathion	น แ- _M . ท -ิ _H . อ -อ- น _M
gnomonic	น โ- _M . ม โ- _M . น -ิ- ก _H
goad	ก โ-- ด _L
gobelins	ก โ- _M . บ เ-อ _M . ล แ-- ง _M
godlove	ก -็อ- ด _L . ล -ั- ฟ _H
godman	ก -็อ- ด _L . ม เ-ิ- น _M
godson	ก -็อ- ด _L . ส -ั- น _R
godwin	ก -อ- ด _L . ว -ิ- น _M
godwin	ก -็อ- ด _L . ว -ิ- น _M
goethe	ก เ-อ _M . ท เ-อ _M
von	ฟ -อ- น _M
goffin	ก -อ- ฟ _L . ฟ -ิ- น _M
nikolai	น -ี _M . ค โ- _M . ล ไ- _M
golding	ก โ- _M . ล โ- _M . ด -ิ- ง _M
golec	ก โ- _M . ล -ิ- ก _H
golombek	ก โ- _M . ล -อ- ม _M . บ -ิ- ก _L
gombrich	ก -อ- ม _M . บ -็ _L . ร -ิ- ก _H
gomme	ก -อ- ม _M
gonorrhea	ก โ- _M . น โ- _M . ร เ-ีย _M
good	ก -ู- ด _L
goode	ก -ู- ด _L
goodman	ก -ู- ด _L . ม แ-- น _M
benny	บ เ-- น _M . น -ี _M
goody	ก -ู- ด _L . ด -ี _M
nadine	น เ- _M . ด -ี- น _M
goremykin	ก -อ _M . ร เ- _M . ม -ิ _H . ก -ิ- น _M
gosho	ก -อ _M . ช โ- _M
gothic	ก -อ _M . ท -ิ- ก _H
gothic	ก โ- _M . ท -ิ- ก _H
gough	ก -อ- ฟ _L
gounod	ก -ู _M . น โ- _M
gove	ก โ-- ฟ _L
gpa	จ -ี _M . พ -ี _M . อ เ- _M
graco	ก แ- _M . ร แ- _M . ก โ- _M
graffin	ก -า- ฟ _L . ร -า- ฟ _L . ฟ -ิ- น _M
grafton	ก -า- ฟ _L . ร -า- ฟ _L . ต เ-ิ- น _M
graham	ก เ- _M . ร เ- _M . ฮ แ-- ม _M
gram	ก -ั- ม _M . ร -ั- ม _M
gramme	ก -ั- ม _M . ร -ั- ม _M
granulation	ก แ- _M . ร แ- _M . น -ู _M . ล เ- _M . ช -ั- น _M
graph	ก -า- ฟ _L . ร -า- ฟ _L
graphic	ก -า- ฟ _L . ร -า- ฟ _L . ฟ -ิ- ก _H
gravy	ก เ- _M . ร เ- _M . ว -ี _M
graw	ก -อ _M . ร -อ _M
grawe	ก -อ _M . ร -อ _M
grede	ก -ี- ด _L . ร -ี- ด _L
gree	ก -ี _M . ร -ี _M
green	ก -ี- น _M . ร -ี- น _M
greene	ก -ี- น _M . ร -ี- น _M
greenham	ก -ี- น _M . ร -ี- น _M . อ เอิ- ม _M . อ เ-ิ- ม _M
greenhead	ก -ี- น _M . ร -ี- น _M . ฮ เ-- ด _F
greenleaf	ก -ี- น _M . ร -ี- น _M . ล -ิ- ฟ _H
greenman	ก -ี- น _M . ร -ี- น _M . ม เ-ิ- น _M
greenough	ก -ี _M . ร -ี _M . น โ- _M
horatio	ฮ -อ _M . ร เ- _M . ช -ี _M . อ โ- _M
greenwood	ก -ี- น _M . ร -ี- น _M . ว -ู- ด _F
greeson	ก -ี _M . ร -ี _M . ส -ั- น _R
gregale	ก -ี _M . ร -ี _M . ก เ- _M . ล เ- _M
grego	ก เ- _M . ร เ- _M . ก โ- _M
gregorio	ก เ- _M . ร เ- _M . ก โ- _M . ร เ-ียว _M
greim	ก -ิ- ม _M . ร -ิ- ม _M
greulich	ก -อย _M . ร -อย _M . ล -ิ- ก _H
greve	ก -ี- ฟ _L . ร -ี- ฟ _L
grew	ก -ู _M . ร -ู _M
grid	ก -ิ- ด _L . ร -ิ- ด _L
grieve	ก -ี- ฟ _L . ร -ี- ฟ _L
griff	ก -ี- ฟ _L . ร -ี- ฟ _L
griffin	ก -ิ- ฟ _L . ร -ิ- ฟ _L . ฟ -ิ- น _M
grim	ก -ิ- ม _M . ร -ิ- ม _M
grimshaw	ก -ิ- ม _M . ร -ิ- ม _M . ช -อ _M
grodno	ก -อ- ด _L . ร -อ- ด _L . น โ- _M
groening	ก โ- _M . ร โ- _M . น -ิ- ง _M
groff	ก -อ- ฟ _L . ร -อ- ฟ _L
groom	ก -ู- ม _M . ร -ู- ม _M
groome	ก -ู- ม _M . ร -ู- ม _M
groucho	ก -ู _M . ร -ู _M . ช โ- _M
growan	ก โ- _M . ร โ- _M . ว -า- น _M
grum	ก -ั- ม _M . ร -ั- ม _M
gruson	ก -ู _M . ร -ู _M . ส -ั- น _R
gryson	ก ไ- _M . ร ไ- _M . ส -ั- น _R
guam	ก -ว- ม _M
che	ช เ- _M
guguan	ก -ู _M . ก -ว- น _M
gui	ก -ุย _M
guillotine	ก -ิ _L . ย โ- _M . ต -ี- น _M
guin	ก -ิ- น _M
guinea	ก -ิ _L . น -ี _M
guinn	ก -ิ- น _M
guion	ค -ิ _H . ว -ิ _H . อ -อ- น _M
gulian	ก -ู _M . ล เ-ีย- น _M
gulick	ก -ิว _M . ล -ิ- ก _H
gum	ก -ั- ม _M
gumbo	ก -ั- ม _M . บ โ- _M
gunnison	ก -ั- น _M . น -ิ _H . ส -ั- น _R
gunson	ก -ั- น _M . ส -ั- น _R
guru	ก -ู _M . ร -ู _M
guru	ค -ุ _H . ร -ุ _H
gusev	ก -ิว _M . ซ เ-- ฟ _F
woody	ว -ู- ด _F . ด -ี _M
guy	ก -าย _M
gwilym	ค -ี _M . ว -ี _M . ล -ิ- ม _M
gwin	ก -ิ- น _M . ว -ิ- น _M
gyration	จ ไ- _M . ร เ- _M . ช -ั- น _M
gyro	จ ไ- _M . ร โ- _M
gyromagnetic	จ ไ- _M . ร โ- _M . ม แ-- ก _F . น เ- _M . ต -ิ- ก _L
haack	ฮ -า- ก _F
haag	ฮ -า- ก _F
haake	ฮ -า- ก _F
hack	ฮ แ-- ก _F
hack	ฮ แ-็- ก _H
hacke	ฮ แ-็- ก _H
hadlow	ฮ แ-- ด _F . ล โ- _M
haemoglobin	ฮ -ี _M . ม โ- _M . ก โ- _M . ล โ- _M . บ -ิ- น _M
haemoglobin	ฮ เ- _M . ม โ- _M . ก โ- _M . ล โ- _M . บ -ิ- น _M
haemophilia	ฮ -ี _M . ม โ- _M . ฟ -ิ _H . ล เ-ีย _M
haff	ฮ แ-- ฟ _F
hafnium	ฮ แ-- ฟ _F . น เ-ีย- ม _M
hag	ฮ แ-็- ก _H
hagelin	ฮ แ-็- ก _H . ก -ี _M . ล -ิ- น _M
hagg	ฮ แ-็- ก _H
hagge	ฮ แ-็- ก _H
hagman	ฮ แ-็- ก _H . ม เ-ิ- น _M
hague	ฮ เ-- ก _F
hahne	ฮ เ-- น _M
haig	ฮ เ-- ก _F
haigh	ฮ เ- _M
haiku	ฮ ไ- _M . ก -ุ _L
hain	ฮ เ-- น _M
haiti	ฮ เ- _M . ต -ิ _L
haiti	ฮ ไ- _M . ต -ี _M
hake	ฮ เ-- ก _F
halfon	ฮ แ- _M . ฟ เ-ิ- น _M
halo	ฮ เ- _M . ล โ- _M
halogen	ฮ แ- _M . ล โ- _M . จ เ-- น _M
halow	ฮ แ- _M . ล โ- _M
ham	ฮ แ-- ม _M
haman	ฮ เ- _M . ม เ-ิ- น _M
hamelin	ฮ แ-- ม _M . ม เ-อ _M . ล -ิ- น _M
hamitic	ฮ แ- _M . ม -ิ _H . ต -ิ- ก _L
hamlin	ฮ แ-- ม _M . ล -ิ- น _M
hamlyn	ฮ แ-- ม _M . ล -ิ- น _M
hammock	ฮ แ-- ม _M . ม เ-ิ- ก _F
hammon	ฮ แ-- ม _M . ม เ-ิ- น _M
hamrick	ฮ แ-- ม _M . ร -ิ- ก _H
hanafin	ฮ แ- _M . น เ-อ _M . ฟ -ิ- น _M
hanbury	ฮ แ-- น _M . บ เ-อ _M . ร -ี _M
haneke	ฮ แ- _M . น -ิ- ก _H
hankinson	ฮ แ-- ง _M . ค -ิ- น _M . ส -ั- น _R
hanlin	ฮ แ-- น _M . ล -ิ- น _M
hanlon	ฮ แ-- น _M . ล เ-ิ- น _M
hannifin	ฮ แ-- น _M . น -ี _M . ฟ -ิ- น _M
hanson	ฮ แ-- น _M . ซ เ-ิ- น _M
harry	ฮ แ- _M . ร -ี _M
harun	ฮ เ-อ _M . ร เ-ิ- น _M
hauck	ฮ -็อ- ก _H
hauf	ฮ -อ- ฟ _F
haug	ฮ -อ- ก _F
hauk	ฮ -็อ- ก _H
haun	ฮ -อ- น _M
have	ฮ แ-- ฟ _F
havelock	ฮ แ-- ฟ _F . ล -็อ- ก _H
havlik	ฮ แ-- ฟ _F . ว -ิ- ก _H
hawe	ฮ -อ _M
hawke	ฮ -็อ- ก _H
hawkinson	ฮ -อ _M . ค -ิ- น _M . ส -ั- น _R
haydn	ฮ ไ- _M . ด เ-ิ- น _M
haydock	ฮ เ- _M . ด -็อ- ก _L
hayek	ฮ เ- _M . ย -ิ- ก _H
hayne	ฮ เ-- น _M
hazen	ฮ เ- _M . ซ เ-ิ- น _M
head	ฮ เ-- ด _F
heading	ฮ เ-- ด _F . ด -ิ- ง _M
headon	ฮ เ-- ด _F . ด -ั- น _M
headphones	ฮ เ-- ด _F . ฟ โ-- น _M
headrick	ฮ เ-- ด _F . ร -ิ- ด _H
hearin	ฮ -ี _M . ร -ิ- น _M
heavy	ฮ เ-- ฟ _F . ว -ี _M
hebb	ฮ เ-- บ _F
heck	ฮ เ-็- ก _H
heckman	ฮ เ-็- ก _H . ม เ-ิ- น _M
hecto	ฮ เ-- ก _F . ต โ- _M
hectogramme	ฮ เ-- ก _F . ต โ- _M . ก -ั- ม _M . ร -ั- ม _M
hedrich	ฮ เ-- ด _F . ร -ิ- ก _H
heede	ฮ -ี- ด _F
heeg	ฮ -ิ- ก _H
heffron	ฮ เ-- ฟ _F . ฟ เ-ิ- น _M . ร เ-ิ- น _M
heflin	ฮ เ-- ฟ _F . ล -ิ- น _M
hugh	ฮ -ิว _M
hegg	ฮ เ-- ก _F
heine	ฮ ไ- _M . น เ- _M
heinecke	ฮ ไ- _M . น -ิ- ก _H
heinicke	ฮ ไ- _M . น -ิ- ก _H
j	จ เ- _M
heisig	ฮ ไ- _M . ซ -ิ- ก _H
heising	ฮ ไ- _M . ซ -ิ- ง _M
heliodon	ฮ -ี _M . ล -ิ _H . อ โ- _M . ด -อ- น _M
helium	ฮ -ี _M . ล เ-ีย- ม _M
hembree	ฮ -ิ- ม _M . บ -็ _L . ร -ี _M
hemlock	ฮ เ-- ม _M . ล -็อ- ก _H
hemoglobin	ฮ -ี _M . ม โ- _M . ก โ- _M . ล โ- _M . บ -ิ- น _M
hemoglobin	ฮ เ- _M . ม โ- _M . ก โ- _M . ล โ- _M . บ -ิ- น _M
hemophilia	ฮ -ี _M . ม โ- _M . ฟ -ิ _H . ล เ-ีย _M
hendon	ฮ เ-- น _M . ด โ-- น _M
hendren	ฮ เ-- น _M . ด เ-อ _M . ร เ-ิ- น _M
heneghan	ฮ -ี _M . น เ-- ก _F . ฮ เ-ิ- น _M
henig	ฮ เ- _M . น -ิ- ก _H
henn	ฮ เ-- น _M
henning	ฮ เ-- น _M . น -ิ- ง _M
henoch	ฮ -ี _M . น เ-ิ- ก _F
henrich	ฮ เ-- น _M . ร -ิ- ก _H
henrik	ฮ เ-- น _M . ร -ิ- ก _H
henry	อ -อ- ง _M . ร -ี _M
thierry	ท -ี _M . ย เ- _M . ร -ี _M
henson	ฮ เ-- น _M . ส -ั- น _R
heren	ฮ -ี _M . ร เ-ิ- น _M
herlihy	ฮ เ- _M . ล -ี _M . ฮ -ี _M
hero	ฮ -ี _M . ร โ- _M
herod	ฮ เ- _M . ร -อ- ด _F
herod	ฮ เ- _M . ร เ-ิ- ด _F
herve	ฮ เ-- ฟ _F
herzig	ฮ เ- _M . ซ -ิ- ก _H
hesiod	ฮ -ี _M . ซ -ี _M . อ เอิ- ด _L . อ เ-ิ- ด _L
heterochromosome	ฮ เ- _M . ท เ-อ _M . ร โ- _M . ค โ- _M . ร โ- _M . ม โ- _M . ซ โ-- ม _M
heterolytic	ฮ เ- _M . ท เ-อ _M . ร โ- _M . ล -ิ _H . ต -ิ- ก _L
hew	ฮ -ิว _M
hewson	ฮ -ิว _M . ส -ั- น _R
hexode	ฮ เ-- ก _F . ซ โ-- ด _F
heyd	ฮ เ-- ด _F
heyde	ฮ เ-- ด _F
heye	ฮ ไ- _M
heymann	ฮ เ- _M . ม เ-ิ- น _M
heyn	ฮ เ-- น _M
hi	ฮ ไ- _M
hickling	ฮ -ิ- ก _H . ก -ิ- ง _M . ล -ิ- ง _M
hickling	ฮ -ิ- ก _H . ล -ิ- ง _M
hickman	ฮ -ิ- ก _H . ม เ-ิ- น _M
hickson	ฮ -ิ- ก _H . ซ เ-ิ- น _M
hiddan	ฮ -ิ- ด _H . ด แ-- น _M
hidden	ฮ -ิ- ด _H . ด เ-ิ- น _M
hifi	ฮ ไ- _M . ฟ ไ- _M
higginbotham	ฮ -ิ- ก _H . ก -ิ- น _M . บ -อ _M . ท เ-ิ- ม _M
higginson	ฮ -ิ- ก _H . ก -ิ- น _M . ส -ั- น _R
higham	ฮ ไ- _M . อ เอิ- ม _M . อ เ-ิ- ม _M
highlow	ฮ ไ- _M . ล โ- _M
hijack	ฮ ไ- _M . จ แ-็- ก _L
hinchliffe	ฮ -ิ- น _M . ค -ิ- ฟ _H . ล -ิ- ฟ _H
hinshaw	ฮ -ิ- น _M . ช -อ _M
hinson	ฮ -ิ- น _M . ส -ั- น _R
hixson	ฮ -ิ- ก _H . ส -ั- น _R
hoad	ฮ โ-- ด _F
hoag	ฮ โ-- ก _F
hoagland	ฮ โ-- ก _F . ล เ-ิ- น _M
hoban	ฮ โ- _M . บ -ั- น _M
hobson	ฮ -็อ- บ _H . ส -ั- น _R
hoby	ฮ -อ _M . บ -ี _M
hoch	ฮ -อ- ก _F
hock	ฮ -็อ- ก _H
hodograph	ฮ -อ _M . ด โ-- ก _L . ร -า- ฟ _F
hoegh	ฮ โ-- ก _F
hoehn	อ โ-- น _M
hogan	ฮ โ- _M . ก -ั- น _M
hogrefe	ฮ -อ- ก _F . ร -ิ- ฟ _H
hogue	ฮ โ-- ก _F
hokanson	ฮ -อ _M . ค เ-ิ- น _M . ส -ั- น _R
hoke	ฮ โ-- ก _F
hokkaido	ฮ -อ- ก _F . ก ไ- _M . ด โ- _M
holinshed	ฮ -อ _M . ล -ิ- น _M . ช เ-- ด _F
holocene	ฮ โ- _M . ล โ- _M . ซ -ี- น _M
holy	ฮ โ- _M . ล -ี _M
hom	ฮ -ั- ม _M
homan	ฮ โ- _M . ม เ-ิ- น _M
home	ฮ โ-- ม _M
homolographic	ฮ โ- _M . ม โ- _M . ล โ-- ก _F . ร -า- ฟ _F . ฟ -ิ- ก _H
homology	ฮ -อ _M . ม โ- _M . ล โ- _M . ย -ี _M
homolytic	ฮ -อ _M . ม -อ _M . ล -ิ _H . ต -ิ- ก _L
homothetic	ฮ -อ _M . ม -อ _M . ท เ- _M . ต -ิ- ก _L
homotopy	ฮ -อ _M . ม -อ _M . ท โ- _M . ป -ี _M
hondo	ฮ -อ- น _M . ด โ- _M
hone	ฮ โ-- น _M
honeymoon	ฮ -ั- น _M . น -ี _M . ม -ู- น _M
honolulu	ฮ โ- _M . น โ- _M . ล -ู _M . ล -ู _M
hood	ฮ -ู- ด _F
hook	ฮ -ุ- ก _H
hooke	ฮ -ุ- ก _H
hooke	ฮ -ู- ก _F
lee	ล -ี _M
hoon	ฮ -ู- น _M
hooson	ฮ -ู _M . ส -ั- น _R
horatio	ฮ โ- _M . ร เ- _M . ช -ี _M . อ โ- _M
hough	ฮ -อ- ฟ _F
houlihan	ฮ -ู _M . ล -ี _M . ฮ แ-- น _M
houn	ฮ -ู- น _M
hove	ฮ โ-- ฟ _F
hovland	ฮ -อ- ฟ _F . ล เ-ิ- น _M
how	ฮ -าว _M
howden	ฮ -าว _M . ด เ-ิ- น _M
howe	ฮ -าว _M
howick	ฮ -าว _M . ว -ิ- ก _H
howman	ฮ -าว _M . ม แ-- น _M
howsome	ฮ -าว _M . ซ -ั- ม _M
howson	ฮ -าว _M . ส -ั- น _R
hoy	ฮ -อย _M
hoyo	ฮ -อย _M . อ โ- _M
hub	ฮ -ั- บ _H
edwin	อ เ-- ด _L . ว -ิ- น _M
huck	ฮ -ั- ก _H
hue	ฮ -ิว _M
huffam	ฮ -ั- ฟ _H . ฟ แ-- ม _M
hug	ฮ -ั- ก _H
hughenden	ฮ -ิว _M . อ เ-- น _M . ด เ-- น _M
hugo	ฮ -ิว _M . ก โ- _M
huhn	ฮ -ั- น _M
human	ฮ -ิว _M . ม เ-ิ- น _M
hume	ฮ -ู- ม _M
humic	ฮ -ิว _M . ม -ิ- ก _H
hummock	ฮ -ั- ม _M . ม -อ- ก _F
humvee	ฮ -ั- ม _M . ว -ี _M
hunn	ฮ -ั- น _M
hunting	ฮ -ั- น _M . ท -ิ- ง _M
huron	ฮ -ิว _M . ร -อ- น _M
hurricane	ฮ เ-อ _M . ร -ิ _H . ค เ-- น _M
husayn	ฮ -ุ _H . ซ เ-- น _M
huy	ฮ -าย _M
huygen	ฮ -ัย _M . ก เ-- น _M
hybird	ฮ ไ- _M . บ -็ _L . ร -ิ- ด _H
hybridisation	ฮ ไ- _M . บ -็ _L . ร -ิ _H . ด ไ- _M . ซ เ- _M . ช -ั- น _M
hydro	ฮ ไ- _M . ด โ- _M . ร โ- _M
hydrochloric	ฮ ไ- _M . ด โ- _M . ร โ- _M . ค -อ _M . ล -อ _M . ร -ิ- ก _H
hydrogen	ฮ ไ- _M . ด โ- _M . ร โ- _M . จ เ-- น _M
hygene	ฮ ไ- _M . จ -ี- น _M
hyman	ฮ ไ- _M . ม เ-ิ- น _M
hymen	ฮ ไ- _M . ม -ิ- น _M
hynek	ฮ ไ- _M . น -ิ- ก _H
hypotonic	ฮ ไ- _M . พ โ- _M . ท -อ _M . น -ิ- ก _H
hypoxia	ฮ ไ- _M . พ โ- _M . ซ เ-ีย _M
hyson	ฮ ไ- _M . ส -ั- น _R
iaaf	อ ไ- _M . อ เ- _M . อ เ- _M . อ เ-- ฟ _L
iain	ล เ-- น _M
ib	อ ไ- _M . บ -ี _M
ibf	อ ไ- _M . บ -ี _M . อ เ-- ฟ _L
ic	อ ไ- _M . ซ -ี _M
icing	อ ไ- _M . ซ -ิ- ง _M
icon	อ ไ- _M . ค -อ- น _M
id	อ ไ- _M . ด -ี _M
ide	อ เ-- ด _L
idea	อ ไ- _M . ด เ-ีย _M
ileum	อ ไ- _M . ล เ-ีย- ม _M
ingham	อ อิ- ง _M . อ เอิ- ม _M . อ เ-ิ- ม _M
iodine	อ ไ- _M . อ โ- _M . ด -ี- น _M
ionization	อ ไ- _M . อ -อ _M . น ไ- _M . ซ เ- _M . ช -ั- น _M
ipf	อ ไ- _M . พ -ี _M . อ เ-- ฟ _L
ipm	อ ไ- _M . พ -ี _M . อ เอ็- ม _M . อ เ-็- ม _M
iq	อ ไ- _M . ค -ิว _M
irene	อ ไ- _M . ร -ี- น _M
irene	อ ไ- _M . ร -ี _M . น -ี _M
iron	อ ไ- _M . ร -อ- น _M
isaac	อ ไ- _M . ซ แ-็- ก _H
isam	อ ไ- _M . ซ แ-- ม _M
isham	อ ไ- _M . ช เ-ิ- ม _M
isogonic	อ ไ- _M . ซ โ- _M . ก -อ _M . น -ิ- ก _H
isogonic	อ ไ- _M . ซ โ- _M . ก โ- _M . น -ิ- ก _H
isoionic	อ ไ- _M . ซ โ- _M . อ ไ- _M . อ -อ _M . น -ิ- ก _H
isokinetic	อ ไ- _M . ซ โ- _M . ค ไ- _M . น เ- _M . ต -ิ- ก _L
isomerism	อ ไ- _M . ซ โ- _M . ม เ-อ _M . ร -ิ _H . ซ -ึ- ม _M
isoneph	อ ไ- _M . ซ โ- _M . น เ-- ฟ _F
isonzo	อ ไ- _M . ซ -อ- น _M . ซ โ- _M
isothere	อ ไ- _M . ซ โ- _M . ด แ- _M
isotone	อ ไ- _M . ซ โ- _M . ท โ-- น _M
isotonic	อ ไ- _M . ซ โ- _M . ท โ- _M . น -ิ- ก _H
it	อ ไ- _M . ท -ี _M
itf	อ ไ- _M . ท -ี _M . อ เ-- ฟ _L
ittf	อ ไ- _M . ท -ี _M . ท -ี _M . อ เ-- ฟ _L
iveagh	อ ไ- _M . ว -ี _M . อ เอิ- ก _L . อ เ-ิ- ก _L
ivone	อ ไ- _M . ว โ-- น _M
ivy	อ ไ- _M . ว -ี _M
izaak	อ ไ- _M . ซ แ-- ก _F
jab	ย แ-็- บ _H
jackie	จ แ-็- ก _L . ก -ี _M
jacklin	จ แ-็- ก _L . ล -ิ- น _M
jackman	จ แ-็- ก _L . ม เ-ิ- น _M
jacqueline	ช -า- ก _F . ล -ี- น _M
jade	จ เ-- ด _L
jaeck	ย เ-็- ก _H
jahn	จ แ-- น _M
jake	จ เ-- ก _L
jakobson	ย -อ _M . ค -อ- บ _F . ส -ั- น _R
jakobson	จ แ- _M . ค เ-ิ- บ _F . ส -ั- น _R
jam	จ แ-- ม _M
jam	ย แ-- ม _M
jamie	จ เ- _M . ม -ี _M
jamison	จ เ- _M . ม -ี _M . ส -ั- น _R
jan	จ แ-- น _M
jane	ช -า- น _M
jann	จ แ-- น _M
janson	จ แ-- น _M . ส -ั- น _R
jared	จ แ- _M . ร เ-ิ- ด _F
javelin	จ แ- _M . ว เ-อ _M . ล เ-ิ- น _M
jayne	จ เ-- น _M
jayson	จ เ- _M . ส -ั- น _R
jean	จ -ี- น _M
jean	ย -ี- น _M
jeanie	จ -ี _M . น -ี _M
jeanne	จ -ี- น _M
jebb	จ เ-- บ _L
jed	จ เ-- ด _L
jeffe	จ เ-- ฟ _L
jehu	จ เ- _M . ฮ -ู _M
jejunum	จ เ- _M . จ -ู _M . น -ั- ม _M
jem	จ เ-- ม _M
jenison	จ เ- _M . น -ิ _H . ส -ั- น _R
jenkinson	จ เ-- ง _M . ก -ิ- น _M . ส -ั- น _R
jenkinson	จ เ-- ง _M . ค -ิ- น _M . ส -ั- น _R
jennie	จ เ-- น _M . น -ี _M
jenny	จ เ-- น _M . น -ี _M
jenson	จ เ-- น _M . ส -ั- น _R
jeremy	จ เ- _M . ร เ- _M . ม -ี _M
jerome	จ เ- _M . ร โ-- ม _M
jerome	ช เ- _M . ร โ-- ม _M
jesus	ย เ- _M . ซ -ู _M
jew	ย -ิว _M
ji	จ เ- _M . อ ไ- _M
jin	จ -ิ- น _M
jo	จ โ- _M
joad	จ โ-- ด _L
joan	จ โ-- น _M
joanne	จ โ- _M . อ แ-- น _M
job	จ -็อ- บ _L
jobim	ค โ- _M . บ -ิ- ม _M
jock	จ -็อ- ก _L
jockey	จ -็อ- ก _L . ก -ี _M
jody	จ โ- _M . ด -ี _M
johan	ย โ- _M . ฮ -ั- น _M
lyndon	ล -ิ- น _M . ด -อ- น _M
jon	จ -อ- น _M
jonson	จ -อ- น _M . ส -ั- น _R
jonsson	จ -อ- น _M . ส -ั- น _R
joruri	จ โ- _M . ร -ุ _H . ร -ิ _H
josef	จ โ- _M . ซ เ-ิ- ฟ _F
josephine	จ โ- _M . ซ เ- _M . ฟ -ี- น _M
josephine	ช โ- _M . ซ เ- _M . ฟ -ี- น _M
josephine	ย โ- _M . ซ เ- _M . ฟ -ี _M . น เ-อ _M
josephson	จ โ- _M . ซ -ิ- ฟ _H . ซ เ-ิ- น _M
joshua	จ โ- _M . ช -ัว _M
josiah	จ โ- _M . ซ เ-ีย _M
josie	จ โ- _M . ซ -ี _M
josif	จ โ- _M . ซ -ิ- ฟ _H
joy	จ -อย _M
jtu	จ เ- _M . ท -ี _M . ย -ู _M
judaea	จ -ู _M . ด เ-ีย _M
jude	จ -ู- ด _L
judo	ย -ู _M . ด โ- _M
judson	จ -ั- ด _L . ส -ั- น _R
juhan	จ -ู- น _M . อ เอิ- น _M . อ เ-ิ- น _M
jujitsu	จ -ู _M . จ -ิ _L . ส -ึ _L
julia	จ -ู _M . ล เ-ีย _M
julian	จ -ู _M . ล เ-ีย- น _M
julienne	จ -ู _M . ล เ-ีย- น _M
jumbo	จ -ั- ม _M . บ โ- _M
jumping	จ -ั- ม _M . ป -ิ- ง _M
junacke	จ -ู _M . น -ั- ก _H
june	จ -ู- น _M
juneau	จ -ู _M . น โ- _M
jung	จ -ุ- ง _M
juno	จ -ู _M . น โ- _M
kaelin	ค เ-ิ- น _M . ล เ-ิ- น _M
kaff	ค แ-- ฟ _F
kahin	ค เ- _M . ฮ -ิ- น _M
kai	ค ไ- _M
kail	ค เ- _M . ล เ- _M
kaim	ค เ-- ม _M
kain	ค เ-- น _M
kale	ค เ- _M . ล เ- _M
kame	ค เ-- ม _M
kansan	ค แ-- น _M . ซ -า- น _M
kaolin	ค เ- _M . อ โ- _M . ล -ิ- น _M
kapell	ค แ- _M . ล เ- _M . พ เ- _M
karen	ค แ- _M . ร เ-- น _M
karin	ค แ- _M . ร -ิ- น _M
katabolism	ค แ- _M . ท แ- _M . บ -อ _M . ล -ิ _H . ซ -ึ- ม _M
katherine	ค แ- _M . ท เ-อ _M . ร -ิ- น _M
katherine	ค แ- _M . ท เ-อ _M . ร -ี- น _M
kathy	ค แ- _M . ท -ี _M
katie	ค เ- _M . ท -ี _M
katy	ค เ- _M . ท -ี _M
kaufman	ค -อ- ฟ _F . ม เ-ิ- น _M
kavanagh	ค แ- _M . ว เ-อ _M . น -อ _M
kazin	ค เ- _M . ซ -ิ- น _M
kean	ค -ี- น _M
keane	ค -ี- น _M
roy	ร -อย _M
keaton	ค -ี _M . ต -ั- น _M
kee	ค -ี _M
keefe	ค -ิ- ฟ _H
keeffe	ค -ิ- ฟ _H
keeling	ค -ี _M . ล -ิ- ง _M
keen	ค -ี- น _M
keene	ค -ี- น _M
kehoe	ค เ- _M . ฮ โ- _M
keigwin	ค ไ- _M . ก -ิ- น _M . ว -ิ- น _M
keim	ค -ิ- ม _M
kelly	ค เ- _M . ล เ- _M . ล -ี _M
kelso	ค เ- _M . ล เ- _M . ซ โ- _M
kelvin	ค เ- _M . ล เ- _M . ว -ิ- น _M
kemm	ค เ-- ม _M
kennedy	ค เ-- น _M . น เ- _M . ด -ี _M
keno	ค -ิ _H . น โ- _M
kenrick	ค เ-- น _M . ร -ิ- ก _H
kentucky	ค เ-- น _M . ท -ั- ก _H . ก -ี _M
keogh	ค -ี _M . อ โ- _M
keohane	ค -ี _M . อ เ-อ _M . ฮ เ-- น _M
keren	ค เ- _M . ร เ-ิ- น _M
kerogen	ค เ-อ _M . ร โ- _M . จ เ-- น _M
kerosene	ค เ- _M . ร โ- _M . ซ -ี- น _M
kerouac	ค เ- _M . ร -ู _M . อ แ-- ก _L
keson	ค เ- _M . ส -ั- น _R
kev	ค เ-- ฟ _F
kevin	ค เ-ิ- น _M . ว เ-ิ- น _M
kew	ค -ิว _M
khamsin	ก -ั- ม _M . ซ -ิ- น _M
khayyam	ค -ัย _M . ย -ั- ม _M
khomeini	ค โ- _M . ม ไ- _M . น -ี _M
kid	ค -ิ- ด _H
kidson	ค -ิ- ด _H . ส -ั- น _R
kie	ค -ี _M
kiehn	ค -ิ- น _M
kiek	ค -ิ _H . อ เอ็- ก _L . อ เ-็- ก _L
kieran	ค -ี _M . ร เ-ิ- น _M
kiev	ค -ี _M . อ เ-- ฟ _L
kiev	ค เ-ีย- ฟ _F
kihn	ค -ิ- น _M
killea	ค -ี _M . ล เ-ีย _M
killough	ค -ี _M . ล โ- _M
kilo	ก -ิ _L . ล โ- _M
kilobaud	ก -ิ _L . ล โ- _M . บ -อ- ด _L
kilocalorie	ก -ิ _L . ล โ- _M . ค แ- _M . ล -อ _M . ร -ี _M
kilogram	ก -ิ _L . ล โ- _M . ก -ั- ม _M . ร -ั- ม _M
kilogramme	ก -ิ _L . ล โ- _M . ก -ั- ม _M . ร -ั- ม _M
kim	ค -ิ- ม _M
kimbrough	ค -ิ- ม _M . บ -็ _L . ร -าว _M
kimm	ค -ิ- ม _M
kimono	ก -ิ _L . ม โ- _M . น โ- _M
kincade	ค -ิ- น _M . ค เ-- ด _F
kincaid	ค -ิ- น _M . ค เ-- ด _F
kinematic	ค ไ- _M . น เ- _M . ม เ- _M . ต -ิ- ก _L
kinesiology	ค ไ- _M . น เ- _M . ซ -ิ _H . อ โ- _M . ล โ- _M . จ -ี _M
kinetosome	ค ไ- _M . น -ี _M . ท โ- _M . ซ โ-- ม _M
kinglake	ค -ิ- ง _M . ล เ-- ก _F
kingman	ค -ิ- ง _M . ม เ-ิ- น _M
kip	ก -ี- บ _L
kirende	ค -ิ _H . ร เ-็- น _M . ด เ-ะ _L
kishinev	ค -ิ _H . ช -ิ _H . น เ-- ฟ _F
kissick	ค -ี _M . ซ -ิ- ก _H
kiwi	ก -ี _M . ว -ี _M
klee	ค เ- _M . ล เ- _M
klin	ค -ิ- น _M . ล -ิ- น _M
kling	ค -ิ- ง _M . ล -ิ- ง _M
klud	ค -ั- ด _H . ล -ั- ด _H
km	ค เ- _M . อ เอ็- ม _M . อ เ-็- ม _M
knauf	น -อ- ฟ _F
knee	น -ี _M
knew	น -ู _M
knoch	น -็อ- ก _H
knock	น -็อ- ก _H
knode	น โ-- ด _F
knudson	น -ู- ด _F . ส -ั- น _R
kob	ค -็อ- บ _H
kobe	ค โ-- บ _F
kodak	ก โ- _M . ด -ั- ก _L
kodiak	ก โ- _M . ด -ี _M . อ แ-- ก _L
kodiak	ก โ- _M . ด ไ- _M . อ แ-- ก _L
koembang	ก เ-ิ- ม _M . บ -ั- ง _M
kohn	ค -อ- น _M
kolak	ค เ-อ _M . ล เ-ิ- ก _F
kone	ค โ-- น _M
konrad	ค -อ- น _M . ร เ-ิ- ด _F
kontak	ค -อ- น _M . ท -ั- ก _H
kopan	ค โ- _M . พ แ-- น _M
kore	ค โ- _M . ร เ- _M
koum	ก -ู- ม _M
kovach	ค โ- _M . ว -ั- ก _H
kovno	ค -อ- ฟ _F . น โ- _M
kown	ค โ-- น _M
kozak	ค โ- _M . ซ เ-ิ- ก _F
krene	ค -ิ- น _M . ร -ิ- น _M
krim	ก -ิ- ม _M . ร -ิ- ม _M
krimm	ค -ิ- ม _M . ร -ิ- ม _M
krizek	ค -ี _M . ร -ี _M . ซ เ-็- ก _H
krogh	ค โ- _M . ร โ- _M
kroh	ค โ- _M . ร โ- _M
krom	ค -อ- ม _M . ร -อ- ม _M
kron	ค -อ- น _M . ร -อ- น _M
krum	ค -ั- ม _M . ร -ั- ม _M
krumm	ค -ั- ม _M . ร -ั- ม _M
krylov	ค ไ- _M . ร ไ- _M . ล -อ- ฟ _F
kubelik	ค -ู- บ _F . ล -ิ- ก _H
kubik	ค -ิว _M . บ -ิ- ก _L
kuehn	ค -ู- น _M
kulick	ค -ิว _M . ล -ิ- ก _H
kulik	ค -ิว _M . ล -ิ- ก _H
kum	ก -ู- ม _M
kum	ค -ู- ม _M
kuroshio	ก -ุ _L . ร โ- _M . ช -ิ _H . อ โ- _M
kuroshio	ค -ุ _H . ร โ- _M . ช -ิ _H . อ โ-ะ _L
kurosiwo	ก -ุ _L . ร โ- _M . ซ -ิ _H . ว โ- _M
kutak	ค -ู _M . ท เ-ิ- ก _F
kwiatek	ค -ิ _H . ว -ิ _H . อ -อ _M . ท เ-็- ก _H
kyd	ค -ิ- ด _H
kyushu	ค -ิว _M . ช -ู _M
lab	ล แ-็- บ _H
lack	ล แ-็- ก _H
lacon	ล -อ _M . ค เ-ิ- น _M
lactic	ล แ-- ก _F . ต -ิ- ก _L
lactic	ล แ-็- ก _H . ต -ิ- ก _L
lactogenic	ล แ-- ก _F . ท โ- _M . จ เ- _M . น -ิ- ก _H
lad	ล แ-็- ด _H
ladd	ล แ-- ด _F
ladefoged	ล แ- _M . ด เ- _M . ฟ โ- _M . ก เ-- ด _L
ladoo	ล เ-อ _M . ด -ู _M
lady	ล เ- _M . ด -ี _M
laetitia	ล เ- _M . ต -ี _M . ซ เ-ีย _M
lafe	ล เ-- ฟ _F
laffan	ล แ-- ฟ _F . ฟ แ-- น _M
lag	ล แ-็- ก _H
lagrangian	ล -า- ก _F . ร -า- น _M . ก เ-ีย- น _M
lain	ล เ-- น _M
laine	ล เ-- น _M
lake	ล เ-- ก _F
lam	ล แ-- ม _M
lamade	ล แ- _M . ม -า- ด _F
laman	ล เ- _M . ม เ-ิ- น _M
lambe	ล แ-- ม _M
lamon	ล -อ _M . ม -อ- น _M
lamoureux	ล แ- _M . ม -ุ _H . ร โ- _M
lan	ล แ-- น _M
landau	ล แ-- น _M . ด โ- _M
landeck	ล แ-- น _M . ด -ิ- ก _L
landi	ล แ-- น _M . ด -ี _M
lane	ล เ-- น _M
lang	ล แ-- ง _M
lange	ล แ-- ง _M
langlo	ล แ-- ง _M . ล โ- _M
langmuir	ล แ-- ง _M . ม -ู _M . ร เ-ีย _M
langson	ล แ-- ง _M . ซ เ-ิ- น _M
lanigan	ล แ- _M . น -ี _M . ก เ-ิ- น _M
lanneau	ล แ-- น _M . น โ- _M
lanolin	ล แ- _M . น โ- _M . ล -ิ- น _M
laos	ล -าว _M
lappin	ล เ-อ _M . พ แ-- น _M
lasin	ล แ- _M . ส -ั- น _R
lateef	ล แ- _M . ท -ี- ฟ _F
lateritic	ล แ- _M . ต เ-อ _M . ร -ิ _H . ต -ิ- ก _L
lauck	ล -็อ- ก _H
laud	ล -อ- ด _F
laugh	ล -า- ฟ _F
laughlin	ล แ-- ฟ _F . ล -ิ- น _M
laun	ล -อ- น _M
laurasia	ล -อ _M . ร เ- _M . ช เ-ีย _M
laurasia	ล -อ _M . ร เ- _M . ซ เ-ีย _M
lauren	ล -อ _M . ร เ-- น _M
lavan	ล เ- _M . ว เ-ิ- น _M
lavecchia	ล -ั- ฟ _H . ว เ-- ก _F . ค เ-ีย _M
lawn	ล -อ- น _M
lawo	ล เ-อ _M . ว โ- _M
laye	ล เ- _M
layne	ล เ-- น _M
lea	ล -ี _M
lead	ล เ-- ด _F
leaf	ล -ี- ฟ _F
league	ล -ี- ก _L
leahy	ล เ- _M . ฮ -ี _M
leak	ล -ี- ก _L
leake	ล -ี- ก _L
lean	ล -ี- น _M
leane	ล -ี- น _M
leaven	ล เ- _M . ว เ-- น _M
lebesgues	ล เ-อ _M . บ เ-- ก _L
lebig	ล -ี _M . บ -ิ- ก _L
lecithin	ล เ- _M . ซ -ิ _H . ต -ิ- น _M
lecoxene	ล -ู _M . ค โ- _M . ซ -ี- น _M
ledeen	ล เ-อ _M . ด -ี- น _M
leeb	ล -ิ- บ _H
leek	ล -ี- ก _L
leen	ล -ี- น _M
lefanu	ล แ- _M . ฟ แ- _M . น -ู _M
leff	ล เ-- ฟ _F
lefrak	ล เ- _M . ฟ แ-็- ก _H . ร แ-็- ก _H
legge	ล เ-็- ก _H
leggo	ล เ- _M . ก โ- _M
legro	ล เ- _M . ก โ- _M . ร โ- _M
lehn	ล เ-- น _M
lehne	ล เ-- น _M
leib	ล -ิ- บ _H
leiden	ล ไ- _M . ด เ-- น _M
leif	ล -ิ- ฟ _H
leigh	ล -ี _M
leman	ล เ- _M . ม เ-ิ- น _M
lemieux	ล เ-ิ- ม _M . ย -ู _M
lemon	ล เ- _M . ม -อ- น _M
lemon	ล เ- _M . ม เ-ิ- น _M
lemonade	ล เ- _M . ม -อ _M . น เ-- ด _F
len	ล เ-- น _M
lenihan	ล เ- _M . น -ิ _H . ฮ แ-- น _M
lenny	ล เ-- น _M . น -ี _M
leo	ล -ี _M . อ โ- _M
leo	ล เ- _M . อ โ- _M
leofric	ล เ-ีย- ฟ _F . ร -ิ- ก _H
leon	ล -ี _M . อ -อ- น _M
leon	ล เ-อ _M . อ - น _M
leroux	ล เ-อ _M . ร -ู _M
leroy	ล -ี _M . ร -อย _M
lesik	ล เ- _M . ส -ิ- ก _L
lesotho	ล เ- _M . ซ โ- _M . ท โ- _M
lethem	ล เ- _M . ท เ-ิ- ม _M
leti	ล เ- _M . ต -ี _M
letitia	ล -ิ _H . ต -ี _M . ช เ-ีย _M
leukemia	ล -ิว _M . ค -ี _M . ม เ-ีย _M
leukemia	ล -ู _M . ค -ี _M . ม เ-ีย _M
leukoplakia	ล -ิว _M . ค โ- _M . ล เ- _M . พ เ- _M . ก เ-ีย _M
lev	ล เ-- ฟ _F
leveche	ล เ- _M . ว เ- _M . ช -ี _M
leveche	ล เ- _M . ว เ- _M . ช เ- _M
levenson	ล เ- _M . ว -ิ- น _M . ส -ั- น _R
levi	ล -ี _M . ว -าย _M
levie	ล -ี _M . ว -ี _M
levin	ล เ- _M . ว -ิ- น _M
levinson	ล เ- _M . ว -ิ- น _M . ส -ั- น _R
levison	ล -ี _M . ว -ิ _H . ส -ั- น _R
lewin	ล เ- _M . ว -ิ- น _M
wyndham	ว -ิ- น _M . ด -ั- ม _M
leyte	ล เ- _M . ต เ- _M
liam	ล เ-ีย- ม _M
libby	ล -ิ- บ _H . บ -ี _M
libya	ล -ิ _H . บ เ-ีย _M
lichen	ล ไ- _M . ค เ-- น _M
lichen	ล ไ- _M . ค เ-็- น _M
lick	ล -ิ- ก _H
liddy	ล -ี- ด _F . ด -ี _M
lide	ล -ิ- ด _H
lidoff	ล -ี _M . ด -อ- ฟ _L
lief	ล -ิ- ฟ _H
lien	ล -ิ- น _M
liff	ล -ิ- ฟ _H
lifo	ล ไ- _M . ฟ โ- _M
ligurian	ล -ิ _H . ก -ู _M . ร เ-ีย- น _M
lih	ล -ี _M
lilac	ล ไ- _M . ล แ-็- ก _H
lilian	ล -ิ _H . ล เ-ีย- น _M
lilongwe	ล -ิ _H . ล -อ- ง _M . ว เ- _M
lim	ล -ิ- ม _M
limbaugh	ล -ิ- ม _M . บ โ- _M
limerick	ล -ิ _H . ม เ-อ _M . ร -ิ- ก _H
limerick	ล ไ- _M . ม เ-อ _M . ร -ิ- ก _H
limnic	ล -ิ- ม _M . น -ิ- ก _H
limnology	ล -ิ- ม _M . น โ- _M . ล โ- _M . ย -ี _M
limon	ล -ิ _H . ม -อ- น _M
limon	ล -ิ _H . ม เ-ิ- น _M
limpo	ล -ิ- ม _M . ป โ- _M
lin	ล -ิ- น _M
lindane	ล -ิ- น _M . ด เ-- น _M
linden	ล -ิ- น _M . ด เ-ิ- น _M
lindgren	ล -ิ- น _M . ก เ-็- น _M . ร เ-็- น _M
lindrum	ล -ิ- น _M . ด เ- _M . ร -ิ- ม _M
linebaugh	ล -ี _M . น -ี _M . บ -อ _M
linehan	ล -ิ _H . น -ี _M . ฮ แ-- น _M
ling	ล -ิ- ง _M
lingham	ล -ิ- ง _M . ฮ แ-- ม _M
linguini	ล -ิ- ง _M . ก -ี _M . ว -ี _M . น -ี _M
linseed	ล -ิ- น _M . ส -ี- ด _L
linton	ล -ิ- น _M . ต -ั- น _M
linton	ล -ิ- น _M . ต เ-ิ- น _M
lion	ล ไ- _M . อ -อ- น _M
lipid	ล -ิ _H . ป -ิ- ด _L
lipid	ล -ิ _H . พ -ิ- ด _H
lipoprotein	ล ไ- _M . ป โ- _M . ร โ- _M . ป โ- _M . ต -ี- น _M
lithium	ล -ิ _H . ท เ-ีย- ม _M
lithuania	ล -ิ _H . ท -ัว _M . น เ-ีย _M
livia	ล -ิ _H . ว เ-ีย _M
llew	ล -ู _M
llewelyn	ล -ุย _M . ล -ิ- น _M
loam	ล โ-- ม _M
lobban	ล -็อ- บ _H . บ เ-ิ- น _M
lobby	ล -็อ- บ _H . บ -ี _M
lobe	ล โ-- บ _F
location	ล โ- _M . ค เ- _M . ช -ั- น _M
loch	ล -็อ- ก _H
lochan	ล -อ _M . ค -ั- น _M
lock	ล -็อ- ก _H
locke	ล -็อ- ก _H
lockheed	ล -็อ- ก _H . ฮ -ี- ด _F
lockman	ล -็อ- ก _H . ม เ-ิ- น _M
lockwood	ล -็อ- ก _H . ว -ู- ด _F
lodwick	ล -็อ- ด _H . ว -ิ- ก _H
loe	ล โ- _M
loen	ล โ-- น _M
loewen	ล โ- _M . ว เ-- น _M
lofoten	ล โ- _M . ฟ โ- _M . ต เ-- น _M
loftin	ล -อ- ฟ _F . ต -ิ- น _M
logic	ล -อ _M . จ -ิ- ก _L
logo	ล โ- _M . ก โ- _M
logue	ล โ-- ก _F
loke	ล โ-- ก _F
lome	ล โ- _M . ม เ- _M
lon	ล -ั- น _M
london	ล -อ- น _M . ด -อ- น _M
lonely	ล โ-- น _M . ล -ี _M
long	ล -อ- ง _M
longden	ล -อ- ง _M . ด เ-- น _M
longino	ล -อ- ง _M . ก -ี _M . น โ- _M
longman	ล -อ- ง _M . ม เ-ิ- น _M
longmyndian	ล -อ- ง _M . ม -ิ- น _M . ด เ-ีย- น _M
look	ล -ุ- ก _H
lorain	ล เ-อ _M . ร เ-ิ- น _M
loraine	ล เ-อ _M . ร เ-- น _M
loran	ล -อ _M . ร แ-- น _M
loren	ล -อ _M . ร เ-- น _M
sophia	ซ โ- _M . ฟ เ-ีย _M
lorenzo	ล -อ _M . ร เ-- น _M . ซ โ- _M
lorenzo	ล เ-อ _M . ร เ-- น _M . ซ โ- _M
loria	ล -อ _M . ร เ-ีย _M
lorine	ล -อ _M . ร -ิ- น _M
lorraine	ล -อ _M . ร แ-- น _M
loso	ล โ- _M . ซ โ- _M
lotion	ล โ- _M . ช -ั- น _M
lou	ล -ู _M
lough	ล -อ- ก _F
loughton	ล -าว _M . ต เ-ิ- น _M
louis	ล -ุย _M
louw	ล -ู _M
love	ล -ั- ฟ _H
love	ล เ-ิ- ฟ _F
loveden	ล -ั- ฟ _H . ด เ-็- น _M
lovegreen	ล -ั- ฟ _H . ก -ี- น _M . ร -ี- น _M
lovejoy	ล -ั- ฟ _H . จ -อย _M
lovejoy	ล เ-ิ- ฟ _F . จ -อย _M
lowden	ล โ- _M . ด เ-ิ- น _M
lowry	ล -าว _M . ร -ี _M
loy	ล -อย _M
loye	ล -อย _M
lubbock	ล -ั- บ _H . บ เ-ิ- ก _L
lubin	ล -ู _M . บ -ิ- น _M
de	ด เ- _M
lucan	ล -ู _M . ก -ั- น _M
lucan	ล -ู _M . ค เ-ิ- น _M
luchu	ล -ู _M . ช -ู _M
lucia	ล -ู _M . ช เ-ีย _M
lucia	ล -ู _M . ซ เ-ีย _M
lucian	ล -ู _M . ช เ-ิ- น _M
luck	ล -ั- ก _H
lucke	ล -ั- ก _H
lucky	ล -ั- ก _H . ก -ี _M
lucy	ล -ู _M . ซ -ี _M
ludlum	ล -ั- ด _H . ล -ั- ม _M
ludo	ล -ู _M . ด โ- _M
luff	ล -ั- ฟ _H
lufkin	ล -ั- ฟ _H . ค -ิ- น _M
lug	ล -ั- ก _H
lugg	ล -ั- ก _H
lujan	ล -ู _M . ย -ั- น _M
lukin	ล -ู _M . ค -ิ- น _M
lum	ล -ั- ม _M
lumb	ล -ั- ม _M
lumen	ล -ู _M . ม แ-- น _M
luncheon	ล -ั- น _M . ช เ-ีย- น _M
lundeen	ล -ั- น _M . ด -ิ- น _M
lunn	ล -ั- น _M
lupino	ล -ู _M . พ -ิ- น _M . น โ- _M
luria	ล -ุ _H . ร เ-ีย _M
lutetium	ล -ู _M . ท -ี _M . ช เ-ีย- ม _M
lutetium	ล -ู _M . ท -ี _M . ซ เ-ีย- ม _M
lutetium	ล -ู _M . ท -ี _M . ท เ-ีย- ม _M
luxury	ล -ั- ก _H . ช เ-อ _M . ร -ี _M
luzon	ล -ู _M . ซ -อ- น _M
lycan	ล ไ- _M . ค เ-ิ- น _M
lychee	ล ไ- _M . ช -ี _M
lydia	ล -ิ _H . ด เ-ีย _M
lydon	ล -ิ _H . ด เ-ิ- น _M
lygon	ล ไ- _M . ก -อ- น _M
lyly	ล -ิ _H . ล -ี _M
lyman	ล -ี _M . ม แ-- น _M
lyman	ล ไ- _M . ม เ-ิ- น _M
lyn	ล -ิ- น _M
lyng	ล -ิ- ง _M
lynton	ล -ิ- น _M . ต -ั- น _M
mabie	ม แ- _M . บ -ี _M
mac	ม แ-- ก _F
macallan	ม เ-ิ- ก _F . ค แ- _M . อ เอิ- น _M . อ เ-ิ- น _M
macchia	ม -ั- ก _H . ก เ-ีย _M
macchia	ม แ-- ก _F . ค เ-ีย _M
macchia	ม แ-็- ก _H . ค เ-ีย _M
macduff	ม เ-ิ- ก _F . ด -ั- ฟ _L
machine	ม แ- _M . ช -ี- น _M
mack	ม แ-็- ก _H
mackaye	ม เ-ิ- ก _F . ค เ- _M
mackenzie	ม เ-ิ- ก _F . ค เ-- น _M . ซ -ี _M
macklin	ม แ-็- ก _H . ล -ิ- น _M
maclaine	ม แ-- ก _F . ล เ-- น _M
macon	ม เ- _M . ค เ-ิ- น _M
macrae	ม เ-ิ- ก _F . ค เ- _M . ร เ- _M
macro	ม แ-- ก _F . ค โ- _M . ร โ- _M
macro	ม แ- _M . ค โ- _M . ร โ- _M
macrobiotic	ม แ- _M . ค โ- _M . ร โ- _M . บ ไ- _M . อ โ- _M . ต -ิ- ก _L
macroom	ม แ-- ก _F . ร -ู- ม _M
mact	อ เอ็- ม _M . อ เ-็- ม _M . อ เ- _M . ซ -ี _M . ท -ี _M
mad	อ เอ็- ม _M . อ เ-็- ม _M . อ เ- _M . ด -ี _M
maddison	ม แ-- ด _F . ด -ิ _L . ส -ั- น _R
maddock	ม แ-- ด _F . ด -อ- ก _L
madeleine	ม -า- ด _F . ล แ-- น _M
madeleine	ม แ- _M . ด เ- _M . ล -ิ- น _M
madelyn	ม แ-็- ด _H . ล -ิ- น _M
madison	ม แ- _M . ด -ิ _L . ส -ั- น _R
madrid	ม -า- ด _F . ร -ิ- ด _H
madson	ม แ-- ด _F . ส -ั- น _R
mafic	ม เ- _M . ฟ -ิ- ก _H
mag	ม แ-็- ก _H
maggie	ม แ-- ก _F . ก -ี _M
maggy	ม แ-็- ก _H . ก -ี _M
magic	ม แ- _M . จ -ิ- ก _L
magician	ม เ- _M . จ -ิ _L . ช เ-ีย- น _M
magnesia	ม แ-- ก _F . น -ี _M . ซ เ-ีย _M
magnesiam	ม แ-- ก _F . น -ี _M . ซ เ-ีย- ม _M
magnetic	ม แ-- ก _F . น เ- _M . ต -ิ- ก _L
magnetic	ม แ-- น _M . น เ- _M . ต -ิ- ก _L
magnitude	ม แ-- ก _F . น -ิ _H . จ -ู- ด _L
magnitude	ม แ-- ก _F . น -ี _M . จ -ู- ด _L
magnum	ม แ-- ก _F . น -ั- ม _M
mahin	ม แ- _M . ฮ -ิ- น _M
main	ม เ-- น _M
maine	ม เ-- น _M
maisie	ม เ- _M . ซ -ี _M
mak	ม แ-็- ก _H
make	ม เ-- ก _F
maken	ม เ- _M . ก เ-ิ- น _M
malet	ม แ- _M . ล เ-อ _M
maloy	ม แ- _M . ล -อย _M
man	ม แ-- น _M
manchuria	ม แ-- น _M . จ -ู _M . ร เ-ีย _M
mancini	ม -ั- น _M . ซ -ี _M . น -ี _M
mandolin	ม แ-- น _M . ด โ- _M . ล -ิ- น _M
mandy	ม แ-- น _M . ด -ี _M
manfred	ม แ-- น _M . ฟ -ี- ด _F . ร -ี- ด _F
manhood	ม แ-- น _M . ฮ -ู- ด _F
manion	ม -ั- น _M . ย -อ- น _M
manning	ม แ-- น _M . น -ิ- ง _M
manningham	ม แ-- น _M . น -ิ- ง _M . ฮ แ-- ม _M
mansion	ม แ-- น _M . ช -ั- น _M
mantle	ม แ-- น _M . ท เ-ิ- น _M
marian	ม แ- _M . ร เ-ีย- น _M
marianne	ม เ- _M . ร -ี _M . อ แ-- น _M
marie	ม เ- _M . ร -ี _M
marie	ม แ- _M . ร -ี _M
marilyn	ม แ- _M . ร -ิ _H . ล -ิ- น _M
marin	ม เ- _M . ร -ิ- น _M
marine	ม เ-อ _M . ร -ี- น _M
marino	ม เ- _M . ร -ิ _H . น โ- _M
marion	ม เ- _M . ร เ-ีย- น _M
marion	ม แ- _M . ร เ-ีย- น _M
jacques	ช -า- ก _F
mary	ม เ- _M . ร -ี _M
mary	ม แ- _M . ร -ี _M
maryanne	ม แ- _M . ร -ี _M . อ แ-- น _M
maryon	ม เ- _M . ร -ี _M . อ เอิ- น _M . อ เ-ิ- น _M
mashek	ม แ- _M . ช -ิ- ก _H
mason	ม เ- _M . ส -ั- น _R
mathea	ม แ- _M . ท เ-ีย _M
mathieson	ม แ- _M . ท -ี _M . ซ เ-ิ- น _M
henri	อ -อ- ง _M . ร -ี _M
maturity	ม แ- _M . ช -ัว _M . ร -ิ _H . ต -ี _M
maud	ม -อ- ด _F
maude	ม -อ- ด _F
maudlin	ม -อ- ด _F . ล -ิ- น _M
maureen	ม -อ _M . ร -ี- น _M
mauritania	ม -อ _M . ร -ิ _H . ต เ- _M . น เ-ีย _M
maverick	ม แ- _M . ว เ-อ _M . ร -ิ- ก _H
mawson	ม -อ _M . ส -ั- น _R
maximilian	ม แ-- ก _F . ซ -ิ _H . ม -ิ _H . ล เ-ีย- น _M
maxson	ม แ-็- ก _H . ส -ั- น _R
mayhew	ม เ- _M . ฮ -ิว _M
mayne	ม เ-- น _M
mba	อ เอ็- ม _M . อ เ-็- ม _M . บ -ี _M . อ เ- _M
mc	ม แ-- ก _F
mccabe	ม เ-ิ- ก _F . ค เ-- บ _F
mccain	ม เ-ิ- ก _F . ค เ-- น _M
mcclanahan	ม เ-ิ- ก _F . ค แ- _M . ล แ- _M . น เ-อ _M . ฮ แ-- น _M
mcclean	ม เ-ิ- ก _F . ค -ี- น _M . ล -ี- น _M
mcclintock	ม เ-ิ- ก _F . ล -ิ- น _M . ท -็อ- ก _H
mccloy	ม เ-ิ- ก _F . ค -อย _M . ล -อย _M
mcclung	ม เ-ิ- ก _F . ค -ั- ง _M . ล -ั- ง _M
mccoll	ม เ-ิ- ก _F . ค โ- _M . ล โ- _M
mccoy	ม เ-ิ- ก _F . ค -อย _M
mccoy	ม แ-- ก _F . ค -อย _M
mccrea	ม เ-ิ- ก _F . ค เ-ีย _M . ร เ-ีย _M
mccue	ม เ-ิ- ก _F . ย -ู _M
mccune	ม เ-ิ- ก _F . ค -ู- น _M
mcdavid	ม เ-ิ- ก _F . ด เ- _M . ว เ-ิ- ด _F
mcenroe	ม แ-็- ก _H . อ เ-- น _M . ร โ- _M
mcgehee	ม เ-ิ- ก _F . ก -ี _M
mcgrew	ม เ-ิ- ก _F . ก -ู _M . ร -ู _M
mchugh	ม เ-ิ- ก _F . ค -ิว _M
mckesson	ม แ-- ก _F . ค -ี _M . ซ เ-ิ- น _M
mclaughlin	ม เ-ิ- ก _F . ค -า- ฟ _F . ล -า- ฟ _F . ล -ิ- น _M
mclaughlin	ม แ-็- ก _H . ล -า- ก _F . ล -ิ- น _M
mclean	ม เ-ิ- ก _F . ค -ี- น _M . ล -ี- น _M
mclean	ม แ-็- ก _H . ล -ี- น _M
don	ด -อ- น _M
mcluhan	ม เ-ิ- ก _F . ค -ู- น _M . ล -ู- น _M
mcmahon	ม เ-ิ- ก _F . ม แ-- น _M
mcminn	ม เ-ิ- ก _F . ม -ิ- น _M
mcmoran	ม เ-ิ- ก _F . ม -อ _M . ร เ-ิ- น _M
mcqueen	ม เ-ิ- ก _F . ค -ี- น _M . ว -ี- น _M
mcqueen	ม แ-- ก _F . ค -ี- น _M . ว -ี- น _M
mcrae	ม เ-ิ- ก _F . ค เ- _M . ร เ- _M
md	อ เอ็- ม _M . อ เ-็- ม _M . ด -ี _M
me	ม -ี _M
mea	ม -ี _M
meacham	ม -ี _M . ช เ-ิ- ม _M
mead	ม -ี- ด _F
meade	ม -ิ- ด _H
meade	ม -ี- ด _F
mean	ม -ี- น _M
meany	ม -ี _M . น -ี _M
mechanic	ม เ- _M . ค แ- _M . น -ิ- ก _H
media	ม -ี _M . ด เ-ีย _M
medium	ม -ี _M . ด เ-ีย- ม _M
medlock	ม เ-็- ด _H . ล -็อ- ก _H
mee	ม -ี _M
meek	ม -ี- ก _F
meg	ม เ-- ก _F
meid	ม -ิ- ด _H
meiji	ม เ- _M . จ -ิ _L
meiling	ม เ- _M . ล -ิ- ง _M
mein	ม -ิ- น _M
meinecke	ม ไ- _M . น -ิ- ก _H
mejid	ม เ- _M . จ -ิ- ด _L
melick	ม เ- _M . ล -ิ- ก _H
melodeon	ม เ- _M . ล โ- _M . ด เ-ีย- น _M
melody	ม เ- _M . ล โ- _M . ด -ี _M
melon	ม เ- _M . ล -อ- น _M
meloy	ม เ- _M . ล -อย _M
memory	ม เ- _M . ม โ- _M . ร -ี _M
mencken	ม เ-- ง _M . ค เ-ิ- น _M
mendelevium	ม เ-- น _M . ด เ- _M . ล -ี _M . ว เ-ีย- ม _M
mendeleyev	ม เ-- น _M . ด เ- _M . ล เ- _M . ย เ-- ฟ _F
menelik	ม เ- _M . น เ- _M . ล -ิ- ก _H
menhaden	ม เ-- น _M . ฮ เ- _M . ด เ-- น _M
menken	ม เ-- น _M . ก เ-- น _M
menton	ม เ-- น _M . ต เ-ิ- น _M
menu	ม เ- _M . น -ู _M
menuhin	ม เ-อ _M . น -ู _M . ฮ -ิ- น _M
meridian	ม เ- _M . ร -ิ _H . ด เ-ีย- น _M
meridian	ม เ-อ _M . ร -ิ _H . ด เ-ีย- น _M
meringue	ม เ-อ _M . ร แ-- ง _M
merry	ม เ- _M . ร -ี _M
mesic	ม เ- _M . ส -ิ- ก _L
meson	ม -ี _M . ซ -อ- น _M
mesophilic	ม เ- _M . ซ โ- _M . ฟ -ิ _H . ล -ิ- ก _H
messick	ม เ- _M . ซ -ิ- ก _H
metabolism	ม เ- _M . ท แ- _M . บ -อ _M . ล -ิ _H . ซ -ึ- ม _M
methane	ม -ี _M . ท เ-- น _M
methuen	ม เ- _M . ท -ู- น _M
mexico	ม เ-็- ก _H . ซ -ิ _H . ก โ- _M
meyne	ม เ-- น _M
meyrick	ม เ- _M . ร -ิ- ก _H
mfn	อ เอ็- ม _M . อ เ-็- ม _M . อ เ-- ฟ _L . อ เอ็- น _M . อ เ-็- น _M
mgd	อ เอ็- ม _M . อ เ-็- ม _M . จ -ี _M . ด -ี _M
mho	ม โ- _M
mic	อ เอ็- ม _M . อ เ-็- ม _M . อ ไ- _M . ซ -ี _M
joni	จ โ- _M . น -ี _M
michaud	ม -ิ _H . ช โ- _M
michelin	ม -ิ _H . ช เ-อ _M . ล -ิ- น _M
michie	ม -ิ _H . ช -ี _M
michigan	ม -ิ _H . ช -ิ _H . ก แ-- น _M
michon	ม -ิ _H . ช เ-ิ- น _M
mick	ม -ิ- ก _H
micky	ม -ิ- ก _H . ก -ี _M
micro	ม ไ- _M . ค โ- _M . ร โ- _M
microaerophilic	ม ไ- _M . ค โ- _M . ร โ- _M . อ แ- _M . ร โ- _M . ฟ -ิ _H . ล -ิ- ก _H
microgram	ม ไ- _M . ค โ- _M . ร โ- _M . ก -ั- ม _M . ร -ั- ม _M
microgramme	ม ไ- _M . ค โ- _M . ร โ- _M . ก -ั- ม _M . ร -ั- ม _M
micron	ม ไ- _M . ค -อ- น _M . ร -อ- น _M
micronesia	ม ไ- _M . ค โ- _M . ร โ- _M . น -ี _M . ซ เ-ีย _M
microphone	ม ไ- _M . ค โ- _M . ร โ- _M . ฟ โ-- น _M
midi	ม -ิ _H . ด -ิ _L
midi	ม -ี _M . ด -ี _M
midkiff	ม -ิ- ด _H . ค -ิ- ฟ _H
van	ว -า- น _M
mifflin	ม -ิ- ฟ _H . ฟ -ิ- น _M . ล -ิ- น _M
mig	ม -ิ- ก _H
mihan	ม -ี _M . ฮ เ-ิ- น _M
mikail	ม -ิ _H . ค เ- _M . ล เ- _M
milieu	ม -ี _M . ล -ี _M . อ เ-อ _M
milovan	ม -ิ _H . ล โ- _M . ว -า- น _M
min	ม -ิ- น _M
mindoro	ม -ิ- น _M . ด โ- _M . ร โ- _M
ming	ม -ิ- ง _M
mini	ม -ิ _H . น -ิ _H
minick	ม -ี _M . น -ิ- ก _H
minogue	ม -ี _M . น โ-ะ _H
minshall	ม -ิ- น _M . ช เ-ิ- ง _M
miocene	ม ไ- _M . อ โ- _M . ซ -ี- น _M
miriam	ม -ิ _H . ร เ-ีย- ม _M
miro	ม -ี _M . ร โ- _M
miron	ม -ี _M . ร -อ- น _M
mitchem	ม -ี _M . ช -ิ- ม _M
mitotic	ม ไ- _M . ท โ- _M . ต -ิ- ก _L
mmd	อ เอ็- ม _M . อ เ-็- ม _M . อ เอ็- ม _M . อ เ-็- ม _M . ด -ี _M
mob	ม -็อ- บ _H
mock	ม -อ- ก _F
mock	ม -็อ- ก _H
mode	ม โ-- ด _F
modem	ม โ- _M . ด เ-- ม _M
modem	ม โ- _M . ด เ-็- ม _M
modic	ม -อ _M . ด -ิ- ก _L
modin	ม โ- _M . ด -ิ- น _M
modine	ม โ- _M . ด -ี- น _M
modulo	ม -อ _M . ด -ุ _L . ล โ- _M
moe	ม โ- _M
mogensen	ม -อ _M . ก -ิ- น _M . ซ -ั- น _M
mohammed	ม โ- _M . ฮ -ั- ม _M . ม -ั- ด _H
mohan	ม โ- _M . ฮ -ั- น _M
mohawk	ม โ- _M . ฮ -อ- ก _F
mohawk	ม โ- _M . ฮ -็อ- ก _H
moho	ม -อ _M . ฮ -อ _M
mohorovicic	ม โ- _M . ฮ โ- _M . ร โ- _M . ว -ิ _H . ซ -ิ- ก _H
molality	ม โ- _M . ล แ- _M . ล -ิ _H . ต -ี _M
moleon	ม เ-อ _M . ล -ี _M . อ เอิ- น _M . อ เ-ิ- น _M
molin	ม โ- _M . ล -ิ- น _M
moline	ม โ- _M . ล -ิ- น _M
molokai	ม โ- _M . ล โ- _M . ค ไ- _M
molybdenum	ม โ- _M . ล -ิ- บ _H . ด -ี _M . น -ั- ม _M
momentum	ม โ- _M . ม เ-- น _M . ต -ั- ม _M
monahan	ม -อ _M . น เ-อ _M . ฮ แ-- น _M
moncrieff	ม -ั- น _M . ค เ-ิ- ฟ _F . ร เ-ิ- ฟ _F
monet	ม โ- _M . น เ- _M
mongolia	ม -อ- ง _M . ก โ- _M . ล เ-ีย _M
monic	ม โ- _M . น -ิ- ก _H
monjo	ม โ-- น _M . จ โ- _M
mono	ม โ- _M . น โ- _M
monologue	ม โ- _M . น โ- _M . ล -็อ- ก _H
monopoly	ม โ- _M . น โ- _M . ป โ- _M . ล -ี _M
monopoly	ม โ- _M . น โ- _M . พ โ- _M . ล -ี _M
monro	ม -อ- น _M . ร โ- _M
monroe	ม -อ- น _M . ร โ- _M
monson	ม -อ- น _M . ส -ั- น _R
montevideo	ม -อ- น _M . ต เ- _M . ว -ิ _H . ด เ- _M . อ โ- _M
mood	ม -ู- ด _F
moody	ม -ู- ด _F . ด -ี _M
moon	ม -ู- น _M
demi	ด เ- _M . ม -ี _M
moran	ม เ-อ _M . ร แ-- น _M
moreau	ม โ- _M . ร โ- _M
morin	ม -อ _M . ร -ิ- น _M
moro	ม -อ _M . ร โ- _M
moron	ม -อ _M . ร -อ- น _M
morong	ม เ-อ _M . ร -อ- ง _M
moroni	ม โ- _M . ร โ- _M . น -ี _M
morotai	ม -อ _M . ร โ- _M . ต ไ- _M
mosaic	ม โ- _M . ส เ-- ก _L
mosimann	ม โ- _M . ซ -ี _M . ม เ-ิ- น _M
mosso	ม โ- _M . ซ โ- _M
motivation	ม โ- _M . ท -ิ _H . ว เ- _M . ช -ั- น _M
moton	ม โ- _M . ท โ-- น _M
mottram	ม -อ _M . ท เ- _M . ร -ิ- ม _M
mouzon	ม -ู _M . ซ -อ- น _M
moy	ม -อย _M
moynahan	ม -อย _M . น เ-อ _M . ฮ แ-- น _M
moynihan	ม -อย _M . น -ี _M . ฮ แ-- น _M
mozambique	ม โ- _M . ซ -ั- ม _M . บ -ิ- ก _L
mpn	อ เอ็- ม _M . อ เ-็- ม _M . พ -ี _M . อ เอ็- น _M . อ เ-็- น _M
mtb	อ เอ็- ม _M . อ เ-็- ม _M . ท -ี _M . บ -ี _M
mu	ม -ิว _M
muct	อ เอ็- ม _M . อ เ-็- ม _M . ย -ู _M . ซ -ี _M . ท -ี _M
muff	ม -ั- ฟ _H
muffin	ม -ั- ฟ _H . ฟ -ิ- น _M
mugge	ม -ั- ก _H
muhammad	ม -ู _M . ฮ -ั- ม _M . ม -ั- ด _H
mukden	ม -ุ- ก _H . ด เ-- น _M
mun	ม -ั- น _M
muni	ม -ิว _M . น -ี _M
munich	ม -ิว _M . น -ิ- ก _H
munn	ม -ั- น _M
munro	ม เ-ิ- น _M . ร โ- _M
munroe	ม -ั- น _M . ร โ- _M
munson	ม -ั- น _M . ส -ั- น _R
muon	ม -ิว _M . อ -อ- น _M
murad	ม -ิว _M . ร แ-- ด _F
murai	ม -ิว _M . อ เ-อ _M . ร ไ- _M
muriac	ม โ- _M . ร -ี _M . ย -า- ก _F
francois	ฟ -อ- ง _M . ร -อ- ง _M . ซ -ัว _M
music	ม -ิว _M . ซ -ิ- ก _H
music	ม -ิว _M . ส -ิ- ก _L
musick	ม -ิว _M . ซ -ิ- ก _H
mutation	ม -ิว _M . ท เ- _M . ช -ั- น _M
mv	อ เอ็- ม _M . อ เ-็- ม _M . ว -ี _M
mycenae	ม ไ- _M . ซ -ี _M . น -ี _M
myosin	ม ไ- _M . อ โ- _M . ซ -ิ- น _M
myrick	ม ไ- _M . ร -ิ- ก _H
nab	น แ-็- บ _H
nabby	น แ-- บ _F . บ -ี _M
nadia	น เ- _M . ด เ-ีย _M
nafe	น เ-- ฟ _F
nairn	น แ- _M . ร -ึ- น _M
nairobi	น ไ- _M . ร โ- _M . บ -ี _M
name	น เ-- ม _M
namm	น -า- ม _M
naomi	น เ- _M . ด -อ _M . ม -ี _M
ogden	อ -อ- ก _L . ด เ-- น _M
nasion	น เ- _M . ซ -ิ _H . อ -อ- น _M
nason	น แ- _M . ส -ั- น _R
nathan	น เ- _M . ท -า- น _M
nathanson	น แ- _M . ท เ-ิ- น _M . ส -ั- น _R
natick	น เ- _M . ต -ิ- ก _L
nation	น เ- _M . ช -ั- น _M
native	น เ- _M . ท -ิ- ฟ _H
nau	น โ- _M
naum	น -อ- ม _M
nave	น เ-- ฟ _F
nb	อ เอ็- น _M . อ เ-็- น _M . บ -ี _M
nealon	น -ี _M . ล เ-ิ- น _M
neame	น -ิ- ม _M
neave	น -ิ- ฟ _H
necktie	น เ-- ก _F . ท ไ- _M
ned	น เ-- ด _F
neddy	น เ-- ด _F . ด -ี _M
nee	น -ี _M
need	น -ี- ด _F
neef	น -ิ- ฟ _H
nef	น เ-- ฟ _F
neff	น เ-- ฟ _F
neglia	น เ-็- ก _H . ล เ-ีย _M
negri	น เ-- ก _F . ร -ี _M
nehemiah	น -ี _M . อ เ-อ _M . ม ไ- _M . อ เ-อ _M
ricky	ร -ิ- ก _H . ก -ี _M
nekton	น เ-- ก _F . ต -อ- น _M
neogene	น -ี _M . อ โ- _M . จ -ี- น _M
neogene	น -ี _M . อ โ- _M . ย -ี- น _M
neon	น -ี _M . อ -อ- น _M
nepheline	น เ- _M . ฟ -ิ _H . ล -ี- น _M
nephridium	น เ-- ฟ _F . ร -ิ _H . ด เ-ีย- ม _M
nerin	น เ- _M . ร -ิ- น _M
nero	น -ี _M . ร โ- _M
neu	น -อย _M
neutron	น -ิว _M . ร -อ- น _M . ต -อ- น _M
neve	น -ิ- ฟ _H
nevin	น เ- _M . ว -ิ- น _M
nevinson	น เ- _M . ว -ิ- น _M . ส -ั- น _R
new	น -ิว _M
newbery	น -ิว _M . บ เ-อ _M . ร -ี _M
newguinea	น -ิว _M . ก -ิ _L . น -ี _M
newlin	น -ู _M . ล -ิ- น _M
newlove	น -ู _M . ล โ-- ฟ _F
newman	น -ิว _M . ม แ-- น _M
newsome	น -ิว _M . ซ -ั- ม _M
newson	น -ู _M . ส -ั- น _R
newton	น -ิว _M . ต -ั- น _M
niblock	น -ี- บ _F . ล -็อ- ก _H
nicholson	น -ิ _H . ค โ- _M . ล โ- _M . ส -ั- น _R
nick	น -ิ- ก _H
nicklin	น -ิ- ก _H . ล -ิ- น _M
nicky	น -ิ- ก _H . ก -ี _M
nicolson	น -ิ _H . ค โ- _M . ล โ- _M . ส -ั- น _R
nicosia	น -ิ _H . ก โ- _M . ซ เ-ีย _M
nicosia	น -ิ _H . ค โ- _M . ซ เ-ีย _M
nicotine	น -ิ _H . ค โ- _M . ต -ิ- น _M
niehoff	น -ิ _H . ฮ -อ- ฟ _F
nietzsche	น -ี _M . ช เ-อ _M
nigeria	น ไ- _M . จ -ี _M . ร เ-ีย _M
nightingale	น ไ- _M . ต -ิ- ง _M . ก เ- _M . ล เ- _M
nion	น ไ- _M . อ เอิ- น _M . อ เ-ิ- น _M
nitrilotriacetic	น ไ- _M . ร -ิ _L . ต -ิ _L . ล โ- _M . ร ไ- _M . ต ไ- _M . อ แ- _M . ซ -ี _M . ต -ิ- ก _L
niven	น ไ- _M . ว เ-- น _M
nixon	น -ิ- ก _H . ส -ั- น _R
nixon	น -ิ- ก _H . ซ เ-ิ- น _M
no	น โ- _M
nobelium	น โ- _M . บ เ- _M . ล เ-ีย- ม _M
nobuyuki	น โ- _M . บ -ู _M . ย -ู _M . ก -ิ _L
noc	อ เอ็- น _M . อ เ-็- น _M . อ โ- _M . ซ -ี _M
noe	น โ- _M
nolan	น โ- _M . ล เ-ิ- น _M
nolen	น -อ _M . ล เ-ิ- น _M
nolin	น โ- _M . ล -ิ- น _M
noman	น โ- _M . ม เ-ิ- น _M
noren	น -อ _M . ร เ-ิ- น _M
nouveau	น -ู _M . ว โ- _M
novack	น -อ _M . ว เ-ิ- ก _F
novak	น โ- _M . ว แ-- ก _F
nove	น โ-- ฟ _F
novick	น โ- _M . ว -ิ- ก _H
novik	น โ- _M . ว -ิ- ก _H
nowak	น โ- _M . ว แ-็- ก _H
noy	น -อย _M
ntp	อ เอ็- น _M . อ เ-็- น _M . ท -ี _M . พ -ี _M
ntu	อ เอ็- น _M . อ เ-็- น _M . ท -ี _M . ย -ู _M
nucleic	น -ิว _M . ค -ิ _H . ล -ิ _H . อ อิ- ก _L
nucleon	น -ิว _M . ค -ี _M . ล -ี _M . อ -อ- น _M
nucleoprotein	น -ิว _M . ค -ี _M . ล -ี _M . อ โ- _M . ร โ- _M . ป โ- _M . ต -ี- น _M
nude	น -ู- ด _F
nuke	น -ุ- ก _H
nummulitic	น -ั- ม _M . ม -ู _M . ล -ิ _H . ต -ิ- ก _L
nylon	น ไ- _M . ล -อ- น _M
oa	อ โ- _M . อ เ- _M
oake	อ โ- _M . อ เ-- ก _L
oaten	อ โ- _M . อ แ- _M . ท เ-ิ- น _M
obed	อ โ- _M . บ เ-- ด _L
obeirne	อ โ- _M . บ ไ- _M . ร เ-ิ- น _M
oberon	อ โ- _M . บ เ-อ _M . ร -อ- น _M
obi	อ โ- _M . บ -ี _M
oboe	อ โ- _M . บ โ- _M
obsidian	อ -อ- บ _L . ซ -ิ _H . ด เ-ีย- น _M
obukhov	อ โ- _M . บ -ู _M . ค -อ- ฟ _F
obyrne	อ - _L . บ ไ- _M . ร -ึ- น _M
oca	อ โ- _M . ซ -ี _M . อ เ- _M
occam	อ เอิ- ก _L . อ เ-ิ- ก _L . ค แ-- ม _M
occasion	อ -อ- ก _L . ค เ- _M . ช -ั- น _M
oceania	อ โ- _M . ช เ-ีย _M . น เ-ีย _M
octane	อ -อ- ก _L . ท เ-- น _M
octave	อ -อ- ก _L . ท เ-- ฟ _F
octoroon	อ -อ- ก _L . ต โ- _M . ร -ู- น _M
ode	อ โ-- ด _L
odea	อ โ- _M . ด เ-ีย _M
odem	อ โ- _M . ด เ-็- ม _M
odograph	อ โ- _M . ด โ-- ก _L . ร -า- ฟ _F
odonoghue	อ - _L . ด เ-อ _M . น -็อ- ก _H . ฮ -ู _M
of	อ -อ- ฟ _L
off	อ -อ- ฟ _L
oflynn	อ -อ- ฟ _L . ล -ิ- น _M
og	อ โ- _M . จ -ี _M
ogee	อ โ- _M . จ -ี _M
ogive	อ โ- _M . ก -ี- ฟ _L
ohenry	อ โ- _M . ฮ เ-- น _M . ร -ี _M
ok	อ โ- _M . ค เ- _M
okay	อ โ- _M . ค เ- _M
okeefe	อ โ- _M . ค -ี- ฟ _F
okeeffe	อ -อ _M . ค -ี- ฟ _F
oken	อ โ- _M . ค เ-- น _M
okun	อ โ- _M . ค -ู- น _M
olaf	อ โ- _M . ล -ั- ฟ _H
olefins	อ โ- _M . ล เ- _M . ฟ -ิ- น _M
oleson	อ -อ _M . ล -ี _M . ส -ั- น _R
oleum	อ โ- _M . ล เ-ีย- ม _M
oligocene	อ โ- _M . ล -ิ _H . ก โ- _M . ซ -ี- น _M
olin	อ โ- _M . ล -ิ- น _M
olive	อ โ- _M . ล -ิ- ฟ _H
olive	อ โ- _M . ล -ี- ฟ _F
olivia	อ โ- _M . ล -ิ _H . ว เ-ีย _M
olivine	อ โ- _M . ล -ิ _H . ว -ี- น _M
olivo	อ - _L . ล -ี _M . ว โ- _M
olympia	อ โ- _M . ล -ิ- ม _M . ป เ-ีย _M
olympic	อ โ- _M . ล -ิ- ม _M . ป -ิ- ก _L
oman	อ โ- _M . ม -า- น _M
ombai	อ -อ- ม _M . บ ไ- _M
omelia	อ โ- _M . ม เ- _M . ล เ-ีย _M
omicron	อ โ- _M . ม ไ- _M . ค -อ- น _M . ร -อ- น _M
oncken	อ -อ- ง _M . ก แ-- น _M
onek	อ โ- _M . น เ-็- ก _H
ontario	อ -อ- น _M . ท แ- _M . ร -ี _M . อ โ- _M
opaque	อ โ- _M . ป เ-- ก _L
opec	อ โ- _M . ป เ-- ก _L
opening	อ โ- _M . พ เ-- น _M . น -ิ- ง _M
openshaw	อ โ- _M . ป เ-ิ- น _M . ช -อ _M
opie	อ โ- _M . พ -ี _M
orientation	อ -อ _M . ร เ-ีย- น _M . ท เ- _M . ช -ั- น _M
orin	อ -อ _M . ร -ิ- น _M
orogenic	อ -อ _M . ร โ- _M . จ เ- _M . น -ิ- ก _H
donny	ด -อ- น _M . น -ี _M
otec	อ โ- _M . ท เ-็- ก _H
outen	อ โ- _M . ท เ-ิ- น _M
oven	อ โ- _M . ว เ-- น _M
overend	อ โ- _M . ว เ-อ _M . ร เ-ิ- น _M
ovum	อ โ- _M . ว -ั- ม _M
owen	อ โ- _M . ว เ-- น _M
owne	อ โ-- น _M
oxic	อ -อ- ก _L . ซ -ิ- ก _H
oxy	อ -อ- ก _L . ซ -ี _M
oxyhaemoglobin	อ -อ- ก _L . ซ -ี _M . ฮ -ี _M . ม โ- _M . ก โ- _M . ล โ- _M . บ -ิ- น _M
oye	อ -อย _M
ozanne	อ โ- _M . ซ แ-- น _M
ozonation	อ โ- _M . ซ โ- _M . น เ- _M . ช -ั- น _M
ozone	อ โ- _M . ซ โ-- น _M
ozonisation	อ โ- _M . ซ โ- _M . น ไ- _M . ซ เ- _M . ช -ั- น _M
o	อ โ- _M
eugene	ย -ู _M . จ -ี- น _M
pab	พ -ี _M . อ เ- _M . บ -ี _M
pac	พ -ี _M . อ เ- _M . ซ -ี _M
pacific	ป แ- _M . ซ -ิ _H . ฟ -ิ- ก _H
pack	พ แ-- ก _F
pack	พ แ-็- ก _H
packe	พ แ-็- ก _H
packing	พ แ-- ก _F . ก -ิ- ง _M
packman	พ แ-็- ก _H . ม เ-ิ- น _M
pad	พ แ-- ด _F
paddy	พ แ-- ด _F . ด -ี _M
paeon	พ -ี _M . อ -อ- น _M
pagin	พ เ-- ก _F . ก -ิ- น _M
pagliai	พ แ-็- ก _H . ล -ี _M . อ ไ- _M
pain	พ เ-- น _M
palik	พ แ- _M . ล -ิ- ก _H
palk	พ -็อ- ก _H
palladium	ล แ- _M . พ แ- _M . ล เ- _M . ด เ-ีย- ม _M
palo	พ แ- _M . ล โ- _M
palou	พ แ- _M . ล -ู _M
pam	พ แ-- ม _M
pampero	ป -ั- ม _M . ป เ- _M . ร โ- _M
pampero	ป -า- ม _M . ป เ- _M . ร โ- _M
pangaea	ป -ั- น _M . จ เ-ีย _M
pangaea	พ -ั- น _M . จ เ-ีย _M
pangea	พ -ั- น _M . จ เ-ีย _M
pansy	พ แ-- น _M . ซ -ี _M
pantheon	พ แ-- น _M . ท -ี _M . อ -อ- น _M
pantin	พ แ-- น _M . ต -ิ- น _M
pantograph	พ แ-- น _M . ท โ-- ก _F . ร -า- ฟ _F
pao	พ -ี _M . อ เ- _M . อ โ- _M
patenaude	พ แ- _M . ต -ี _M . น โ-- ด _F
pauk	พ -็อ- ก _H
pauken	พ -อ _M . ค เ-ิ- น _M
paulin	พ -อ _M . ล -ิ- น _M
pauline	พ -อ _M . ล -ี- น _M
pauline	ป โ- _M . ล -ี- น _M
pauling	พ -อ _M . ล -ิ- ง _M
pavin	ว เ-ิ- น _M . พ เ-ิ- น _M
pc	พ -ี _M . ซ -ี _M
pcbs	พ -ี _M . ซ -ี _M . บ -ี _M
pcdd	พ -ี _M . ซ -ี _M . ด -ี _M . ด -ี _M
pct	พ -ี _M . ซ -ี _M . ท -ี _M
pda	พ -ี _M . ด -ี _M . อ เ- _M
peabody	พ -ี _M . บ -อ _M . ด -ี _M
peak	พ -ี- ก _F
peake	พ -ี- ก _F
peck	พ เ-็- ก _H
pectin	พ เ-- ก _F . ต -ิ- น _M
pectin	พ เ-- ก _F . ท -ิ- น _M
pedigree	พ เ-- ด _F . ด -ิ- ก _L . ร -ี _M
peejay	พ -ี _M . จ เ- _M
peek	พ -ี- ก _F
peg	พ เ-- ก _F
peg	พ เ-็- ก _H
peggie	พ เ-- ก _F . ก -ี _M
pele	ป เ- _M . ล เ- _M
peleg	พ เ- _M . ล เ-ิ- ก _F
pelham	พ เ- _M . ล เ-ิ- ม _M
pellow	พ เ- _M . ล โ- _M
penang	ป -ี _M . น -ั- ง _M
penelope	พ เ- _M . น เ- _M . ล โ- _M . ป -ี _M
penguin	พ เ-- น _M . ก -ิ- น _M . ว -ิ- น _M
penguin	พ เ-็- น _M . ก -ิ- น _M . ว -ิ- น _M
penicillin	พ เ- _M . น -ิ _H . ซ -ิ _H . ล -ิ- น _M
penick	พ เ- _M . น -ิ- ก _H
pennock	พ เ-- น _M . น เ-ิ- ก _F
penny	พ เ-- น _M . น -ี _M
penny	พ เ-็- น _M . น -ี _M
penson	พ เ-- น _M . ส -ั- น _R
penutian	พ -ี _M . น -ู _M . ช เ-ีย- น _M
penzing	พ เ-- น _M . ซ -ิ- ง _M
peperoni	พ เ- _M . พ เ- _M . ร โ- _M . น -ี _M
peregrine	พ เ- _M . ร เ-- ก _F . ร -ี- น _M
peren	ร เ-ิ- น _M . พ เ-ิ- น _M
perigean	ป เ- _M . ร -ิ _H . จ เ-ีย- น _M
perigee	ป เ- _M . ร -ิ _H . จ -ี _M
perigee	พ เ- _M . ร -ิ _H . จ -ี _M
perihelion	ป เ- _M . ร -ิ _H . ฮ เ- _M . ล -ิ _H . อ -อ- น _M
perihelion	พ เ- _M . ร -ิ _H . ฮ -ี _M . ล เ-ีย- น _M
perihelion	พ เ-อ _M . ร -ิ _H . ฮ -ี _M . ล -ี _M . อ -อ- น _M
perikinetic	พ เ-อ _M . ร -ิ _H . ค ไ- _M . น เ- _M . ต -ิ- ก _L
periodic	พ -ี _M . ร -ิ _H . อ -อ _M . ด -ิ- ก _L
periodic	พ เ- _M . ร -ิ _H . อ -อ _M . ด -ิ- ก _L
periphyton	พ เ-อ _M . ร -ิ _H . ฟ ไ- _M . ต -อ- น _M
peru	ป เ- _M . ร -ู _M
peso	ป เ- _M . ซ โ- _M
petanque	ป เ- _M . ต -อ- ง _M
petroleum	ป -ิ _L . ร โ- _M . ต โ- _M . ล เ-ีย- ม _M
petunia	พ -ิ _H . ท -ู _M . น เ-ีย _M
pew	พ -ิว _M
pflag	ฟ แ-็- ก _H . ล แ-็- ก _H
pg	พ -ี _M . จ -ี _M
phail	ฟ เ- _M . ล เ- _M
phaneuf	ฟ แ- _M . น -ู- ฟ _F
phantom	ฟ แ-- น _M . ท -อ- ม _M
pheromone	ฟ เ- _M . ร โ- _M . ม โ-- น _M
phi	ฟ -าย _M
phi	ฟ -ี _M
philemon	ฟ ไ- _M . ล -ี _M . ม -ั- น _M
philosophy	ฟ -ิ _H . ล -อ _M . ซ โ- _M . ฟ -ี _M
phin	ฟ -ิ- น _M
phloem	ฟ โ- _M . ล โ- _M . อ เอ็- ม _M . อ เ-็- ม _M
phobia	ฟ โ- _M . บ เ-ีย _M
phoenician	ฟ -ิ _H . น -ิ _H . ช เ-ีย- น _M
phon	ฟ -อ- น _M
photochemy	ฟ โ- _M . ต โ- _M . ค เ- _M . ม -ี _M
photon	ฟ โ- _M . ต -อ- น _M
phylum	ฟ ไ- _M . ล -ั- ม _M
physick	ฟ -ี _M . ซ -ิ- ก _H
pi	พ -าย _M
piano	ป เ-ีย _M . น โ- _M
piccolo	พ -ิ- ก _H . ค โ- _M . ล โ- _M
pick	พ -ิ- ก _H
picnic	ป -ิ- ก _L . น -ิ- ก _H
pico	พ -ิ- ก _H . ก โ- _M
pico	พ -ิ _H . ก โ- _M
picocurie	พ -ิ _H . ค โ- _M . ค -ู _M . ร -ี _M
picon	พ -ิ _H . ค เ-ิ- น _M
pidgin	พ -ิ- ด _H . จ -ิ- น _M
pie	พ -าย _M
pilaf	พ -ิ _H . ล -า- ฟ _F
pilang	ป -ิ _L . ล -ั- ง _M
pilon	พ -ิ _H . ล -อ- น _M
pim	พ -ิ- ม _M
pin	พ -ิ- น _M
pindyck	พ -ิ- น _M . ด -ิ- ก _L
pineau	พ -ิ _H . น โ- _M
pinero	พ -ิ _H . น เ- _M . ร โ- _M
ping	ป -ิ- ง _M
pingo	ป -ิ- ง _M . ก โ- _M
pinguin	พ -ิ- น _M . ก -ิ- น _M . ว -ิ- น _M
pinnock	พ -ิ- น _M . น -็อ- ก _H
pino	พ -ี _M . น โ- _M
pj	พ -ี _M . จ เ- _M
plaque	ล -ั- ก _H . พ -ั- ก _H
platinum	ล แ- _M . พ แ- _M . ท -ิ _H . น -ั- ม _M
plato	ล เ- _M . พ เ- _M . ต โ- _M
pliocene	ล ไ- _M . พ ไ- _M . อ โ- _M . ซ -ี- น _M
plough	ล -าว _M . พ -าว _M
plum	ล -ั- ม _M . พ -ั- ม _M
pluto	ล -ู _M . พ -ู _M . ต โ- _M
pluton	ล -ู _M . พ -ู _M . ต -อ- น _M
plutonium	ล -ู _M . พ -ู _M . ต โ- _M . น เ-ีย- ม _M
plutonium	ล -ู _M . พ -ู _M . ท โ- _M . น เ-ีย- ม _M
plywood	ล -าย _M . พ -าย _M . ว -ู- ด _F
pm	พ -ี _M . อ เอ็- ม _M . อ เ-็- ม _M
pnas	พ -ี _M . อ เอ็- น _M . อ เ-็- น _M . อ เ- _M
pneumatic	น -ิว _M . ม เ- _M . ต -ิ- ก _L
pneumonia	น -ิว _M . ม -อ _M . น เ-ีย _M
pod	พ -อ- ด _F
podium	พ โ- _M . ด เ-ีย- ม _M
podzolic	พ -อ- ด _F . ซ โ- _M . ล -ิ- ก _H
poe	พ โ- _M
poff	พ -อ- ฟ _F
pole	ล โ- _M . ป โ- _M
policy	พ -อ _M . ล -ิ _H . ซ -ี _M
poling	พ โ- _M . ล -ิ- ง _M
polio	ป โ- _M . ล -ิ _H . อ โ- _M
polo	ป โ- _M . ล โ- _M
polson	ล โ- _M . พ โ- _M . ส -ั- น _R
polyconic	ป โ- _M . ล -ิ _H . ค โ- _M . น -ิ- ก _H
polyethylene	พ -อ _M . ล -ิ _H . อ เ- _M . ท -ิ _H . ล -ี- น _M
polyethylene	พ โ- _M . ล -ี _M . อ เ- _M . ท -ิ _H . ล -ี- น _M
polypropylene	พ -อ _M . ล -ิ _H . ร โ- _M . พ โ- _M . พ -ิ _H . ล -ี- น _M
polyurethane	พ -อ _M . ล -ิ _H . ย -ู _M . ร -ิ _H . ท เ-- น _M
polyurethane	พ โ- _M . ล -ี _M . ย -ู _M . ร -ิ _H . ท เ-- น _M
polyurethane	พ โ- _M . ล -ี _M . ย -ู _M . ร เ- _M . ท เ-- น _M
pomade	พ -อ _M . ม เ-- ด _F
pomeroy	พ -อ _M . ม เ-อ _M . ร -อย _M
poncho	พ -อ- น _M . ช โ- _M
du	ด -ู _M
pontiac	พ -อ- น _M . ท -ิ _H . อ แอ็- ก _L . อ แ-็- ก _L
pook	พ -ุ- ก _H
poseidon	พ โ- _M . ซ ไ- _M . ด -อ- น _M
potato	พ โ- _M . ท เ- _M . ต โ- _M
poti	ป โ- _M . ต -ี _M
poudre	พ -าว _M . ด เ- _M . ร -อ _M
poulain	พ -ู _M . ล -ิ- น _M
poussin	ป -ู _M . ซ แ-- ง _M
pp	พ -ี _M . พ -ี _M
prague	ร -า- ก _L . ป -า- ก _L
pre	ร -ี _M . พ -ี _M
precipitation	ร -ี _M . พ -ี _M . ซ -ิ _H . พ -ิ _H . ท เ- _M . ช -ั- น _M
premo	ร แ- _M . พ แ- _M . ม โ- _M
presentation	ร -ี _M . พ -ี _M . ซ เ-- น _M . ท เ- _M . ช -ั- น _M
pretoria	ร -ิ _L . ป -ิ _L . ต -อ _M . ร เ-ีย _M
pretoria	ร -ิ _H . พ -ิ _H . ท -อ _M . ร เ-ีย _M
pribilof	ร -ิ _H . พ -ิ _H . บ -ิ _L . ล -อ- ฟ _F
prism	ร -ิ _L . ป -ิ _L . ซ -ึ- ม _M
procyon	ร โ- _M . ป โ- _M . ซ -ิ _H . อ -อ- น _M
production	ร โ- _M . พ โ- _M . ด -ั- ก _L . ช -ั- น _M
profumo	ร โ- _M . พ โ- _M . ฟ -ู _M . ม โ- _M
projection	ร โ- _M . พ โ- _M . จ เ-็- ก _L . ช -ั- น _M
proliferation	ร โ- _M . พ โ- _M . ล -ิ _H . ฟ เ-อ _M . ร เ- _M . ช -ั- น _M
prolog	ร โ- _M . ป โ- _M . ล -็อ- ก _H
prom	ร -็อ- ม _M . พ -็อ- ม _M
promotion	ร โ- _M . ป โ- _M . ม โ- _M . ช -ั- น _M
promotion	ร โ- _M . พ โ- _M . ม โ- _M . ช -ั- น _M
prony	ร โ- _M . พ โ- _M . น -ี _M
protactinium	ร โ- _M . พ โ- _M . ท แ-- ก _F . ท -ิ _H . น เ-ีย- ม _M
protein	ร โ- _M . ป โ- _M . ต -ี- น _M
protoactinium	ร โ- _M . พ โ- _M . ท โ- _M . อ แ-- ก _L . ท -ิ _H . น เ-ีย- ม _M
proton	ร โ- _M . ป โ- _M . ต -อ- น _M
protons	ร โ- _M . ป โ- _M . ต -อ- น _M
protozoa	ร โ- _M . พ โ- _M . ท โ- _M . ซ -ัว _M
pru	ร -ู _M . พ -ู _M
prude	ร -ู- ด _F . พ -ู- ด _F
prudhoe	ร -ุ- ด _H . พ -ุ- ด _H . ฮ โ- _M
prudhomme	ร -ั- ด _H . พ -ั- ด _H . ฮ เ-ิ- ม _M
prue	ร -ู _M . พ -ู _M
prune	ร -ุ- น _M . พ -ุ- น _M
prune	ร -ู- น _M . พ -ู- น _M
pryrobitumen	พ ไ- _M . ร โ- _M . บ -ิ _L . ท -ู _M . ม เ-- น _M
psilomelane	ซ ไ- _M . ล โ- _M . ม -ิ _H . ล เ-- น _M
psycho	ซ ไ- _M . ค โ- _M
psychrophilic	ซ ไ- _M . ค โ- _M . ร โ- _M . ฟ -ิ _H . ล -ิ- ก _H
ptolemaic	ต โ- _M . ล เ- _M . ม -ี _M
pudding	พ -ุ- ด _H . ด -ิ- ง _M
pue	พ -ู _M
puff	พ -ั- ฟ _H
pugin	พ -ิว _M . จ -ิ- น _M
pure	พ เ-ียว _M
purin	พ -ู _M . ร -ิ- น _M
puritan	พ -ิว _M . ร -ิ _H . ต -ั- น _M
puy	ป -ุย _M
puzo	ป -ู _M . ซ โ- _M
pvc	พ -ี _M . ว -ี _M . ซ -ี _M
pygmy	ป -ิ- ก _L . ม -ี _M
pygmy	พ -ิ- ก _H . ม -ี _M
pym	พ -ิ- ม _M
pynchon	พ -ิ- น _M . ช -ั- น _M
pynchon	พ -ิ- น _M . ช เ-ิ- น _M
pyongyang	ป เ-ีย- ง _M . ย -า- ง _M
pyroxene	พ ไ- _M . ร -อ- ก _F . ซ -ี- น _M
quadroon	ค -อ- ด _F . ว -อ- ด _F . ร -ู- น _M
quam	ค -ั- ม _M . ว -ั- ม _M
quantam	ค -อ- น _M . ว -อ- น _M . ต -ั- ม _M
quantity	ค -ั- น _M . ว -ั- น _M . ท -ิ _H . ต -ี _M
quantum	ค -อ- น _M . ว -อ- น _M . ต -ั- ม _M
quantum	ค -ั- น _M . ว -ั- น _M . ต -ั- ม _M
quebec	ค -ิ _H . ว -ิ _H . บ เ-- ก _L
quello	ก เ- _M . ว เ- _M . ล โ- _M
queue	ค -ิว _M
queux	ก เ-อ _M
quie	ค -ี _M . ว -ี _M
quin	ค -ิ- น _M . ว -ิ- น _M
quine	ค -ิ- น _M . ว -ิ- น _M
quintilian	ค -ิ- น _M . ว -ิ- น _M . ท -ิ _H . ล เ-ีย- น _M
quintin	ค -ิ- น _M . ว -ิ- น _M . ท -ิ- น _M
quintin	ก แ-- ง _M . ต แ-- ง _M
quipu	ค -ิ _H . ป -ู _M
quotation	ค โ- _M . ว โ- _M . ท เ- _M . ช -ั- น _M
raab	ร -า- บ _F
raabe	ร -า- บ _F
rabb	ร แ-็- บ _H
rabbi	ร แ-- บ _F . บ ไ- _M
raccoon	ร แ-- ก _F . ค -ู- น _M
rachlin	ร แ-็- ก _H . ล -ิ- น _M
rackham	ร แ-็- ก _H . ฮ เ-ิ- ม _M
rad	ร แ-- ด _F
rad	ร แ-็- ด _H
radian	ร เ- _M . ด เ-ีย- น _M
radio	ร เ- _M . ด -ิ _L . อ โ- _M
radium	ร เ- _M . ด เ-ีย- ม _M
radome	ร เ- _M . ด โ-- ม _M
radon	ร เ- _M . ด -อ- น _M
rae	ร เ- _M
rafe	ร เ-- ฟ _F
ragg	ร แ-็- ก _H
raglan	ร แ-- ก _F . ล แ-- น _M
raglan	ร แ-็- ก _H . ล เ-ิ- น _M
rahab	ร แ- _M . ฮ เ-ิ- บ _F
rahim	ร เ-อ _M . ฮ -ิ- ม _M
rahm	ร แ-- ม _M
rain	ร เ-- น _M
raine	ร เ-- น _M
raisin	ร เ- _M . ซ -ิ- น _M
rake	ร เ-- ก _F
rakim	ร -ั- ก _H . ค -ิ- ม _M
raleigh	ร -อ _M . ล -ี _M
raman	ร เ- _M . ม เ-ิ- น _M
ramm	ร แ-- ม _M
ramo	ร เ- _M . ม โ- _M
randy	ร แ-- น _M . ด -ี _M
ranken	ร แ-- ง _M . ค เ-ิ- น _M
rankin	ร แ-- ง _M . ค -ิ- น _M
rankine	ร แ-- ง _M . ค -ิ- น _M
ransom	ร แ-- น _M . ซ -ั- ม _M
ransom	ร แ-- น _M . ซ เ-ิ- ม _M
ranson	ร แ-- น _M . ส -ั- น _R
raphson	ร -า- ฟ _F . ส -ั- น _R
ratio	ร เ- _M . ช โ- _M
rau	ร โ- _M
rauh	ร -อ _M
rawn	ร -อ- น _M
rawson	ร -อ _M . ส -ั- น _R
re	ร เ- _M
rea	ร -ี _M
reaction	ร -ี _M . อ แ-- ก _L . ช -ั- น _M
read	ร -ี- ด _F
reade	ร เ-- ด _F
readhead	ร -ิ- ด _H . ฮ เ-- ด _F
ready	ร เ- _M . ด -ี _M
reagan	ร เ- _M . ก แ-- น _M
ream	ร -ี- ม _M
reback	ร -ี _M . บ แ-็- ก _L
reck	ร เ-็- ก _H
reco	ร -ิ- ก _H . ค โ- _M
rectum	ร เ-- ก _F . ต -ั- ม _M
redd	ร เ-- ด _F
reddick	ร เ-- ด _F . ด -ิ- ก _L
rede	ร เ-- ด _F
redhead	ร เ-- ด _F . ฮ เ-- ด _F
redlich	ร เ-- ด _F . ล -ิ- ก _H
redmayne	ร เ-- ด _F . ม เ-- น _M
redmond	ร เ-- ด _F . ม เ-ิ- น _M
reduction	ร -ี _M . ด -ั- ก _L . ช -ั- น _M
redwood	ร เ-- ด _F . ว -ู- ด _F
reeb	ร -ี- บ _F
reed	ร -ี- ด _F
reef	ร -ี- ฟ _F
reengineering	ร -ี _M . อ เ-- น _M . จ -ิ _L . น เ-ีย _M . ร -ิ- ง _M
reeve	ร -ี- ฟ _F
reg	ร เ-- ก _F
regia	ร -ี _M . จ เ-ีย _M
rehan	ร -ี _M . ฮ เ-ิ- น _M
rehm	ร เ-- ม _M
reid	ร -ี- ด _F
reiff	ร -ิ- ฟ _H
reiki	ร ไ- _M . ก -ิ _L
reinecke	ร ไ- _M . น -ิ- ก _H
reinicke	ร ไ- _M . น เ-ิ- ก _F
reisig	ร ไ- _M . ซ -ิ- ก _H
reissig	ร ไ- _M . ซ -ิ- ก _H
remick	ร เ- _M . ม -ิ- ก _H
remoulade	ร เ- _M . ม โ- _M . ล -า- ด _F
remoulade	ร เ- _M . ม โ- _M . ล เ-- ด _F
rendon	ร เ-- น _M . ด โ-- น _M
renfrew	ร เ-- น _M . ฟ -ู _M . ร -ู _M
renick	ร เ- _M . น -ิ- ก _H
renn	ร เ-- น _M
renne	ร เ-- น _M
renouf	ร เ-อ _M . น -ู- ฟ _F
renwick	ร เ-- น _M . ว -ิ- ก _H
resin	ร เ- _M . ซ -ิ- น _M
reuven	ร -ู _M . ว เ-ิ- น _M
review	ร -ี _M . ว -ิว _M
rew	ร -ู _M
reynaud	ร เ- _M . น -อ- ด _F
reyne	ร เ-- น _M
rhaetic	ร -ี _M . ต -ิ- ก _L
rhea	ร เ-ีย _M
rho	ร โ- _M
rhodesia	ร โ- _M . ด -ิ _L . ซ เ-ีย _M
rhodium	ร โ- _M . ด เ-ีย- ม _M
rhondda	ร -ั- น _M . ด เ-อ _M
rhone	ร โ-- น _M
ribonucleic	ร ไ- _M . บ โ- _M . น -ิว _M . ค -ิ _H . ล -ิ _H . อ อิ- ก _L
ribosome	ร ไ- _M . บ โ- _M . ซ โ-- ม _M
rick	ร -ิ- ก _H
rickett	ร -ี _M . ค -ิ- ด _H
rickey	ร -ิ- ก _H . ก -ี _M
riddick	ร -ิ- ด _H . ด -ิ- ก _L
riding	ร ไ- _M . ด -ิ- ง _M
rieck	ร -ิ- ก _H
riecke	ร -ิ- ก _H
ried	ร -ิ- ด _H
ried	ร -ี- ด _F
rieff	ร -ิ- ฟ _H
ring	ร -ิ- ง _M
ringham	ร -ิ- ง _M . ฮ แ-- ม _M
ringling	ร -ิ- ง _M . ล -ิ- ง _M
rison	ร -ี _M . ส -ั- น _R
rivero	ร -ี _M . ว เ- _M . ร โ- _M
rivlin	ร -ี- ฟ _F . ล -ิ- น _M
roan	ร โ-- น _M
roane	ร โ-- น _M
roaring	ร -อ _M . ร -ิ- ง _M
rob	ร -็อ- บ _H
robbie	ร -็อ- บ _H . บ -ี _M
robe	ร โ-- บ _F
robeson	ร โ- _M . บ -ี _M . ส -ั- น _R
robichaud	ร -อ _M . บ -ิ _L . ช โ- _M
robin	ร -อ _M . บ -ิ- น _M
robinsin	ร -อ _M . บ -ิ- น _M . ส -ั- น _R
robinson	ร -อ _M . บ -ิ- น _M . ส -ั- น _R
robison	ร -อ _M . บ -ิ _L . ส -ั- น _R
roblin	ร -อ- บ _F . ล -ิ- น _M
robson	ร -็อ- บ _H . ส -ั- น _R
rock	ร -็อ- ก _H
rocke	ร -็อ- ก _H
rockingham	ร -็อ- ก _H . ค -ิ- น _M . ฮ แ-- ม _M
rockwood	ร -็อ- ด _H . ว -ู- ด _F
rocky	ร -อ- ก _F . ก -ี _M
rod	ร -อ- ด _F
rodd	ร -อ- ด _F
roddick	ร -็อ- ด _H . ด -ิ- ก _L
roddon	ร -็อ- ด _H . ด -อ- น _M
rode	ร โ-- ด _F
roderic	ร -อ- ด _F . ร -ิ- ก _H
roderick	ร -อ _M . ด เ- _M . ร -ิ- ก _H
jimmie	จ -ิ- ม _M . ม -ี _M
rodin	ร โ- _M . ด แ-- ง _M
roe	ร โ- _M
roebuck	ร โ- _M . บ -ั- ก _L
roeland	ร โ- _M . ล เ-ิ- น _M
rogan	ร โ- _M . ก เ-ิ- น _M
roger	ร โ- _M . ช เ- _M
roget	ร โ- _M . ช เ- _M
rogge	ร -็อ- ก _H
rohde	ร โ-- ด _F
der	ด เ-อ _M
rohm	ร โ-- ม _M
rojek	ร โ- _M . ย เ-็- ก _H
roland	ร โ- _M . ล เ-ิ- น _M
romain	ร โ- _M . ม เ-- น _M
romane	ร โ- _M . ม เ-- น _M
romanne	ร โ- _M . ม แ-- น _M
romanoff	ร โ- _M . ม -า- น _M . อ - ฟ _L
romanov	ร โ- _M . ม -า- น _M . อ - ฟ _L
romantic	ร โ- _M . ม แ-- น _M . ต -ิ- ก _L
rombach	ร -อ- ม _M . บ -ั- ก _L
rome	ร โ-- ม _M
romeo	ร โ- _M . ม -ิ _H . อ โ- _M
romeu	ร โ- _M . ม -ู _M
romm	ร -อ- ม _M
ron	ร -อ- น _M
ronne	ร -อ- น _M
ronnie	ร -อ- น _M . น -ี _M
room	ร -ู- ม _M
roome	ร -ู- ม _M
rosalynn	ร โ- _M . ซ เ-อ _M . ล -ิ- น _M
roseau	ร โ- _M . ซ โ- _M
rosey	ร โ- _M . ซ -ี _M
rosin	ร เ- _M . ซ -ิ- น _M
roszak	ร -อ _M . ช เ-ิ- ก _F
roti	ร โ- _M . ต -ี _M
rough	ร -ั- ฟ _H
routine	ร -ู _M . ท -ี- น _M
rovine	ร โ- _M . ว -ิ- น _M
rowan	ร โ- _M . ว -ั- น _M
rowan	ร โ- _M . ว แ-- น _M
rowen	ร โ- _M . ว เ-- น _M
rowson	ร โ- _M . ส -ั- น _R
rozanne	ร โ- _M . ซ แ-- น _M
ruane	ร -ู _M . อ เ-- น _M
rubbra	ร -ั- บ _H . บ เ- _M . ร -อ _M
ruben	ร -ู _M . บ เ-ิ- น _M
rubidium	ร -ู _M . บ -ิ _L . ด เ-ีย- ม _M
ruby	ร -ู _M . บ -ี _M
ruck	ร -ั- ก _H
ruddick	ร -ั- ด _H . ด -ิ- ก _L
rude	ร -ู- ด _F
rudkin	ร -ั- ด _H . ค -ิ- น _M
rudnick	ร -ั- ด _H . น -ิ- ก _H
rue	ร -ู _M
ruegg	ร -ู- ก _F
rugby	ร -ั- ก _H . บ -ี _M
rugg	ร -ั- ก _H
rugge	ร -ั- ก _H
rugh	ร -อ _M
ruhm	ร -ั- ม _M
rum	ร -ั- ม _M
runes	ร -ู- น _M
runge	ร -ุ- ง _M . ง เ-อ _M
runnymede	ร -ั- น _M . น -ิ _H . ม -ี- ด _F
ruoff	ร -ู _M . อ -อ- ฟ _L
rupee	ร -ู _M . ป -ี _M
rupiah	ร -ู _M . ป เ-ีย _M
ruthenium	ร -ู _M . ท -ี _M . น เ-ีย- ม _M
ryde	ร -ิ- ด _H
ryen	ร ไ- _M . อ เอิ- น _M . อ เ-ิ- น _M
ryman	ร ไ- _M . ม เ-ิ- น _M
ryno	ร -ี _M . น โ- _M
ryukyu	ร -ิว _M . ก -ิว _M
eero	อ เ- _M . ร โ- _M
sabine	ซ แ- _M . บ -ี- น _M
sack	ซ แ-็- ก _H
sack	ส แ-็- ก _L
sadie	ซ เ- _M . ด -ี _M
sadove	ซ -อ _M . ด -อ- ฟ _L
safe	ซ เ-็- ฟ _H
safety	ซ เ-- ฟ _F . ต -ี _M
saffron	ซ แ-- ฟ _F . ฟ -อ- น _M . ร -อ- น _M
bud	บ -ั- ด _L
said	ซ เ-- ด _F
saimon	ซ ไ- _M . ม เ-ิ- น _M
sain	ซ เ-- น _M
saipan	ซ ไ- _M . ป -ั- น _M
salem	ซ เ- _M . ล เ-- ม _M
d	ด -ี _M
salmon	ซ แ- _M . ม -อ- น _M
salomon	ซ แ- _M . ล เ-อ _M . ม เ-ิ- น _M
sampling	ซ แ-- ม _M . ล -ิ- ง _M . พ -ิ- ง _M
samson	ซ แ-- ม _M . ส -ั- น _R
san	ซ -ั- น _M
san	ซ -า- น _M
sandison	ซ แ-- น _M . ด -ิ _L . ส -ั- น _R
sando	ซ แ-- น _M . ด โ- _M
sandon	ซ แ-- น _M . ด -อ- น _M
sandy	ซ แ-- น _M . ด -ี _M
sanko	ซ แ-- ง _M . ก โ- _M
sanmy	ซ แ-- ม _M . ม -ี _M
sansom	ซ แ-- น _M . ซ -อ- ม _M
santiago	ซ -า- น _M . ต -ิ _L . อ เ- _M . ก โ- _M
santo	ซ -ั- น _M . ต โ- _M
santo	ซ -า- น _M . ต โ- _M
santorin	ซ แ-- น _M . ต โ- _M . ร -ิ- น _M
sanzio	ซ -ั- น _M . ซ -ี _M . อ โ- _M
saprophytic	ซ แ- _M . ร โ- _M . พ โ- _M . ฟ ไ- _M . ต -ิ- ก _L
sarich	ซ แ- _M . ร -ิ- ก _H
bin	บ -ิ- น _M
savory	ซ เ- _M . ว เ-อ _M . ร -ี _M
saxon	ซ แ-- ก _F . ซ -ั- น _M
saxony	ซ แ-- ก _F . ซ โ- _M . น -ี _M
saxophone	ซ แ-- ก _F . ซ โ- _M . ฟ โ-- น _M
saxophone	ซ แ-็- ก _H . ซ โ- _M . ฟ โ-- น _M
scene	ซ -ี- น _M
schaaf	ช -อ- ฟ _F
schack	ช แ-็- ก _H
schad	ช แ-- ด _F
schade	ช เ-- ด _F
schapiro	ช แ- _M . พ ไ- _M . ร โ- _M
schaub	ช -็อ- บ _H
scheer	ช เ-ีย _M
scheid	ช เ-- ด _F
scherf	ช เ-- ฟ _F
schick	ช -ิ- ก _H
schine	ช -ิ- น _M
schoen	ช โ-- น _M
schon	ช -ั- น _M
schuck	ช -ั- ก _H
schumm	ช -อ- ม _M
sea	ซ -ี _M
seafood	ซ -ี _M . ฟ -ู- ด _F
seago	ซ -ี _M . ก โ- _M
seaman	ซ -ี _M . ม เ-ิ- น _M
sean	ช -อ- น _M
season	ซ -ี _M . ซ -ั- น _M
sebon	ซ เ- _M . บ -อ- น _M
sec	ซ เ-- ก _F
secam	ซ -ี _M . ค แ-- ม _M
secam	ซ เ- _M . ค แ-- ม _M
seccombe	ซ เ-็- ก _H . ค โ-- ม _M
security	ซ เ- _M . ค เ-ียว _M . ร -ิ _H . ต -ี _M
sedan	ซ -ี _M . ด -า- น _M
seelig	ซ -ี _M . ล -ิ- ก _H
seelye	ซ -ี _M . ล ไ- _M
seem	ซ -ี- ม _M
sehn	ซ แ-- น _M
selenium	ซ -ิ _H . ล -ี _M . น เ-ีย- ม _M
selenium	ซ -ี _M . ล -ิ _H . น เ-ีย- ม _M
selenium	ซ -ี _M . ล -ี _M . น เ-ีย- ม _M
selenium	ซ เ- _M . ล เ- _M . น เ-ีย- ม _M
selig	ซ เ- _M . ล -ิ- ก _H
selim	ซ เ- _M . ล -ิ- ม _M
selin	ซ เ- _M . ล -ิ- น _M
seman	ซ -ี _M . ม เ-ิ- น _M
semitic	ซ เ- _M . ม -ิ _H . ต -ิ- ก _L
sen	ซ เ-็- น _M
sendak	ซ เ-- น _M . ด แ-็- ก _L
senn	ซ เ-- น _M
sensitive	ซ เ-- น _M . ซ -ิ _H . ท -ิ- ฟ _H
senti	ซ เ-็- น _M . ต -ิ _L
sepia	ซ -ี _M . ป เ-ีย _M
seraphin	ซ เ-อ _M . ร -อ _M . ฟ -ิ- น _M
serie	ซ -ี _M . ร -ี _M
serum	ซ -ี _M . ร -ั- ม _M
seton	ซ -ี _M . ต เ-ิ- น _M
sexy	ซ เ-็- ก _H . ซ -ี _M
shad	ช แ-- ด _F
shade	ฉ เ-- ด _L
shade	ช เ-- ด _F
shadyac	ช แ-- ด _F . ย แ-็- ก _H
shahan	ช แ- _M . ฮ เ-ิ- น _M
shaheen	ช เ-อ _M . ฮ -ี- น _M
shake	ช เ-- ก _F
sham	ช แ-- ม _M
shampoo	ช แ-- ม _M . พ -ู _M
shanahan	ช แ- _M . น เ-อ _M . ฮ แ-- น _M
shane	ช เ-- น _M
shanklin	ช แ-- ง _M . ค -ิ- น _M . ล -ิ- น _M
shann	ช แ-- น _M
shapleigh	ช เ- _M . ล เ-อ _M . พ เ-อ _M
sharon	ช แ- _M . ร -อ- น _M
shaun	ช -อ- น _M
shayne	ช เ-- น _M
shea	ช เ- _M
sheaf	ช -ี- ฟ _F
shedd	ช เ-- ด _F
sheehan	ช -ี _M . อ เอิ- น _M . อ เ-ิ- น _M
sheehy	ช -ี _M . ฮ -ี _M
sheen	ช -ี- น _M
sheerin	ช -ี _M . ร -ิ- น _M
sheridan	ช เ- _M . ร -ิ _H . ด แ-- น _M
b	บ -ี _M
shiek	ช -ี- ก _F
brooke	บ -็ _L . ร -ู- ก _F
shieling	ช -ี _M . ล -ิ- ง _M
shikoku	ช -ิ _H . ก โ- _M . ก -ุ _L
shim	จ -ี- ม _M
shireen	ช -ิ _H . ร -ิ- น _M
shoe	ช -ู _M
sholokhov	ช โ- _M . ล โ- _M . ค -อ- ฟ _F
shon	ช -อ- น _M
shoshoni	ช โ- _M . ช โ- _M . น -ี _M
shub	ช -ั- บ _H
shuman	ช -ู _M . ม เ-ิ- น _M
siberia	ซ ไ- _M . บ -ี _M . ร เ-ีย _M
siberian	ซ ไ- _M . บ -ี _M . ร เ-ีย- น _M
sicilian	ซ -ิ _H . ซ -ิ _H . ล เ-ีย- น _M
sicily	ซ -ิ _H . ซ -ิ _H . ล -ี _M
sid	ซ -ิ- ด _H
sidman	ซ -ิ- ด _H . ม เ-ิ- น _M
sieck	ซ -ิ- ก _H
sief	ซ -ิ- ฟ _H
sieg	ซ -ิ- ก _H
siegfried	ซ -ิ- ก _H . ฟ -ี- ด _F . ร -ี- ด _F
sierozem	ซ เ-ีย _M . ร โ- _M . ซ เ-- ม _M
sieve	ซ -ี- ฟ _F
signum	ซ -ิ- ก _H . น -ั- ม _M
sikh	ซ -ิ- ก _H
sikkhim	ส -ิ- ก _L . ข -ิ- ม _R
sikri	ส -ิ- ก _L . ร -ี _M
silicic	ซ -ิ _H . ล -ิ _H . ซ -ิ- ก _H
silicon	ซ -ิ _H . ล -ิ _H . ค -อ- น _M
silicone	ซ -ิ _H . ล -ิ _H . ค โ-- น _M
silo	ซ ไ- _M . ล โ- _M
silurian	ซ ไ- _M . ล -ู _M . ร เ-ีย- น _M
sim	ซ -ิ- ม _M
simco	ซ -ิ- ม _M . ค โ- _M
simeon	ซ -ี _M . ม เ-ีย- น _M
similarity	ซ -ิ _H . ม -ิ _H . ล แ- _M . ร -ิ _H . ต -ี _M
simile	ซ -ิ _H . ม -ิ _H . ล -ี _M
simon	ซ -ี _M . ม -อ- น _M
simonson	ซ ไ- _M . ม เ-ิ- น _M . ส -ั- น _R
simoon	ซ -ิ _H . ม -ู- น _M
simson	ซ -ิ- ม _M . ส -ั- น _R
sinai	ซ ไ- _M . น ไ- _M
sinek	ซ -ี _M . น -ิ- ก _H
sinotibetan	ซ ไ- _M . น โ- _M . ท -ิ _H . บ เ- _M . ต -ั- น _M
siphon	ซ ไ- _M . ฟ -อ- น _M
siren	ซ ไ- _M . ร เ-- น _M
sirocco	ซ -ิ _H . ร -อ- ก _F . ก โ- _M
sirocco	ซ -ิ _H . ร -อ- ก _F . ค โ- _M
situation	ซ -ิ _H . ท -ู _M . อ เ- _M . ช -ั- น _M
tony	ท โ- _M . น -ี _M
soane	ซ โ-- น _M
sobczak	ซ -อ- บ _F . ช แ-็- ก _H
society	ซ โ- _M . ซ ไ- _M . ต -ี _M
society	ซ โ- _M . ซ ไ- _M . อ เ- _M . ต -ี _M
sockeye	ซ -็อ- ก _H . อ -าย _M
soddy	ซ -อ- ด _F . ด -ี _M
sodium	ซ โ- _M . ด เ-ีย- ม _M
sofia	ซ โ- _M . ฟ เ-ีย _M
sohm	ซ โ-- ม _M
solem	ซ โ- _M . ล -ิ- ม _M
solidity	ซ โ- _M . ล -ิ _H . ด -ิ _L . ต -ี _M
soling	ซ โ- _M . ล -ิ- ง _M
solo	ซ โ- _M . ล โ- _M
solon	ซ โ- _M . ล เ-ิ- น _M
solonchak	ซ โ- _M . ล -อ- น _M . ช -ั- ก _H
somme	ซ -อ- ม _M
sone	ซ โ-- น _M
song	ซ -อ- ง _M
sonia	ซ -อ _M . น เ-ีย _M
sonia	ซ โ- _M . น เ-ีย _M
sonic	ซ โ- _M . น -ิ- ก _H
sonneck	ซ -ั- น _M . น เ-็- ก _H
sonny	ซ -อ- น _M . น -ี _M
sontag	ซ -อ- น _M . ท แ-- ก _F
susan	ซ -ู _M . ซ -า- น _M
sophie	ซ โ- _M . ฟ -ี _M
sophie	ซ โ- _M . ฟ -ี _M . อ เ-อ _M
sophy	ซ โ- _M . ฟ -ี _M
sorenson	ซ -อ _M . ร เ-ิ- น _M . ส -ั- น _R
soria	ซ -อ _M . ร เ-ีย _M
sotho	ซ โ- _M . ท โ- _M
soucek	ซ โ- _M . ซ -ิ- ก _H
souffle	ซ -ู _M . ฟ เ- _M . ล เ- _M
soy	ซ -อย _M
ringo	ร -ิ- ง _M . ก โ- _M
frederic	ฟ เ- _M . ร เ- _M . ด เ- _M . ร -ิ- ก _H
rod	ร -็อ- ด _H
bram	บ -็ _L . ร -า- ม _M
subadiabatic	ซ -ั- บ _H . อ แ- _M . ด เ-ีย _M . บ แ- _M . ต -ิ- ก _L
subic	ซ -ู _M . บ -ิ- ก _L
subroutine	ซ -ั- บ _H . ร -ู _M . ท -ี- น _M
succory	ซ -ั- ก _H . ค -อ _M . ร -ี _M
suckling	ซ -ั- ก _H . ล -ิ- ง _M
suction	ซ -ั- ก _H . ช -ั- น _M
sue	ซ -ู _M
sugg	ซ -ั- ก _H
sulak	ซ -ู _M . ล เ-ิ- ก _F
sulu	ซ -ู _M . ล -ู _M
sum	ซ -ั- ม _M
suman	ซ -ู _M . ม เ-ิ- น _M
summ	ซ -ั- ม _M
sundae	ซ -ั- น _M . ด เ- _M
sung	ซ -ุ- ง _M
sununu	ซ เ-อ _M . น -ู _M . น -ู _M
surinam	ส -ุ _L . ร -ิ _H . น -ั- ม _M
susie	ซ -ู _M . ซ -ี _M
suvero	ซ -ู _M . ว เ- _M . ร โ- _M
di	ด -ี _M
suzane	ซ -ู _M . ซ เ-- น _M
suzanne	ซ -ู _M . ซ -า- น _M
suzy	ซ -ู _M . ซ -ี _M
sydenham	ซ -ี _M . ด เ-ิ- น _M . ฮ เ-ิ- ม _M
symeon	ซ -ี _M . ม -ี _M . อ เอิ- น _M . อ เ-ิ- น _M
symon	ซ -ี _M . ม เ-ิ- น _M
symphony	ซ -ิ- ม _M . ฟ โ- _M . น -ี _M
symposium	ซ -ิ- ม _M . พ โ- _M . ซ เ-ีย- ม _M
syphon	ซ ไ- _M . ฟ -อ- น _M
syria	ซ -ี _M . ร เ-ีย _M
szoke	ช โ-- ก _F
szymczak	ช -ิ- ม _M . ช แ-็- ก _H
taaffe	ท -า- ฟ _F
tabb	ท แ-็- บ _H
taen	ท เ-ิ- น _M
taff	ท แ-- ฟ _F
tain	ท เ-- น _M
taine	ท เ-- น _M
taipei	ท ไ- _M . ป เ- _M
take	ท เ-- ก _F
tallin	ล แ- _M . ต แ- _M . ล -ิ- น _M
tambourine	ท แ-- ม _M . บ -ู _M . ร -ิ- น _M
tambourine	ท แ-- ม _M . บ -ู _M . ร -ี- น _M
tamm	ท แ-- ม _M
tampering	ท แ-- ม _M . ป เ-อ _M . ร -ิ- ง _M
tan	ท แ-- น _M
tandem	ท แ-- น _M . ด เ-ิ- ม _M
tango	ท แ-- ง _M . ก โ- _M
tanguy	ท -ั- ง _M . ก ไ- _M
tann	ท แ-- น _M
tatem	ท แ- _M . ท -ิ- ม _M
taube	ท -็อ- บ _H
i	อ ไ- _M
tea	ท -ี _M
team	ท -ี- ม _M
tee	ท -ี _M
teflon	ท เ-- ฟ _F . ล -อ- น _M
telecine	ท เ- _M . ล เ- _M . ซ -ี- น _M
telegraph	ท เ- _M . ล เ-- ก _F . ร -า- ฟ _F
telia	ท เ- _M . ล เ-ีย _M
temin	ท เ- _M . ม -ิ- น _M
templin	ท เ-็- ม _M . ล -ิ- น _M . พ -ิ- น _M
ten	ท เ-็- น _M
tenison	ท เ- _M . น -ี _M . ส -ั- น _R
tenney	ท เ-- น _M . น -ี _M
tenny	ท เ-- น _M . น -ี _M
tennyson	ท เ-- น _M . น -ิ _H . ส -ั- น _R
teno	ท เ- _M . น โ- _M
teodoro	ท -ี _M . อ โ- _M . ด -อ _M . ร โ- _M
terai	ต เ- _M . ร -าย _M
teutonic	ท -ู _M . ท -อ _M . น -ิ- ก _H
tew	ช -ู _M
thain	ท เ-- น _M
thane	ท เ-- น _M
thau	ท -าว _M
thea	ท เ-ีย _M
thek	ท เ-- ก _F
theo	ท -ี _M . อ โ- _M
theodosia	ท -ี _M . อ เ-อ _M . ด โ- _M . ซ เ-ีย _M
theron	ท เ- _M . ร เ-ิ- น _M
theroux	ท เ-อ _M . ร -ู _M
thibodaux	ท -ี _M . บ เ-อ _M . ด โ- _M
thieme	ท -ิ- ม _M
thien	ท เ-ีย- น _M
thigpen	ท -ิ- ก _H . พ เ-ิ- น _M
thimphu	ท -ิ- ม _M . พ -ู _M
thimphu	ท -ิ- ม _M . ฟ -ู _M
thom	ท -อ- ม _M
thomasson	ท -อ _M . ม เ-อ _M . ส -ั- น _R
thomson	ท -อ- ม _M . ส -ั- น _R
thon	ท -อ- น _M
thone	ท โ-- น _M
thoreau	ท -อ _M . ร โ- _M
thorium	ท -อ _M . ร เ-ีย- ม _M
throck	ท เ- _M . ร -ิ- ก _H
thun	ท -ั- น _M
thurow	ท -ู _M . ร โ- _M
tie	ท ไ- _M
tief	ท -ิ- ฟ _H
tiepolo	ต -ี _M . อ เ- _M . ป โ- _M . ล โ- _M
tiffany	ท -ิ- ฟ _H . ฟ เ-อ _M . น -ี _M
tiffin	ท -ิ- ฟ _H . ฟ -ิ- น _M
tig	ท -ิ- ก _H
timmy	ท -ิ- ม _M . ม -ี _M
timothy	ท -ิ _H . ม โ- _M . ท -ี _M
tin	ท -ิ- น _M
tiomkin	ต -ี _M . อ -อ- ม _M . ค -ิ- น _M
tipi	ท -ี _M . ป -ี _M
tiro	ต -ิ _L . ร โ- _M
titanium	ท ไ- _M . ท เ- _M . น เ-ีย- ม _M
titian	ท -ิ _H . ช เ-ีย- น _M
tito	ต -ิ _L . ต โ- _M
tjale	ช เ- _M . ล เ- _M
tko	ท -ี _M . ค เ- _M . อ โ- _M
tobago	ต โ- _M . บ เ- _M . ก โ- _M
toby	ท โ- _M . บ -ี _M
tod	ท -ี _M . อ โ- _M . ด -ี _M
toefl	ท โ- _M . ฟ เ- _M . ล เ- _M
tofu	ต โ- _M . ฟ -ุ _H
togo	ต โ- _M . ก โ- _M
token	ท โ- _M . ค เ-็- น _M
tokyo	ต โ- _M . ก เ-ียว _M
tomato	ท โ- _M . ม เ- _M . ต โ- _M
tomboy	ท -อ- ม _M . บ -อย _M
tomograph	ท โ- _M . ม โ-- ก _F . ร -า- ฟ _F
tone	ท โ-- น _M
tonic	ท -อ _M . น -ิ- ก _H
tonic	ท โ- _M . น -ิ- ก _H
tonne	ต -ั- น _M
topological	ท -อ _M . พ -อ _M . ล โ- _M . ย -ี _M
topology	ท -อ _M . พ -อ _M . ล โ- _M . ย -ี _M
tory	ท -อ _M . ร -ี _M
totem	ท โ- _M . ท เ-- ม _M
toxin	ท -็อ- ก _H . ซ -ิ- น _M
triceps	ร ไ- _M . ต ไ- _M . ซ เ-- บ _F
triolet	ร -ี _M . ต -ี _M . อ โ- _M . ล เ- _M
trombone	ท -อ- ม _M . ร -อ- ม _M . บ โ-- น _M
troy	ท -อย _M . ร -อย _M
tune	จ -ู- น _M
tunic	ท -ู _M . น -ิ- ก _H
tunisia	ต -ู _M . น -ิ _H . ซ เ-ีย _M
turin	ต -ู _M . ร -ิ- น _M
tuxedo	ท -ั- ก _H . ซ -ิ _H . ด โ- _M
tv	ท -ี _M . ว -ี _M
tycoon	ท ไ- _M . ค -ู- น _M
tyson	ท ไ- _M . ส -ั- น _R
uci	ย -ู _M . ซ -ี _M . อ ไ- _M
ufo	ย -ู _M . อ เ-- ฟ _L . อ โ- _M
ufo	ย -ู _M . ฟ โ- _M
ulam	ย -ู _M . ล แ-- ม _M
un	ย -ู _M . อ เอ็- น _M . อ เ-็- น _M
unicef	ย -ู _M . น -ิ _H . ซ เ-- ฟ _F
unique	ย -ู _M . น -ี- ก _F
unitarian	ย -ู _M . น -ิ _H . ท แ- _M . ร เ-ีย- น _M
unitary	ย -ู _M . น -ิ _H . ท เ- _M . ร -ี _M
unity	ย -ู _M . น -ิ _H . ต -ี _M
unsinn	อ เอิ- น _M . อ เ-ิ- น _M . ซ -ิ- น _M
unwin	อ -อ- น _M . ว -ิ- น _M
upc	ย -ู _M . พ -ี _M . ซ -ี _M
uranium	ย -ู _M . ร เ- _M . น เ-ีย- ม _M
urea	ย -ู _M . ร เ-ีย _M
urethane	ย -ู _M . ร -ิ _H . ท เ-- น _M
urethane	ย -ู _M . ร เ- _M . ท เ-- น _M
utility	ย -ู _M . ท -ิ _H . ล -ิ _H . ต -ี _M
vague	ว เ-- ก _F
valency	ว เ- _M . ล เ-- น _M . ซ -ี _M
valerie	ว แ- _M . ล เ- _M . ร -ี _M
validity	ว แ- _M . ล -ิ _H . ด -ิ _L . ต -ี _M
valium	ว แ- _M . ล เ-ีย- ม _M
vanbeek	ว แ-- น _M . บ -ิ- ก _L
vanbrugh	ว แ-- น _M . บ เ- _M . ร -อ _M
vancleave	ว แ-- น _M . ค เ-ิ- ฟ _F . ล เ-ิ- ฟ _F
vandyck	ว แ-- น _M . ด -ิ- ก _L
vane	ว เ-- น _M
vanlandingham	ว แ-- น _M . ล แ-- ด _F . ด -ิ- ง _M . ฮ แ-- ม _M
vanpraagh	ว แ-- น _M . ร -า- ก _F . พ -า- ก _F
vanwyck	ว แ-- น _M . ว -ิ- ก _H
varian	ว แ- _M . ร -ี _M . อ เอิ- น _M . อ เ-ิ- น _M
vaughan	ว -อ- น _M
vcd	ว -ี _M . ซ -ี _M . ด -ี _M
vd	ว -ี _M . ด -ี _M
vdu	ว -ี _M . ด -ี _M . ย -ู _M
veen	ว -ิ- น _M
vego	ว เ- _M . ก โ- _M
venetia	ว -ิ _H . น -ี _M . ช เ-ีย _M
venetia	ว -ี _M . น -ี _M . ซ เ-ีย _M
venturi	ว เ-- น _M . จ -ู _M . ร -ิ _H
venturi	ว เ-- น _M . จ -ู _M . ร -ี _M
vereeniging	ว เ-อ _M . ร -ี _M . น -ิ _H . ก -ิ- ง _M
veron	ว เ- _M . ร -อ- ง _M
juan	ค -ว- น _M
veto	ว -ี _M . ต โ- _M
vfa	ว -ี _M . อ เ-- ฟ _L . อ เ- _M
vga	ว -ี _M . จ -ี _M . อ เ- _M
via	ว เ-ีย _M
vic	ว -ิ- ก _H
vichy	ว -ิ _H . ช -ี _M
vicini	ว -ิ _H . ซ -ิ _H . น -ี _M
vick	ว -ิ- ก _H
vicki	ว -ิ- ก _H . ก -ี _M
vickie	ว -ิ- ก _H . ก -ี _M
vicky	ว -ิ- ก _H . ก -ี _M
victoria	ว -ิ- ก _H . ต -อ _M . ร เ-ีย _M
victory	ว -ิ- ก _H . ท -อ _M . ร -ี _M
video	ว -ิ _H . ด -ี _M . อ โ- _M
vietnam	ว เ-ีย- ด _F . น -า- ม _M
view	ว -ิว _M
viking	ว ไ- _M . ก -ิ- ง _M
vinayak	ว -ี _M . น ไ- _M . อ แอ็- ก _L . อ แ-็- ก _L
vinsauf	ว -ิ- น _M . ซ -อ- ฟ _F
vinson	ว -ิ- น _M . ส -ั- น _R
violin	ว ไ- _M . อ โ- _M . ล -ิ- น _M
vip	ว -ี _M . อ ไ- _M . พ -ี _M
vision	ว -ิ _H . ช -ั- น _M
vivanco	ว -ี _M . ว แ-- ง _M . ค โ- _M
vivian	ว -ิ _H . ว เ-ีย- น _M
vivien	ว -ิ _H . ว เ-ีย- น _M
vj	ว -ี _M . จ เ- _M
vo	ว -ี _M . อ โ- _M
vsam	ว -ี _M . ซ แ-- ม _M
wade	ว เ-- ด _F
wadham	ว -ั- ด _H . ด เ-ิ- ม _M
wagon	ว แ- _M . ก -อ- น _M
wain	ว เ-- น _M
wake	ว เ-- ก _F
waleran	ว -อ _M . ล เ-อ _M . ร แ-- น _M
wallach	ว -อ _M . ล เ-ิ- ก _F
wambach	ว -อ- ม _M . บ -ั- ก _L
wan	ว แ-- น _M
wane	ว เ-- น _M
wankel	ว แ-- ง _M . ก เ- _M . ล เ- _M
warwick	ว -อ _M . ร -ิ- ก _H
washington	ว -อ _M . ช -ิ- ง _M . ต -ั- น _M
muddy	ม -ั- ด _H . ด -ี _M
waugh	ว -อ _M
evelyn	อ เ- _M . ว เ- _M . ล -ิ- น _M
wave	ว เ-- ฟ _F
wean	ว -ิ- น _M
wearing	ว แ- _M . ร -ิ- ง _M
web	ว เ-็- บ _H
webbe	ว เ-็- บ _H
wedd	ว เ-- ด _F
wedlake	ว เ-- ด _F . ล เ-- ก _F
weed	ว -ี- ด _F
week	ว -ี- ก _F
weick	ว -ิ- ก _H
wen	ว เ-- น _M
wene	ว -ิ- น _M
weng	ว เ-- ง _M
wenham	ว เ-็- น _M . ฮ แ-- ม _M
wenrich	ว เ-- น _M . ร -ิ- ก _H
wham	ว แ-- ม _M
whan	ว แ-- น _M
whayne	ว เ-- น _M
wheelock	ว -ี _M . ล -็อ- ก _H
whelan	ว เ- _M . ล เ-ิ- น _M
whig	ว -ิ- ก _H
wick	ว -ิ- ก _H
wicke	ว -ิ- ก _H
wieck	ว -ิ- ก _H
wieman	ว -ี _M . ม เ-ิ- น _M
wien	ว -ี- น _M
wig	ว -ิ- ก _H
wigg	ว -ิ- ก _H
wigwam	ว -ิ- ก _H . ว แ-- ม _M
winfred	ว -ิ- น _M . ฟ -ิ- ด _H . ร -ิ- ด _H
wing	ว -ิ- ง _M
winick	ว -ิ _H . น -ิ- ก _H
winlaw	ว -ิ- น _M . ล -อ _M
winn	ว -ิ- น _M
winne	ว -ิ- น _M
winnie	ว -ิ- น _M . น -ี _M
winnifred	ว -ิ- น _M . น -ี- ฟ _F . ร -ิ- ด _H
winnipeg	ว -ิ- น _M . น -ิ _H . ป เ-- ก _L
winson	ว -ิ- น _M . ส -ั- น _R
womack	ว โ- _M . ม แ-็- ก _H
won	ว -อ- น _M
wood	ว -ู- ด _F
woodfin	ว -ู- ด _F . ฟ -ิ- น _M
woodham	ว -ู- ด _F . ฮ เ-ิ- ม _M
woodruff	ว -ู- ด _F . ด เ- _M . ร -ิ- ฟ _H
woodson	ว -ู- ด _F . ส -ั- น _R
woon	ว -ู- น _M
wooton	ว -ู _M . ท -ั- น _M
worthen	ว เ- _M . ท เ-ิ- น _M
wove	ว โ-- ฟ _F
wragg	ร แ-็- ก _H
wren	ร เ-- น _M
wrenn	ร เ-- น _M
writing	ร ไ- _M . ต -ิ- ง _M
wrong	ร -อ- ง _M
wych	ว ไ- _M
wyckoff	ว -ิ _H . ค -อ- ฟ _F
wycliffe	ว ไ- _M . ค -ิ- ฟ _H . ล -ิ- ฟ _H
wycoff	ว -ี _M . ค -อ- ฟ _F
wye	ว ไ- _M
wyman	ว เ- _M . ม เ-ิ- น _M
wynkyn	ว -ิ- ง _M . ก -ิ- น _M
wyoming	ว ไ- _M . อ โ- _M . ม -ิ- ง _M
wysiwyg	ว -ิ _H . ซ -ิ _H . ว -ิ- ก _H
xenobiotic	ซ -ี _M . น โ- _M . บ ไ- _M . อ โ- _M . ต -ิ- ก _L
xi	ซ ไ- _M
xylem	ซ ไ- _M . ล เ-็- ม _M
xylene	ซ ไ- _M . ล -ี- น _M
y2k	ว -าย _M . ท -ู _M . ค เ- _M
minoru	ม -ิ _H . น โ-ะ _H . ร -ุ _H
yannick	ย แ-- น _M . น -ิ- ก _H
yared	ย เ- _M . ร -ึ- ด _H
yearick	ย -ี _M . ร -ิ- ก _H
yee	ย -ี _M
yemen	ย เ- _M . ม เ-- น _M
yerevan	ย เ- _M . ร เ- _M . ว -า- น _M
yevgeny	ย เ-- ฟ _F . ก เ- _M . น -ี _M
yew	ย -ู _M
ymca	ว -าย _M . อ เอ็- ม _M . อ เ-็- ม _M . ซ -ี _M . อ เ- _M
yocto	ย -อ- ก _F . ต โ- _M
yoe	ย โ- _M
yohe	ย โ- _M . ฮ เ- _M
yohn	ย -อ- น _M
yoko	ย โ- _M . ค โ- _M
yorick	ย -อ _M . ร -ิ- ก _H
young	ย -ั- ง _M
younglove	ย -ั- ง _M . ล -ั- ฟ _H
yoyo	ย โ- _M . ย โ- _M
yung	ย -ุ- ง _M
zach	ซ แ-็- ก _H
zane	ซ เ-- น _M
zante	ซ -า- น _M . ต เ- _M
zanuck	ซ แ- _M . น เ-ิ- ก _F
zech	ซ เ-็- ก _H
zeck	ซ เ-็- ก _H
zeek	ซ -ิ- ก _H
zeeman	ซ -ี _M . ม แ-- น _M
zelia	ซ เ- _M . ล เ-ีย _M
zen	ซ เ-- น _M
zeno	ซ -ี _M . น โ- _M
zerbe	ซ เ-ีย- บ _F
zeug	ซ -ู- ก _F
zevin	ซ เ- _M . ว -ิ- น _M
ziff	ซ -ี- ฟ _F
zigzag	ซ -ิ- ก _H . ซ แ-็- ก _H
zinn	ซ -ิ- น _M
zion	ซ ไ- _M . อ -อ- น _M
zion	ซ ไ- _M . อ เอิ- น _M . อ เ-ิ- น _M
ziv	ซ -ี- ฟ _F
zock	ซ -็อ- ก _H
zog	ซ -็อ- ก _H
zok	ซ -็อ- ก _H
gianfranco	จ -า- น _M . ฟ -ั- น _M . ร -ั- น _M . ก โ- _M
zondag	ซ -อ- น _M . ด แ-็- ก _L
zone	ซ โ-- น _M
zooglea	ซ -ู- ก _F . ล -ี _M
zoom	ซ -ู- ม _M
zucchini	ซ -ุ _H . ค -ิ _H . น -ี _M
zucchini	ซ -ู _M . ก -ี _M . น -ี _M
zuck	ซ -ั- ก _H
zuk	ซ -ั- ก _H
zulu	ซ -ู _M . ล -ู _M
homeroom	ฮ โ-- ม _M . ร -ู- ม _M
