kharkov	k a . k o . h eu
khalil	k a l . l i l
raabe	l a . b e
simmonds	s i . m eo n . j eu
kemp	k e m . p eu
goldie	g o l . d i
shevchenko	s ye . p eu . ch e n . k o
nipkow	n i b . k o
fiona	p i . o . n a
fallopius	p a l . l o . p i . u . s eu
kapitsa	k a . p i . ch a
seckel	s e . k eo l
rusk	l eo . s eu . k eu
indiana	i n . d e . e . n a
natorp	n a . t o . l eu . p eu
moustapha	m u . s eu . t a . p a
cavalcanti	k a . b a l . k a n . t i
foggia	p o . j i . a
lyman	l a . i . m eo n
cole	k o l
elster	e l . s eu . t eo
loewy	l o . wi
lubbers	l wi . b e . l eu . s eu
jaffna	j a . p eu . n a
bagehot	b ae . j eo s
rosen	l o . s eu n
grenfell	g eu . l e n . p e l
pauker	p a . u . k e . l eu
gracchus	g eu . l a . k u . s eu
harper	h a . p eo
renan	l eu . n a ng
dunstable	d eo n . s eu . t eo . b eu l
locke	l o g
stern	s yu . t e . l eu n
griffin	g eu . l i . p i n
hindustan	h i n . d u . s eu . t a n
venezia	b e . n e . ch i . a
laura	l a . u . l a
shute	s yu . t eu
waage	b o . g e
bales	b e . i l . j eu
dorn	d o n
evan	e . b eo n
karlsruhe	k a . l eu l . s eu . l u . e
collett	k o l . l e . t eu
brenner	b eu . l e . n eo
sheraton	s ye . l eo . t eo n
hepplewhite	h e . p eu l . h wa . i . t eu
frank	p eu . l a ng . k eu
charlie	ch a l . l i
davids	d a . b i . ch eu
horn	h o . l eu n
natalie	n a . t a l . l i
carnegie	k a . n e . g i
hodgson	h o . j i . s eu n
cesare	ch e . s a . l e
boring	b o . l i ng
abdullah	a b . d u l . l a
macbeth	m ae g . b e . s eu
respighi	l e . s eu . p i . g i
eriksen	e . l i g . s e n
livingston	l i . b i ng . s eu . t eo n
mordechai	m o . l eu . d e . h a . i
helge	h e l . g e
bachelard	b a . s yu l . l a . l eu
dickson	d i g . s eu n
olaf	o l . l a . p eu
alberts	ae l . b eo . ch eu
saarinen	s a . l i . n e n
babeuf	b a . b oe . p eu
oregon	o . l i . g eo n
buber	b u . b eo
schleicher	s yu l . l a . i . h eo
tamir	t a . m i . l eu
heymans	h a . i . m a n . s eu
namibia	n a . m i . b i . a
aubrey	o . b eu . l i
herschel	h eo . s yeo l
lenau	l e . n a . u
kingston	k i ng . s eu . t eo n
clayton	k eu l . l e . i . t eo n
guinea	g i . n i
piazzetta	p i . a . ch e . t a
morrow	m o . l o
snowdon	s eu . n o . d eu n
shropshire	s yu . l o b . s yeo
edouard	e . d u . a . l eu
dill	d i l
sharp	s ya . p eu
baku	b a . k u
calder	k o l . d eo
merritt	m e . l i . t eu
kepler	k e . p eu l . l eo
torricelli	t o . l i . ch e l . l i
dundee	d eo n . d i
giuliani	j u l . l i . a . n i
annemarie	a . n e . m a . l i
scarlett	s eu . k a l . l e s
dempsey	d e m . s i
hertz	h e . l eu . jj eu
judy	j u . d i
tate	t e . i . t eu
jessica	j e . s i . k a
henley	h e n . l i
bonner	b o . n eo
picasso	p i . k a . s o
groth	g eu . l o . t eu
sauvy	s o . b i
meri	m e . l i
varenius	b a . l e . n i . u . s eu
kendrew	k e n . d eu . l u
castiglione	k a . s eu . t i l . l i . o . n e
parini	p a . l i . n i
honghai	h u ng . h a . i
burton	b eo . t eo n
israel	i . s eu . l a . e l
paganini	p a . g a . n i . n i
hankel	h a ng . k e l
gainsborough	g e . i n . j eu . b eo . l eo
karel	k a . l e l
daphne	d a . p eu . n e
powys	p o . u . i . s eu
medina	m e . d i . n a
lipton	l i b . t eo n
attwood	ae . t u . d eu
mahaffy	m a . h a . p i
jacquard	j a . k a . d eu
haller	h a l . l eo
pilcher	p i . ch eo
anchorage	ae ng . k eo . l i . j i
carpenter	k a . p e n . t eo
dora	d o . l a
carmona	k a . m o . n a
trier	t eu . l i . eo
hearst	h eo . s eu . t eu
stockholm	s eu . t o g . h o l . l eu m
stipe	s eu . t i . p e
joshua	yeo . h o . s u . a
quinn	k wi n
ungaro	u ng . g a . l o
giuliano	j u l . l i . a . n o
hemingway	h e . m i ng . we . i
casablanca	k a . s a . b eu l . l a ng . k a
lucien	l wi . s i . ae ng
percy	p eo . s i
zeman	j e . m a n
galvani	g a l . b a . n i
beaverbrook	b i . b eo . b eu . l u g
sebastian	s eo . b ae . s eu . ch eo n
blumenbach	b eu l . l u . m e n . b a . h eu
graaf	g eu . l a . p eu
bunin	b u . n i n
ovechkin	o . b e . ch i . k i n
kirby	k eo . b i
brynner	b eu . l i . n eo
foote	p u . t eu
mesquita	m e . s eu . k i . t a
magee	m ae . g i
pennsylvania	p e n . s i l . b e . i . n i . a
maier	m a . i . e . l eu
mraz	m eu . l a . j eu
lanzhan	l a n . j a n
burgundy	b u . l eu . g o . n yu
ravi	l a . b i
frei	p eu . l e . i
welhaven	b e l . h a . b e n
hofstadter	h o . p eu . s eu . t ae . t eo
schuster	s eu . h u . s eu . t e . l eu
bridgetown	b eu . l i . j i . t a . u n
khadem	k a . d e m
ivy	a . i . b i
garrett	g a . l e . t eu
montevideo	m o n . t e . b i . d e . o
homer	h o . m eo
naumann	n a . u . m a n
tunis	t wi . n i . s eu
salten	j a l . t e n
simeon	s i . m eu . o n
rudi	l u . d i
koen	k o . e n
nicolson	n i . k eo l . s eu n
martinson	m a . l eu . t i n . s o n
morley	m o l . l i
mercer	m eo . s eo
kostov	k o . s eu . t o . p eu
tristram	t eu . l i . s eu . t eu . l eo m
morgenstern	m o . l eu . g e n . s yu . t e . l eu n
pereira	p e . l e . i . l a
bartolommeo	b a . l eu . t o l . l o m . m e . o
teagarden	t i . g a . d eu n
rey	l e . i
yahya	ya . h i . a
pompidou	p o ng . p i . d u
dolphin	d o l . p i n
bass	b ae . s eu
nasser	n a . s e . l eu
piaf	p i . a . p eu
paulsen	p o l . s eu n
luce	l u . s eu
moreau	m o . l o
pons	p o ng . s eu
abbe	a . b e
shoemaker	s yu . m e . i . k eo
aretino	a . l e . t i . n o
thoma	t o . m a
tupolev	t u . p o l . l e . p eu
jevons	j e . b eo n . s eu
nujoma	n u . j o . m a
gerald	j e . l eo l . d eu
willemstad	b i l . l e m . s eu . t a . t eu
spaak	s eu . p a . k eu
weiner	wa . i . n eo
bevin	b e . b i n
prim	p eu . l i m
visconti	b i . s eu . k o n . t i
rowell	l o . we l
suva	s u . b a
bogota	b o . g o . t a
sands	s ae n . j eu
felix	p e l . l i g . s eu
comenius	k o . m e . n i . u . s eu
merkel	m e . l eu . k e l
dever	d e . b eo
arminius	a . l eu . m i . n i . u . s eu
brigitte	b eu . l i . j i s
merce	m eo . s eu
seles	s e l . l e . s eu
gundolf	g u n . d o l . p eu
shelton	s ye l . t eo n
theodore	s i . eo . d o . eo
bettino	b e . t i . n o
grimmelshausen	g eu . l i . m e l . s eu . h a . u . j e n
kiribati	k i . l i . b a . s i
rothschild	l o . s eu . ch a . i l . d eu
vera	b e . l a
munch	m u ng . k eu
krasheninnikov	k eu . l a . s ye . n i n . n i . k o . p eu
kinnear	k eo . n i . eo
danieli	d a . n i . e l . l i
remington	l e . m i ng . t eo n
barroso	b a . l o . s u
mauriac	m o . l i . a g
falconet	p a l . k o . n e
helmholtz	h e l . l eu m . h o l . ch eu
chicago	s i . k a . g o
basseterre	b a . s eu . t e . l eu
born	b o . l eu n
stig	s eu . t i . g e
pearl	p eo l
bonnard	b o . n a . l eu
bow	b o . u
yasin	ya . s i n
liza	l i . j a
villani	b i l . l a . n i
jefferson	j e . p eo . s eu n
bernhardt	b e . l eu . n a . l eu
hal	h ae l
sydney	s i . d eu . n i
hensel	h e n . j e l
oberon	o . b e . l o n
caravaggio	k a . l a . b a . j o
steers	s eu . t i . eo . s eu
cram	k eu . l ae m
schmiedeberg	s yu . m i . d e . b e . l eu . k eu
lanier	l eo . n i . eo
haas	h a . s eu
amyot	a . m i . yo
appia	a . p i . a
annabel	a . n a . b e l
carl	k a . l eu l
ericsson	e . l i g . s eu n
turner	t eo . n eo
zetkin	ch e . t eu . k i n
mellon	m e l . l eo n
poul	p o . u l
charles	s ya . l eu l
block	b eu l . l o g
junqueiro	j u n . k e . i . l u
watt	wa . t eu
florian	p eu l . l o . l i . a n
escoffier	e . s eu . k o . p i . e
harley	h a l . l i
connor	k o . n eo
simmons	s i . m o n . j eu
khartoum	h a . l eu . t u m
patel	p a . t e l
bateson	b e . i . t eu . s eu n
diderot	d i . d eu . l o
lindsay	l i n . j i
sexton	s e g . s eu . t eo n
moroni	m o . l o . n i
adama	a . d a . m a
beardsley	b i . eo . j eu l . l i
wartburg	b a . l eu . t eu . b u . l eu . k eu
smiles	s eu . m a . i l . s eu
bolkiah	b o l . k i . a
erica	e . l i . k a
wlodzimierz	b eu l . l o . ch i . m i . e . l eu . ch eu
caucasus	k o . k a . s eo . s eu
maki	m a . k i
din	d i n
marsden	m a . s eu . d eu n
kulik	k u l . l i . k eu
ernestine	eo . n i . s eu . t i n
padua	p a . d u . a
peli	p e l . l i
scofield	s eu . k o . p i l . d eu
warner	wo . n eo
sennett	s e . n e s
midway	m i . d eu . we . i
luc	l wi . k eu
kandel	k ae n . d eu l
blunt	b eu l . l eo n . t eu
kellogg	k e l . l o . g eu
crispin	k eu . l i . s eu . p i . n u . s eu
mahoney	m a . h o . n i
neff	n e . p eu
benigno	b e . n i . g eu . n o
marta	m a . l eu . t a
burma	b eo . m a
valentin	b a l . l e n . t i n
thompson	t o m . s eu n
wick	wi g
nazareth	n a . s a . l e s
wilson	wi l . s eu n
allen	ae l . l eo n
fessenden	p e . s e n . d e n
renner	l e . n eo
boer	b o . eo
hales	h e . i l . j eu
highland	h a . i . l ae n . d eu
marschner	m a . l eu . s yu . n eo
arvid	a . l eu . b i . d eu
felice	p e l . l i . s eu
poulet	p u l . l e
gambia	g a m . b i . a
gabor	g a . b o . l eu
racine	l a . s i n
kretschmer	k eu . l e . ch i . m eo
essen	e . s e n
musset	m wi . s e
blanco	b eu l . l a ng . k o
farina	p a . l i . n a
ramos	l a . m o . s eu
goldberg	g o l . d eu . b eo . g eu
cage	k e . i . j i
machel	m a . s ye l
gyula	j u l . l eo
banville	b a ng . b i l
dufour	d u . p o . b o ng
simpson	s i n . p eu . s eu n
cesarotti	ch e . s a . l o . t i
sisley	s i . s eu l . l e
garland	g a l . l eo n . d eu
vivien	b i . b i . eo n
sperry	s eu . p e . l i
frankenstein	p eu . l a ng . k e n . s yu . t a . i n
phillippe	p i l . l i . p eu
staffordshire	s eu . t ae . p eo . d eu . s yeo
campanella	k a m . p a . n e l . l a
willi	b i l . l i
sander	s ae n . d eo
fiske	p i . s eu . k eu
eusebio	e . u . s e . b i . u
strasburger	s yu . t eu . l a . s eu . b u . l eu . g eo
steinem	s eu . t a . i . n eo m
spitsbergen	s eu . k i . ch eu . b e . l eu . g e n
rosetti	l o . s e . t i
manuela	m a . n u . e l . l a
hamlet	h ae m . l i s
hanslick	h a n . s eu l . l i . k eu
daniele	d a . n i . e l
guatemala	g wa . t e . m a l . l a
kossel	k o . s e l
harcourt	h a . k o . t eu
bartley	b a . t eu . l i
bruch	b eu . l u . h eu
salvini	s a l . b i . n i
mannheim	m a n . h a . i m
tiffany	t i . p a . n i
londonderry	l eo n . d eo n . d e . l i
fontana	p o n . t a . n a
dali	d a l . l i
rudenko	l u . d e n . k o
cheney	ch e . n i
tricia	t eu . l i . s i . a
sigrid	s i . g eu . l i . d eu
taunton	t o n . t eo n
picard	p i . k a . l eu
ulaanbaatar	u l . l a n . b a . t o . l eu
segovia	s e . g o . b i . a
willoughby	wi l . l u . b i
amara	a . m a . l a
lydia	l i . d i . a
roald	l o . a l
waltari	b a l . t a . l i
chantal	s ya n . t a l
egon	e . g o n
sal	s a l
ammon	a . m o n
wolker	b o l . k e . l eu
angel	e n . j e l
rob	l o b
granville	g eu . l ae n . b i l
waterloo	wo . t eo l . l u
crommelynck	k eu . l o m . l ae ng . k eu
wolsey	u l . j i
kentucky	k e n . t eo . k i
branner	b eu . l a . n e . l eu
fromentin	p eu . l o . m a ng . t ae ng
barre	b a . l e
mary	m e . l i
sears	ss i . eo . s eu
singh	s i ng
bellman	b e l . m a n
daudet	d o . d e
freud	p eu . l o . i . t eu
shaw	s yo
rufus	l u . p eo . s eu
pasolini	p a . s o l . l i . n i
chris	k eu . l i . s eu
florin	p eu l . l o . l i n
vladislav	b eu l . l a . d i . s eu l . l a . p eu
ciampi	ch a m . p i
loos	l u . s eu
lipatti	l i . p a . t i
ralf	l a l . p eu
wiley	wa . i l . l i
skryabin	s eu . k eu . l ya . b i n
herzberg	h e . l eu . ch eu . b e . l eu . k eu
bowles	b o l . s eu
novgorod	n o . b eu . g o . l o . t eu
pfitzner	p i . ch eu . n eo
albano	a l . b a . n o
cicero	k i . k e . l o
leonid	l e . o . n i . t eu
stravinsky	s eu . t eu . l a . b i n . s eu . k i
alfons	a l . p o n . s eu
heym	h a . i m
reggie	l e . j i
dubrovnik	d u . b eu . l o . b eu . n i . k eu
cech	ch e . k eu
marc	m a . l eu . k eu
dowdeswell	d o . d e . s eu . b e l
adrienne	e . i . d eu . l i . e n
mandeville	m ae n . d eo . b i l
trinidad	t eu . l i . n i . d a . d eu
sharaf	s ye . l a . p eu
tatiana	t a . t i . a . n a
denzel	d e n . j eo l
marriott	m a . l i . o . t eu
bosco	b o . s eu . k o
boston	b o . s eu . t eo n
gertrude	g eo . t eu . l u . d eu
lorenz	l o . l e n . ch eu
jensen	ye n . s e n
norma	n o . m a
damascus	d a . m a . s eu . k u . s eu
portsmouth	p o . ch eu . m eo . s eu
gros	g eu . l o
campra	k a ng . p eu . l a
magda	m a . g eu . d a
eakins	e . i . k i n . s eu
dyke	d a . i . k eu
nernst	n e . l eu n . s eu . t eu
waltham	wo l . s eo m
longford	l o ng . p o . d eu
dirac	d i . l ae g
michie	m i . ch i . e
anders	a n . d e . l eu . s eu
maher	m a . h e . l eu
vigo	b i . g o
vane	b e . i n
kalinin	k a l . l i . n i n
carrington	k ae . l i ng . t eo n
eisenstein	a . i . j e n . s yu . t a . i n
norton	n o . t eo n
zaire	j a . i . l eu
gunter	g eo n . t eo
bullock	b u l . l eo g
luis	l u . i . s eu
ukraine	u . k eu . l a . i . n a
junkers	yu ng . k eo . s eu
nasir	n a . s i . l eu
damiani	d a . m i . a . n i
sawyer	s o . i . eo
bodo	b o . d o
lombardi	l o m . b a . l eu . d i
haworth	h a . s eu
beckmann	b e . k eu . m a n
cushing	k u . s i ng
badajoz	b a . d a . h o . s eu
springsteen	s eu . p eu . l i ng . s eu . t i n
schaudinn	s ya . u . d i n
pidgeon	p i . j eo n
quadri	k wa . d eu . l i
prince	p eu . l i n . s eu
pelegrin	p e l . l e . g eu . l i n
kimberly	k i m . b eo l . l i
kiev	k i . ye . p eu
pittsburgh	p i . ch i . b eo . g eu
teague	t i . g eu
grotius	g eu . l o . t i . u . s eu
perutz	p eo . l u . ch eu
ocampo	o . k a m . p o
moretti	m o . l e . t i
durango	d u . l a ng . g o
duclos	d wi . k eu l . l o
saul	s a . u l
ivo	i . b o
krakow	k eu . l a . k o . p eu
kimmel	k i . m e l
stephanie	s eu . t e . p a . n i
kamen	k e . i . m eo n
warburg	b a . l eu . b u . l eu . k eu
arnauld	a . l eu . n o
granet	g eu . l a . n e
olof	o l . l o . p eu
ferguson	p eo . g eo . s eu n
batoni	b a . t o . n i
darius	d a . l i . u . s eu
kingsley	k i ng . j eu l . l i
malcolm	m ae l . k eo m
pretoria	p eu . l i . t o . l i . a
uccello	u . ch e l . l o
antoinette	a ng . t u . a . n e . t eu
ionesco	i . o . n e . s eu . k o
cugnot	k wi . n yo
joshua	j o . s u . a
crompton	k eu . l eo m . p eu . t eo n
manrique	m a n . l i . k e
laine	l e . i n
reis	l a . i . s eu
mackay	m ae g . k e . i
brindley	b eu . l i n . d eu l . l i
susanna	s u . s a n . n a
goethe	g oe . t e
gower	g a . wo
uruguay	u . l u . g wa . i
short	s yo . t eu
bernie	b eo . n i
galton	g o l . t eo n
zeno	j e . n o n
billings	b i l . l i ng . s eu
wernicke	b e . l eu . n i . k e
massimo	m a . s i . m o
algeciras	a l . h e . s i . l a . s eu
bartlett	b a . t eu l . l i s
heckscher	h e . k eu . s ye . l eu
boussinesq	b u . s eu . n e . s eu . k eu
szilard	j i l . l a . d eu
feldman	p e l . d eu . m a n
deutsch	d o . i . ch i
moira	m o . i . l a
abadan	a . b a . d a n
hoxha	h o . j a
binding	b i n . d i ng
duane	d yu . a n
mcbride	m ae g . b eu . l a . i . d eu
chauncey	ch e n . s i
augusto	a . u . g u . s eu . t o
minot	m a . i . n eo s
goldmann	g o l . d eu . m a n
biber	b i . b eo
ghosh	g o . s i
ness	n e . s eu
crean	k eu . l i n
fogel	p o . g e l
ezra	e . s eu . l a
tosti	t o . s eu . t i
brunner	b eu . l u . n eo
geoffrey	j o . p eu . l i
irving	eo . b i ng
mount	m a . u n . t eu
barnes	b a . n e . j eu
giza	g i . j a
petty	p e . t i
rautio	l o . t i . o
hannelore	h a . n e l . l o . l e
spiegel	s eu . p i . g e l
churchill	ch eo . ch i l
frakes	p eu . l e . i . k eu
masaccio	m a . s a . ch o
wittig	b i . t i . h i
rostand	l o . s eu . t a ng
rauf	l a . u . p eu
bakan	b a . k a n
darmstadt	d a . l eu m . s yu . t a . t eu
solo	s o l . l o
ratzinger	l a . ch i ng . g eo
jenny	j e . n i
ron	l o n
kaunda	k a . u n . d a
cochin	k o . ch i n
marlon	m a l . l o n
husserl	h u . s eo l
weinheber	b a . i n . h e . b eo
weber	we . b eo
campos	k a m . p u . s eu
sabin	s e . i . b i n
brangwyn	b eu . l ae ng . g wi n
kari	k a . l i
fahmi	p a . m i
velayati	b e l . l a . ya . t i
libreville	l i . b eu . l eu . b i l
munro	m eo n . l o
kluge	k eu l . l u . g e
doumergue	d u . m e . l eu . g eu
gerolamo	j e . l o l . l a . m o
most	m o . s eu . t eu
mischa	m i . s ya
esther	e . s eu . d eo
qi	ch i
cleve	k eu l . l e . b e
ivory	a . i . b o . l i
anzengruber	a n . ch e n . g eu . l u . b eo
comte	k o ng . t eu
rehnquist	l e n . k wi . s eu . t eu
holliday	h o l . l i . d e . i
chianti	k a n . t i
maclaren	m ae . k eu l . l ae . l eo n
aldrin	o l . d eu . l i n
maastricht	m a . s eu . t eu . l i . h i . t eu
rio	l i . u
moody	m u . d i
dev	d e . b eu
pratt	p eu . l ae s
symons	s i . m eo n . s eu
gras	g eu . l a . s eu
cummings	k eo . m i ng . s eu
dave	d e . i . b eu
arlington	a l . l i ng . t eo n
limburg	l i m . b u . l eu . h eu
steele	s eu . t i l
damon	d e . i . m eo n
drago	d eu . l a . g o
leon	l e . o ng
nemanja	n e . m a . n ya
cardin	k a . d i n
mauritania	m o . l i . t a . n i . a
hartung	a . l eu . t u ng
surikov	s u . l i . k o . p eu
hazard	h ae . j eo . d eu
maximilian	m a g . s i . m i l . l i . a n
verhoeven	b eo . h o . b e n
zurich	ch wi . l i . h i
concepcion	k o n . s e b . s i . o n
gaillard	g a . i . ya . l eu
evelyn	e . b eo l . l i n
minnie	m i . n i
rosas	l o . s a . s eu
eiffel	e . p e l
popov	p o . p o . p eu
ivanov	i . b a . n o . p eu
dilthey	d i l . t a . i
landry	l a ng . d eu . l i
livius	l i . b i . u . s eu
liechtenstein	l i . h i . t e n . s yu . t a . i n
bethel	b e . d e l
northumberland	n o . s eo m . b eo l . l ae n . d eu
calcutta	k ae l . k eo . t a
lubin	l u . b i n
symonds	s i . m eo n . j eu
hawaii	h a . wa . i
pirandello	p i . l a n . d e l . l o
hanson	h ae n . s eu n
brahms	b eu . l a m . s eu
witz	b i . ch eu
mona	m o . n a
modigliani	m o . d i l . l i . a . n i
medhurst	m e . d eu . h eo . s eu . t eu
kennedy	k e . n e . d i
steinberger	s eu . t a . i n . b eo . g eo
galland	g a l . l a ng
segura	s e . g u . l a
sabastian	s e . b a . s eu . ch a n
solovyov	s o l . l o . b i . yo . p eu
kenneth	k e . n e . s eu
islamabad	i . s eu l . l a . m a . b a . d eu
hewish	h yu . i . s i
coker	k o . k eo
zeppelin	ch e . p e l . l i n
kris	k eu . l i . s eu
betty	b e . t i
edelstein	e . d e l . s eu . t e . i n
naiman	n a . i . m a n
amelie	a . m e l . l i . e
whitelaw	h wa . i . t eu l . l o
salween	s a l . wi n
nahum	n a . h u m
simi	s i . m i
vallejo	b a . ye . h o
seligman	s e l . l i . g eu . m eo n
barker	b a . k eo
sigourney	s i . g eo . n i
edward	e . d eu . wo . d eu
fonseca	p o n . s e . k a
jasper	j a . s eu . p eo
bains	b e . i n . j eu
eleanor	e l . l i . n eo
biagio	b i . a . j i . o
silber	s i l . b eo
tam	t a m
halley	h ae l . l i
metz	m e . s eu
giordano	j o . l eu . d a . n o
nepal	n e . p a l
utrillo	yu . t eu . l i l . l o
scharnhorst	s ya . l eu n . h o . l eu . s eu . t eu
astrakhan	a . s eu . t eu . l a . h a n
crosby	k eu . l o . s eu . b i
synge	s i ng
olive	o l . l i . b eu
schopenhauer	s yo . p e n . h a . wo
carvalho	k a . l eu . b a l . l yo
hendrix	h e n . d eu . l i g . s eu
schawlow	s yo l . l o
med	m e . d eu
dongen	d o ng . g e n
bergman	b eo . g eu . m eo n
keiser	k a . i . j eo
turk	t eo . k i
lini	l i . n i
frick	p eu . l i g
brattain	b eu . l ae . t eu n
burnett	b eo . n e s
weingartner	b a . i n . g a . l eu . t eu . n eo
fedin	p e . d i n
kasper	k a . s eu . p eo
leipzig	l a . i . p eu . ch i . h i
allen	a l . l e n
doherty	d o . h eo . t i
cyprus	s a . i . p eu . l eo . s eu
montenegro	m o n . t e . n e . g eu . l o
appenzeller	a . p e n . j e l . l eo
nestor	n e . s eu . t o . l eu
reppe	l e . p e
wesleyan	we . s eu l . l i
makarov	m a . k a . l o . p eu
xizhen	s i . j eo n
harden	h a . d eu n
galilei	g a l . l i l . l e . i
vinogradov	b i . n o . g eu . l a . d o . p eu
machiavelli	m a . k i . a . b e l . l i
kierkegaard	k i . e . l eu . k e . g o . l eu
sullivan	s eo l . l i . b eo n
jospin	j o . s eu . p ae ng
fisher	p i . s yeo
stevie	s eu . t i . b i
gorbachev	g o . l eu . b a . ch o . p eu
pasto	p a . s eu . t o
alexander	a l . l e g . s a n . d eu . l eu
london	l eo n . d eo n
port_of_spain	p o . t eu . o . b eu . s eu . p e . i n
lithuania	l i . t u . a . n i . a
koltsov	k o l . ch o . p eu
joanna	j o . a n . n a
abir	a . b i . l eu
ulf	u l . p eu
erfurt	e . l eu . p u . l eu . t eu
pacino	p a . ch i . n o
zimmer	ch i . m eo
francisco	p eu . l a n . s i . s eu . k o
harsanyi	h eo . s ya . n i
sampson	s ae m . s eu n
feininger	p a . i . n i ng . eo
campigli	k a m . p i l . l i
soufflot	s u . p eu l . l o
monge	m o ng . j u
reuter	l o . i . t eo
jena	ye . n a
masefield	m e . i . s eu . p i l . d eu
jansky	j ae n . s eu . k i
whittier	h wi . t i . eo
robertson	l o . b eo . t eu . s eu n
lenz	l e n . ch eu
simon	s i . m o n
cabrera	k a . b eu . l e . l a
toni	t a . n i
pollock	p o l . l o g
ericson	e . l i g . s eu n
janusz	ya . n u . s i
sarney	s a . l eu . n e . i
angora	a ng . g o . l a
kremer	k eu . l e . m eo
melbourne	m e l . b eo . l eu n
clearwater	k eu l . l i . eo . wo . t eo
dickens	d i . k i n . j eu
westwood	we . s eu . t eu . u . d eu
rhodes	l o . d o . s eu
bernanos	b e . l eu . n a . n o . s eu
raj	l a . j i
walter	b a l . t eo
meryl	m e . l i l
cochrane	k o . k eu . l eo n
peruzzi	p e . l u . ch i
roland	l o l . l a n . d eu
guarnieri	g wa . l eu . n i . e . l i
jacoby	j a . k o . b i
berkeley	b a . k eu l . l i
ronald	l o . n eo l . d eu
pulci	p u l . ch i
stefani	s eu . t e . p a . n i
eliot	e l . l i . eo . t eu
moi	m o . i
ralston	l ae l . s eu . t eo n
gunnar	g u n . n a . l eu
frantisek	p eu . l a n . t i . s e g
denikin	d e . n i . k i n
grahame	g eu . l e . i . eo m
carlin	k a l . l i n
jude	yu . d a
mccann	m ae g . k ae n
erin	e . l i n
fanny	p a . n i
belfast	b e l . p a . s eu . t eu
verwey	p e . l eu . we . i
alberti	a l . b e . l eu . t i
america	a . m e . l i . k a
spener	s yu . p e . n eo
whitfield	h wi s . p i l . d eu
belmopan	b e l . m o . p a n
royce	l o . i . s eu
lily	l i l . l i
tasman	t a . s eu . m eo n
addison	ae . d i . s eu n
verde	b e . l eu . d e
babylon	b a . b i l . l o n
khorana	k o . l a . n a
arroyo	a . l o . yo
tussaud	t eo . s o
lugar	l u . g a
cane	k e . i n
dagmar	d a . g eu . m a . l eu
ahern	eo . h eo n
topeka	t o . p i . k a
noah	n o . a
kolja	k o l . l i . ya
seton	s i . t eo n
keswick	k e . s eu . wi g
eve	i . b eu
marisa	m a . l i . s a
stanislav	s eu . t a . n i . s eu l . l a . p eu
salvador	s a l . b a . d o . l eu
clifford	k eu l . l i . p eo . d eu
gielgud	g i l . g u . d eu
koirala	k o . i . l a l . l a
delta	d e l . t a
dulles	d eo l . l e . s eu
banting	b ae n . t i ng
fernandez	p e . l eu . n a n . d e . s eu
andrade	a n . d eu . l a . d e
schleiermacher	s yu l . l a . i . eo . m a . h eo
vincent	b ae ng . s a ng
katherine	k ae . s eo . l i n
guillaumin	g i . yo . m ae ng
azerbaijan	a . j e . l eu . b a . i . j a n
abuja	a . b u . j a
laurens	l o . l a ng . s eu
rademacher	l a . d e . m a . h eo
basie	b e . i . s i
heaviside	h e . b i . s a . i . d eu
wicksell	b i g . s e l
chic	ch i g
krasnoyarsk	k eu . l a . s eu . n o . ya . l eu . s eu . k eu
muskogee	m u . s eu . k o . g i
eichendorff	a . i . h e n . d o . l eu . p eu
kaspar	k a . s eu . p a . eo
dee	d i
soares	s o . a . l e . s eu
santayana	s a n . t a . ya . n a
benacerraf	b e . n a . s e . l a . p eu
grigorovich	g eu . l i . g o . l o . b i . ch i
graf	g eu . l a . p eu
joaquim	h o . a . k i m
baldung	b a l . d u ng
trollope	t eu . l o l . l eo b
cajori	k a . j o . l i
kempis	k e m . p i . s eu
pinto	p i n . t o
baker	b e . i . k eo
walcott	wo l . k eo s
maciel	m a . s i . e l
ward	wo . d eu
monty	m o n . t i
caprivi	k a . p eu . l i . b i
daniel	d a . n i . e l
toma	t o . m a
maurras	m o . l a . s eu
michell	m i . ch e l
bethlehem	b e . d eu l . l e . h e m
carlson	k a l . s eu n
ernie	eo . n i
winkler	b i ng . k eu l . l eo
gerhard	g e . l eu . h a . l eu . t eu
apollo	a . p o l . l o
krishna	k eu . l i . s yu . n a
sforza	s eu . p o . l eu . j a
buhari	b u . h a . l i
alvin	ae l . b i n
glenda	g eu l . l e n . d a
mantovani	m a n . t o . b a . n i
frida	p eu . l i . d a
tyndale	t i n . d eu l
selim	s e l . l i m
jobim	j o . b i m
nolte	n o l . t e
hahnemann	h a . n e . m a n
gladkov	g eu l . l a s . k o . p eu
luxemburg	l u g . s e m . b u . l eu . k eu
marlowe	m a l . l o
wimbledon	wi m . b eu l . d eo n
gamble	g ae m . b eu l
sonya	s o . n ya
quasimodo	k wa . s i . m o . d o
beda	b e . d a
armando	a . l eu . m a n . d o
seamus	s ye . i . m eo . s eu
bessemer	b e . s e . m eo
amar	a . m a . l eu
fitch	p i . ch i
reinhardt	l a . i n . h a . l eu . t eu
dodoma	d o . d o . m a
celia	s e l . l i . a
acapulco	a . k a . p u l . k o
brand	b eu . l ae n . d eu
wilm	b i l . l eu m
stonehenge	s eu . t o n . h e n . j i
isabel	i . s a . b e l
bergen	b e . l eu . g e n
loy	l o . i
stratford	s eu . t eu . l ae s . p o . d eu
cassell	k a . s e l
cassin	k a . s ae ng
betjeman	b e . ch eo . m eo n
gore	g o . eo
benedikt	b e . n e . d i g . t eu
peng	p eo ng
ismael	i . s eu . m a . e l
chamai	ch a . m a . i
kaufman	k o . p eu . m eo n
hyndman	h a . i n . d eu . m eo n
georg	g e . o . l eu . g eu
mircea	m i . l eu . ch e . a
richelieu	l i . s yu l . l i . oe
arkansas	a . k a n . s o
june	j yu n
richie	l i . ch i
salinger	s ae l . l i n . j eo
gross	g eu . l o . s eu
anatolia	a . n a . t o l . l i . a
violet	b a . i . o l . l e s
judea	yu . d ae
pisano	p i . s a . n o
tallis	t ae l . l i . s eu
nathalie	n a . t a l . l i
gairdner	g e . eo . d eu . n eo
rombach	l o m . b a . h eu
irwin	eo . wi n
somalia	s o . m a l . l i . a
melinda	m e l . l i n . d a
molnar	m o l . n a
chatterton	ch ae . t eo . t eo n
herrington	h e . l i ng . t eo n
mathis	m ae . t i . s eu
orange	o . l a ng . ye
russ	l eo . s eu
vincent	b i n . s e n . t eu
secchi	s e . k i
sahara	s a . h a . l a
ruud	l wi . t eu
coiter	k o . i . t eo
lusaka	l u . s a . k a
miller	m i l . l eo
fontaine	p o ng . t e n
joanne	j o . ae n
brant	b eu . l a n . t eu
badger	b ae . j eo
santer	s a ng . t e . l eu
wendy	we n . d i
mei	m e . i
dorothy	d o . l o . s i
agatha	a . g a . s a
jolly	j o l . l i
razin	l a . j i n
alam	a l . eo m
hall	h o l
carlyle	k a l . l a . i l
johansen	yo . h a n . s e n
auer	a . u . eo
ciano	ch i . a . n o
kabul	k a . b u l
stephen	s eu . t i . b eu n
everhart	e . b eo . h a . t eu
peper	p e . p e . l eu
bushman	b u . s i . m eo n
bayer	b a . i . eo
sommer	j o . m eo
viola	b i . o l . l a
maupertuis	m o . p e . l eu . t wi . i
ehrenfeld	e . l eo n . p e l . d eu
borodin	b o . l o . d i n
dicey	d a . i . s i
kilpinen	k i l . p i . n e n
steiner	s yu . t a . i . n eo
lieberman	l i . b eo . m eo n
amos	a . m o . s eu
pigou	p i . g u
philippe	p i l . l i . p eu
roberta	l o . b eo . t a
florence	p eu l . l o . l e n . s eu
garcia	g a . l eu . s i . a
kees	k i . s eu
stanley	s eu . t ae n . l i
holt	h o l . t eu
cohen	k o . eo n
lemaitre	l eu . m e . t eu . l eu
langmuir	l ae ng . m yu . eo
sholokhov	s yo l . l o . h o . p eu
lassus	l a . s u . s eu
lamartine	l a . m a . l eu . t i n
beckett	b e . k e . t eu
norway	n o . l eu . we . i
unger	u ng . g eo
kronecker	k eu . l o . n e . k eo
bihar	b i . h a . l eu
neil	n i l
myers	m a . i . eo . s eu
titchener	t i . ch i . n eo
scott	s eu . k o . t eu
yannick	ya . n i g
biel	b i . e l
munich	m wi n . h e n
gamba	g a m . b a
gaetano	g a . e . t a . n o
rudiger	l u . d i . g eo
palme	p a l . m e
hana	h a . n a
worthington	wo . s i ng . t eo n
frechette	p eu . l e . s ye . t eu
mussolini	m u s . s o l . l i . n i
kane	k e . i n
bendix	b e n . d i g . s eu
burlington	b eo . l i ng . t o n
pudovkin	p u . d o . p eu . k i n
goa	g o . a
haeckel	h e . k e l
boucher	b a . u . ch eo
leif	l e . i . p eu
natta	n a . t a
stefano	s eu . t e . p a . n o
byrd	b eo . d eu
gajdusek	g a . i . d yu . s e g
thebes	t e . b e
blake	b eu l . l e . i . k eu
previn	p eu . l e . b i n
els	e l . s eu
howell	h a . we l
beaufort	b o . p eo . t eu
ryle	l a . i l
castigliano	k a . s eu . t i l . l i . a . n o
shah	s ya . a
husak	h u . s a g
sibelius	s i . b e l . l i . u . s eu
latvia	l a . t eu . b i . a
hamm	h a m
gleysteen	g eu l . l a . i . s eu . t i n
raffles	l ae . p eu l . s eu
enders	e n . d eo . s eu
swan	s eu . wa n
gleizes	g eu l . l e . i . j eu
shamir	s ya . m i . l eu
korngold	k o n . g o l . d eu
goldoni	g o l . d o . n i
brightman	b eu . l a . i . t eu . m a n
rosemary	l o . j eu . m e . l i
hecht	h e g . t eu
europe	yu . l eo b
matt	m ae s
gable	g e . i . b eu l
wiesel	b i . s e l
baumeister	b a . u . m a . i . s eu . t eo
reiner	l a . i . n eo
tendryakov	t e n . d eu . l ya . k o . p eu
ulises	yu l . l i . s i . s eu
paula	p o l . l a
dod	d o . d eu
count	k a . u n . t eu
ferry	p e . l i
ashley	ae . s yu l . l i
mabel	m a . b e l
anfinsen	a n . p i n . s eu n
utah	yu . t a
boccioni	b o . ch o . n i
temple	t e m . p eu l
kraft	k eu . l a . p eu . t eu
jeans	j i n . s eu
sweet	s eu . wi . t eu
siegel	s i . g e l
carmel	k a . l eu . m e l
jouvet	j u . b e
sherriff	s ye . l i . p eu
eritrea	e . l i . t eu . l e . a
magnitogorsk	m a . g eu . n i . t o . g o . l eu . s eu . k eu
bluff	b eu l . l eo . p eu
allentown	a l . l e n . t a . u n
macon	m a . k o ng
bret	b eu . l e s
brooke	b eu . l u g
shaheen	s yae . h i n
guiana	g i . a . n a
perl	p eo l
gaspard	g a . s eu . p a . l eu
arce	a . l eu . s e
marcel	m a . l eu . s e l
pregl	p eu . l e . g eu l
klondike	k eu l . l o n . d a . i . k eu
heisenberg	h a . i . j e n . b e . l eu . k eu
reinach	l a . i . n a . h eu
ekman	e . k eu . m a n
kachalov	k a . ch a l . l o . p eu
klagenfurt	k eu l . l a . g e n . p u . l eu . t eu
flemming	p eu l . l e . m i ng
tiselius	t i . s e l . l i . u . s eu
bruce	b eu . l u . s eu
phillip	p i l . l i b
powell	p a . wo l
koenigsberger	k wi . n i . s eu . b eo . g eo
eberhard	e . b e l . h a . l eu . t eu
osler	o . s eu l . l eo
werth	we l . s eu
dewey	d yu . i
hobson	h o b . s eu n
waterford	wo . t eo . p eo . d eu
ara	a . l a
morrissey	m o . l i . ss i
matthews	m ae . s yu . s eu
crawford	k eu . l o . p eo . d eu
radu	l a . d u
fillmore	p i l . m o . eo
elias	e l . l i . a . s eu
pollack	p o l . l a g
hanoi	h a . n o . i
inez	a . i . n e . j eu
zacharias	j a . k a . l i . a . s eu
aaron	a . l o n
northrop	n o . s eu . l eo b
pyongyang	p yeo ng . ya ng
spyri	s yu . p i . l i
sheppard	s ye . p eo . d eu
kuznetsov	k u . j eu . n e . ch o . p eu
napoleon	n a . p o l . l e . o ng
pagano	p a . g a . n o
zelaya	j e . l a . ya
kingstown	k i ng . s eu . t a . u n
lynch	l i n . ch i
jeanne	j a n
vinci	b i n . ch i
dirk	d eo . k eu
bates	b e . i . ch eu
durante	d yu . l a n . t e
greuze	g eu . l oe . j eu
hue	wi . e
delibes	d eu l . l i . b eu
bowen	b o . e n
kuno	k u . n o
russo	l u . s o
moss	m o . s eu
bernier	b e . l eu . n i . e
antonius	a n . t o . n i . u . s eu
mozart	m o . ch a . l eu . t eu
janez	ya . n e . j eu
asuncion	a . s u n . s i . o n
dopsch	d o . p eu . s yu
suriname	s u . l i . n a m
robles	l o . b eu l . l e . s eu
wieman	wi . m eo n
ridley	l i . d eu l . l i
kemal	k e . m a l
portugal	p o . l eu . t u . g a l
judd	j eo . d eu
pfleiderer	p eu l . l a . i . t e . l eo
nikolai	n i . k o l . l a . i
arnhem	a . l eu n . h e m
garbo	g a . l eu . b o
barna	b a . n a
virchow	p i . l eu . h o
osgood	o . s eu . g u s
bolzano	b o l . ch a . n o
kiss	k i . s i
rifkin	l i . p eu . k i n
gottlieb	g o . t eu l . l i . b eu
joaquin	h o . a . k i n
maksim	m a g . s i m
lapp	l a . p eu
wayne	we . i n
albani	a l . b a . n i
monet	m o . n e
goldman	g o l . d eu . m a ng
schmid	s yu . m i . d eu
cresson	k eu . l e . s o ng
bessel	b e . s e l
saunders	s eo n . d eo . s eu
abel	a . b e l
platen	p eu l . l a . t e n
wallon	wa l . l o ng
buchenwald	b u . h e n . b a l . t eu
parly	p a . l eu l . l i
littleton	l i . t eu l . t eo n
heyden	h e . i . d e n
padilla	p a . d i l . l a
bean	b i n
tina	t i . n a
rolf	l o l . p eu
alphonso	a l . p o n . s o
ronge	l o ng . i
bakhtin	b a . h eu . ch i n
niels	n i l . s eu
hofmeister	h o . p eu . m a . i . s eu . t eo
beadle	b i . d eu l
pavese	p a . b e . s e
jennifer	j e . n i . p eo
jobs	j a b . s eu
cunningham	k eo . n i ng . eo m
hensen	h e n . j e n
sanz	s a n . s eu
asturias	a . s eu . t u . l i . a . s eu
abigail	ae . b i . g ae . i l
gordimer	g o . d i . m eo
liebmann	l i . p eu . m a n
prendergast	p eu . l e n . d eo . g a . s eu . t eu
cowper	k u . p eo
groom	g eu . l u m
woodworth	u . d eu . wo . s eu
robinson	l o . b i n . s eu n
nadine	n e . i . d i n
ariel	a . l i . e l
hebra	h e . b eu . l a
helsinki	h e l . s i ng . k i
gloucester	g eu l . l o . s eu . t eo
starr	s eu . t a
toffler	t o . p eu l . l eo
cudworth	k eo . d eu . wo . s eu
fidel	p i . d e l
kondo	k o n . d o
cassou	k a . s u
havel	h a . b e l
klinger	k eu l . l i ng . g eo
rodgers	l o . j eo . s eu
lesseps	l e . s e b . s eu
barrie	b ae . l i
bourget	b u . l eu . j e
alvaro	a l . b a . l o
boghossian	b o . g o . s i . a ng
huizinga	h o . i . j i ng . g a
fridtjof	p eu . l i . d eu . s yo . p eu
amy	e . i . m i
weyden	b a . i . d e n
townes	t a . u n . s eu
deed	d i . d eu
frisch	p eu . l i . s yu
trautmann	t eu . l o . t eu . m a n
georgi	g e . o . l eu . g i
bulganin	b u l . g a . n i n
jain	j e . i n
hartle	h a . t eu l
danny	d a . n i
lorraine	l o . l e n
andres	a n . d eu . l e . s eu
asmara	a . s eu . m a . l a
pane	p e . i n
briscoe	b eu . l i . s eu . k o
camillo	k a . m i l . l o
brito	b eu . l i . t o
kruger	k eu . l wi . g eo
nesmeyanov	n e . s eu . m e . ya . n o . p eu
broadbent	b eu . l o . d eu . b e n . t eu
meisheng	m e . i . s eo ng
pippin	p i . p i n
renata	l e . n a . t a
joyner	j o . i . n eo
mark	m a . l eu . k eu
keane	k i n
johnstone	j o n . s eu . t o n
shield	s wi l . d eu
maxim	m a g . s i m
parma	p a . l eu . m a
benghazi	b e ng . g a . j i
hagen	h a . g e n
micronesia	m i . k eu . l o . n e . s i . a
ide	i . d eu
rodrigues	l o . d eu . l i . g e . s eu
haiti	a . i . t i
brockman	b eu . l o . k eu . m a n
nobile	n o . b i l . l e
hanon	a . n o ng
tiberius	t i . b e . l i . u . s eu
lu	l u
rossi	l o . s i
rude	l wi . d eu
julius	yu l . l i . u . s eu
borlaug	b o l . l o . g eu
marin	m a . l ae ng
murdoch	m eo . d o g
grey	g eu . l e . i
cueva	k u . e . b a
fowles	p a . u l . j eu
marie	m a . l i
epirus	e . p i . l u . s eu
blass	b eu . l e . s eu
black	b eu l . l ae g
meyers	m e . i . eo . s eu
agrippina	a . g eu . l i . p i . n a
torrence	t o . l eo n . s eu
spallanzani	s eu . p a l . l a n . ch a . n i
murphy	m eo . p i
hinshelwood	h i n . s yeo l . u . d eu
sanger	s ae ng . eo
feuerbach	p o . i . eo . b a . h eu
jozef	yo . j e . p eu
antonina	a n . t o . n i . n a
doisy	d o . i . j i
dufy	d wi . p i
titus	d i . d o . s eo
kendall	k e n . d eu l
ferenc	p e . l e n . ch eu
fiedler	p i . d eu l . l eo
brent	b eu . l e n . t eu
gennady	g e n . n a . d i
green	g eu . l i n
deirdre	d e . eo . d eu . l eu
rich	l i . ch i
husseini	h u . s e . i . n i
tormod	t o . m o . d eu
mille	m i l
mitropoulos	m i . t eu . l o . p o l . l o . s eu
eccles	e . k eu l . s eu
murmansk	m u . l eu . m a n . s eu . k eu
thorne	ss o n
daley	d e . i l . l i
rosenthal	l o . j e n . t a l
lima	l i . m a
matthew	m a . t ae
bloch	b eu l . l o . k eu
serge	s e . l eu . g e
normandy	n o . l eu . m a ng . d i
kerstin	k eo . s eu . t i n
albers	a l . b e . l eu . s eu
boz	b o . j eu
mike	m a . i . k eu
siewert	s i . wo . t eu
reynaud	l e . n o
tudor	t u . d o . l eu
kansas	k ae n . j a . s eu
meg	m ae g
wolfers	wo l . p eo . s eu
grenada	g eu . l e . n a . d a
rankovic	l a ng . k o . b i . ch i
keller	k e l . l eo
gropius	g eu . l o . p i . u . s eu
schnabel	s yu . n a . b e l
borchardt	b o . l eu . h a . l eu . t eu
breton	b eu . l e . t eu n
pekka	p e . k a
driesch	d eu . l i . s yu
alberto	a l . b e . l eu . t o
donahue	d o . n a . h yu
monteux	m o ng . t oe
brescia	b eu . l e . s i . a
fritz	p eu . l i . ch eu
borgia	b o . l eu . j a
fitzgerald	p i . ch eu . j e . l eo l . d eu
schell	s we l
aman	a . m a n
dyer	d a . i . eo
corsica	k o . l eu . s i . k a
vesuvius	b e . s u . b i . o
nasmyth	n e . i . j eu . m i . s eu
augustine	eo . g eo . s eu . t i n
makin	m a . k i n
jenner	j e . n eo
toner	t o . n eo
tilghman	t i l . m eo n
shu	s u
arago	a . l a . g o
ancona	a n . k o . n a
bette	b e . t i
chattanooga	ch ae . t eo . n u . g a
piranesi	p i . l a . n e . s i
boas	b o . ae . s eu
alfred	ae l . p eu . l e . d eu
diocletianus	d i . o . k eu l . l e . t i . a . n u . s eu
hoffmann	h o . p eu . m a n
dorchester	d o . ch e . s eu . t eo
sazonov	s a . j o . n o . p eu
feldstein	p e l . d eu . s eu . t a . i n
tweed	d e . d o
gantt	g ae n . t eu
annika	a . n i . k a
torquato	t o . l eu . k wa . t o
garang	g a . l a ng
nouri	n u . l i
judas	yu . d a
ginastera	h i . n a . s eu . t e . l a
cartan	k a . l eu . t a ng
lino	l i . n o
kuibyshev	k u . i . b i . s ye . p eu
kok	k o . k eu
pontormo	p o n . t o . l eu . m o
lamy	l a . m i
orban	o . l eu . b eo n
asa	a . s a
jerrold	j e . l eo l . d eu
abilene	ae . b i l . l i n
alexandria	a l . l e g . s a n . d eu . l i . a
saar	j a . l eu
cardinale	k a . l eu . d i . n a l . l e
sprengel	s yu . p eu . l e ng . g e l
reynolds	l e . i . n o l . j eu
fo	p o
sol	s o l
pax	p a g . s eu
hasenclever	h a . j e n . k eu l . l e . b eo
johnstown	j o n . s eu . t a . u n
guyau	g wi . yo
gokhale	g o . k a l . l e
branco	b eu . l a ng . k o
tripolitania	t eu . l i . p o l . l i . t a . n i . a
nevada	n e . b a . d a
vivian	b i . b i . eo n
farrell	p ae . l eo l
afanasiev	a . p a . n a . s i . ye . p eu
acs	ae g . s eu
arnoldson	a . l eu . n o l . d eu . s o n
polo	p o l . l o
danielsson	d a . n i . e l . s o n
oliveira	o l . l i . b e . i . l a
christenson	k eu . l i . s eu . t eo n . s eu n
schwerin	s yu . b e . l i n
pullman	p u l . m eo n
cox	k o g . s eu
linton	l i n . t eo n
titulescu	t i . t u l . l e . s eu . k u
weizman	b a . i . ch eu . m a n
baucus	b a . k eu . s eu
leopardi	l e . o . p a . l eu . d i
imbert	i m . b e . l eu . t eu
balenciaga	b a l . l e n . s i . a . g a
alban	a l . b a n
donatus	d o . n a . t u . s eu
simmons	s i . m eo n . s eu
shockley	s yo . k eu l . l i
kircher	k i . l eu . h eo
masur	m a . j u . eo
lesotho	l e . s o . t o
kahn	k a n
martins	m a . t i n
poitiers	p u . a . t i . e
camargo	k a . m a . l eu . g o
tylor	t a . i l . l eo
marianne	m a . l i . a n . n eu
hofer	h o . p eo
jan	ya n
gardner	g a . d eu . n eo
pauling	p o l . l i ng
ruo	l wo
rand	l ae n . d eu
castillo	k a . s eu . t i l . l o
wilhelm	b i l . h e l . l eu m
gould	g u l . d eu
roberts	l o . b eo . ch eu
obando	o . b a n . d o
huston	h yu . s eu . t eo n
cardano	k a . l eu . d a . n o
bevan	b e . b eo n
ellery	e l . l eo . l i
holden	h o l . d eu n
robert	l o . b eo . t eu
dan	d a n
jawara	j a . wa . l a
stirling	s eu . t eo . l i ng
boswell	b o . j eu . we l
denis	d e . n i . s eu
thor	t o . l eu
malpighi	m a l . p i . g i
lamennais	l a . m eu . n e
ames	e . i m . s eu
barcelona	b a . l eu . s e l . l o . n a
thorpe	s o . p eu
carol	k ae . l eo l
albany	o l . b eo . n i
rainy	l e . i . n i
labuan	l a . b u . a n
mauser	m o . j e . l eu
tulasne	t u l . l a . s eu n
zagreb	j a . g eu . l e . b eu
tajo	t a . h o
peel	p i l
babbage	b ae . b i . j i
giovanni	j o . b a n . n i
burger	b eo . g eo
ursula	u . j eu l . l a
pellegrini	p e l . l e . g eu . l i . n i
couperin	k u . p eu . l ae ng
goffman	g o . p eu . m eo n
ems	e m . s eu
caldecott	k o l . d eo . k eo s
lytton	l i . t eo n
duisburg	d wi . s eu . b u . l eu . k eu
macrae	m ae g . l e . i
greece	g eu . l i . s eu
gertsen	g e . l eu . ch e n
savannah	s eo . b ae . n eo
appalachia	a . p a . l a . ch i . a
musa	m u . s a
desnos	d e . s eu . n o . s eu
heuss	h o . i . s eu
jocelyn	j o . s e l . l i n
lockett	l o . k e s
ryan	l a . i . eo n
gustavo	g u . s eu . t a . b o
doolittle	d u l . l i . t eu l
brunei	b eu . l u . n a . i
karin	k a . l i n
pertini	p e . l eu . t i . n i
richter	l i . h i . t eo
canaro	k a . n a . l o
erhard	e . l eu . h a . l eu . t eu
asser	a . s e . l eu
eastman	i . s eu . t eu . m eo n
vives	b i . b e . s eu
goethals	g o . s eo l . s eu
iris	i . l i . s eu
pinero	p i . n e . l o
dannemann	d a . n e . m a n
erdmann	e . l eu . d eu . m a n
stakhanov	s eu . tt a . h a . n o . p eu
mbasogo	eu m . b a . s o . g o
whymper	h wi m . p eo
pablo	p a . b eu l . l o
harare	h a . l a . l e
veronese	b e . l o . n e . s e
ingram	i ng . g eu . l ae m
thomas	d o . m a
benedetto	b e . n e . d e . t o
christchurch	k eu . l a . i . s eu . t eu . ch eo . ch i
bjorklund	b i . yo . l eu . k eu . l u n . t eu
nizan	n i . j a ng
philipe	p i l . l i . p eu
eastwood	i . s eu . t eu . u . d eu
sheila	s wi l . l a
gerd	g e . l eu . t eu
gluck	g eu l . l u . k eu
wohlgemut	b o l . g e . m u . t eu
pick	p i . k eu
houston	h yu . s eu . t eo n
markham	m a . k a m
hendrikx	h e n . d eu . l i g . s eu
gustaf	g u . s eu . t a . p eu
beth	b e . s eu
boyce	b o . i . s eu
kaas	k a . s eu
ezer	e . j e . l eu
roy	l o . i
hepburn	h e b . b eo n
guido	g u . i . d o
dane	d e . i n
jacobson	j e . i . k o b . s eu n
cambiaso	k a m . b i . a . s o
paderewski	p a . d e . l e . p eu . s eu . k i
pagnol	p a . n yo l
taylor	t e . i l . l eo
giusti	j u . s eu . t i
keats	k i . ch eu
kitty	k i . t i
petri	p e . t eu . l i
chamorro	ch a . m o . l o
vorontsov	b o . l o n . ch o . p eu
wassermann	b a . s e . l eu . m a n
rabelais	l a . b eu l . l e
abegg	a . b e . g eu
bangalore	b a ng . g a l . l o . l eu
lech	l e . h eu
flanagan	p eu l . l ae . n eo . g eo n
ochab	o . h a . p eu
lippi	l i . p i
emanuel	e . m a . n u . e l
salerno	s a l . l e . l eu . n o
negev	n e . g e . b eu
ludwig	l u . t eu . b i . h i
colombo	k o l . l o m . b o
norris	n o . l i . s eu
rabinowitz	l a . b i . n o . b i . ch eu
aspinall	a . s eu . p i . n a l
driver	d eu . l a . i . b eo
schubert	s yu . b e . l eu . t eu
kraepelin	k eu . l e . p e l . l i n
gorky	g o . k i
jidda	j i . d a
reade	l i . d eu
renn	l e n
ackermann	a . k eo . m a n
espronceda	e . s eu . p eu . l o n . s e . d a
rodriguez	l o . d eu . l i . g e . s eu
duhem	d wi . e m
aram	a . l a m
lou	l u
malkin	m a l . k i n
haynes	h e . i n . j eu
edita	e . d i . t a
pinheiro	p i . n e . i . l o
phyllis	p i l . l i . s eu
boerner	b oe . l eu . n eo
ion	i . o n
christie	k eu . l i . s eu . t i
chippendale	ch i . p e n . d e . i l
benedetti	b e . n e . d e . t i
janine	j e . n i n
sonia	s o . n ya
dobson	d o . b eu . s eu n
blair	b eu l . l e . eo
hayat	h a . ya s
gorchakov	g o . l eu . ch a . k o . p eu
calfa	ch a l . p a
tashkent	t a . s yu . k e n . t eu
kerekou	k e . l e . k u
walsingham	wo l . s i ng . eo m
oklahoma	o . k eu l . l eo . h o . m a
rozier	l o . j i . e
sok	s eo g
wade	wa . d e
agarwal	a . g a . l eu . wa l
carpaccio	k a . l eu . p a . ch o
kathryn	k ae . s eo . l i n
fibiger	p i . b i . g e . l eu
sholes	s yo l . s eu
sumner	s eo m . n eo
roach	l o . ch i
haidar	h a . i . d a . l eu
amato	a . m a . t o
rous	l a . u . s eu
grieg	g eu . l i . g eu
schultze	s yu l . ch e
ahmad	a . m a . d eu
jacobsen	ya . k o b . s e n
bremerhaven	b eu . l e . m eo . h a . p e n
angela	a ng . g e l . l a
montfort	m o ng . p o . l eu
alessandro	a l . l e . s a n . d eu . l o
altman	o l . t eu . m eo n
serao	s e . l a . o
berenger	b e . l i n . j eo
erasmus	e . l a . s eu . m u . s eu
barth	b a . l eu . t eu
zeeland	j e l . l a n . d eu
masters	m a . s eu . t eo . s eu
navarro	n a . b a . l o
denton	d e n . t eu n
whitaker	h wi . t ae . k eo
andy	ae n . d i
greely	g eu . l i l . l i
fitzpatrick	p i . ch eu . p ae . t eu . l i g
xenakis	k eu . s e . n a . k i . s eu
vertov	b e . l eu . t o . p eu
sigmund	s i . g eu . m eo n . d eu
bonnie	b o . n i
sakharov	s a . h a . l o . p eu
rivera	l i . b e . l a
sally	s ae l . l i
morrison	m o . l i . s eu n
pacheco	p a . ch e . k o
bernd	b e . l eu n . t eu
singer	s i ng . eo
ozenfant	o . j a ng . p a ng
gordon	g o . d eu n
eckersley	e . k eo . s eu l . l i
borst	b o . l eu . s eu . t eu
tomas	t o . m a . s eu
tarrant	t a . l a n . t eu
cartwright	k a . t eu . l a . i . t eu
theobald	s i . eo . b eo l . d eu
aquino	a . k i . n o
dayan	d a . ya n
mackinder	m ae . k i n . d eo
moscow	m o . s eu . k eu . b a
servais	s e . l eu . b e
mayer	m a . i . eo
poe	p o
jamil	h a . m i l
canton	g wa ng . d u ng
bonomi	b o . n o . m i
cressent	k eu . l e . s a ng
ndiaye	n eu . j ya . ye
morton	m o . t eo n
apollinaire	a . p o l . l i . n e . l eu
bryant	b eu . l a . i . eo n . t eu
dunne	d eo n
spohr	s yu . p o . eo
milton	m i l . t eo n
brundage	b eu . l eo n . d i . j i
wright	l a . i . t eu
deissmann	d a . i . s eu . m a n
serafin	s e . l a . p i n
alvares	a l . b a . l e . s eu
moyse	m o . i . j eu
bardeen	b a . d i n
mckenzie	m ae g . k e n . j i
palmiro	p a l . m i . l o
rabat	l a . b a . t eu
kessel	k e . s e l
dolph	d o l . p eu
calgary	k ae l . g eo . l i
boccherini	b o . k e . l i . n i
mari	m a . l i
sadi	s a . d i
buddy	b eo . d i
dominique	d o . m i . n i . k eu
freetown	p eu . l i . t a . u n
zoran	j o . l a n
steel	s eu . t i l
gadamer	g a . d a . m eo
messer	m e . s eo
dion	d i . o ng
warga	wa . g a
alaska	a l . l ae . s eu . k a
stokowski	s eu . t o . k o . p eu . s eu . k i
lysenko	l i . s e n . k o
essex	e . s i g . s eu
milos	m i l . l o . s eu
uzi	u . j i
grasse	g eu . l ae . s eu
aldington	o l . d i ng . t eo n
dodds	d o . j eu
hungary	h eo ng . g a . l i
varga	b a . l eu . g a
lauren	l o . l e n
standen	s eu . t ae n . d eu n
bilal	b i l . l a l
shostakovich	s yo . s eu . t a . k o . b i . ch i
stewart	s eu . t yu . eo . t eu
edna	e . d eu . n a
pirelli	p i . l e l . l i
jodie	j o . d i
lorin	l o . l i n
andrea	a n . d eu . l e . a
merriam	m e . l i . eo m
verdun	b e . l eu . d oe ng
packard	p ae g . k eo . d eu
mesopotamia	m e . s o . p o . t a . m i . a
lyons	l i . yo ng
milano	m i l . l a . n o
johnston	j o n . s eu . t o n
wyatt	wa . i . eo s
magdalena	m a g . d a l . l e . n a
west	we . s eu . t eu
colleen	k o l . l i n
vida	b i . d a
medawar	m e . d eo . wo
turgenev	t u . l eu . g e . n e . p eu
maxine	m ae g . s i n
doreen	d o . l i n
shelby	s ye l . b i
salih	ss a l . l i . h eu
bergson	b e . l eu . g eu . s o ng
forst	p o . l eu . s eu . t eu
koblenz	k o . b eu l . l e n . ch eu
flaubert	p eu l . l o . b e . l eu
lorenzen	l o . l e n . j e n
moran	m o . l eo n
sade	s a . d eu
emma	e . m a
naples	n a . p o l . l i
pakistan	p a . k i . s eu . t a n
hampshire	h ae m . p eu . s yeo
sangallo	s a ng . g a l . l o
zemskov	j e m . s eu . k o . p eu
northcliffe	n o . s eu . k eu l . l i . p eu
wallis	wi l . l i . s eu
gaj	g a . i
gertrude	g e . l eu . t eu . l u . d eu
berchem	b eo . ch e m
mbabane	eu m . b a . b a . n e
brodsky	b eu . l o . d eu . s eu . k i
beauchamp	b o . s ya ng
forlani	p o l . l a . n i
oslo	o . s eu l . l o
austin	o . s eu . t i n
soros	s o . l o . s eu
herta	h e . l eu . t a
bang	b a ng
monte	m o n . t e
helmont	h e l . m o n . t eu
maclean	m ae g . k eu l . l ae n
braham	b eu . l ae . h eo m
nilson	n i l . s o n
ioffe	yo . p e
stevenson	s eu . t i . b eu n . s eu n
constance	k o n . s eu . t a n . s eu
eliana	e l . l i . a . n a
kadun	k a . d u n
ruska	l u . s eu . k a
vermont	b eo . m o n . t eu
bonhoeffer	b o n . h oe . p eo
southey	s a . u . d i
wilfred	wi l . p eu . l e . d eu
smolensk	s eu . m o l . l e n . s eu . k eu
espinoza	e . s eu . p i . n o . j a
indra	i n . d eu . l a
tourneur	t eo . n eo
bellevue	b e l . l e . b yu
konstantin	k o n . s eu . t a n . t i n
agostino	a . g o . s eu . t i . n o
pareto	p a . l e . t o
iain	i . eo n
belasco	b e l . l a . s eu . k o
galtung	g a l . t u ng
sumatra	s u . m a . t eu . l a
monika	m o . n i . k a
rockefeller	l o g . p e l . l eo
karajan	k a . l a . ya n
sonja	s o . n ya
foch	p o . s yu
costa	k o . s eu . t a
cleveland	k eu l . l i . b eu l . l ae n . d eu
dow	d a . u
caplet	k ae . p eu l . l i s
kundt	k u n . t eu
stresemann	s yu . t eu . l e . j e . m a n
gavin	g ae . b i n
heim	h a . i m
debreu	d eu . b eu . l oe
dunant	d wi . n a ng
dent	t e n . t eu
nairobi	n a . i . l o . b i
johnnie	j o . n i
mander	m a n . d e . l eu
carlos	k a . l eu l . l o . s eu
morais	m o . l a . i . s eu
altenberg	a l . t e n . b e . l eu . k eu
herne	h e . l eu . n e
hamsun	h a m . s u n
hanover	h a . n o . b eo
marit	m a . l i . t eu
pepe	p e . p e
kinck	k i ng . k eu
hebbel	h e . b e l
bacon	b e . i . k eo n
kohl	k o l
bertel	b e . l eu . t e l
agnew	ae . g eu . n yu
hellman	h e l . m eo n
lawson	l o . s eu n
vicente	b i . s e n . t e
cienfuegos	s i . e n . p u . e . g o . s eu
grosso	g eu . l o . s o
halls	h o l . s eu
california	k ae l . l i . p o . n i . a
zeiss	ch a . i . s eu
debbie	d e . b i
carter	k a . t eo
elena	e l . l e . n a
guldberg	g u l . d eu . b e . l eu . g eu
ashton	ae . s yu . t eo n
leonor	l e . o . n o . l eu
ribera	l i . b e . l a
windsor	wi n . j eo
boden	b o . d e n
providence	p eu . l o . b i . d eo n . s eu
herford	h e . eo . p o . t eu
orlando	o l . l ae n . d o
henryk	h e n . l i . k eu
melchior	m e l . k i . o . l eu
gervinus	g e . l eu . b i . n u . s eu
francois	p eu . l a ng . s u . a
tallahassee	t ae l . l eo . h ae . s i
baer	b e . eo
jansson	ya n . s o n
luba	l u . b a
steinmetz	s eu . t a . i n . m e . ch eu
richmond	l i . ch i . m eo n . d eu
inga	i ng . g a
mondriaan	m o n . d eu . l i . a n
eysenck	a . i . s eo n . k eu
berlage	b e . l eu l . l a . h e
rohmer	l o . m e . l eu
muller	m eo l . l eo
matisse	m a . t i . s eu
dimitrov	d i . m i . t eu . l o . p eu
mariano	m a . l i . a . n o
magdeburg	m a . g eu . d e . b u . l eu . k eu
virgil	b eo . j i l
tehran	d e . h e . l a n
victor	b i g . t eo
welty	we l . t i
hannibal	h a n . n i . b a l
anstey	ae n . s eu . t i
switzerland	s eu . wi . s eu
sara	s a . l a
montero	m o n . t e . l o
alston	e l . s eu . t o n
strachey	s eu . t eu . l e . i . ch i
alia	a l . l i . a
lebedev	l e . b e . d e . p eu
strickland	s eu . t eu . l i g . l ae n . d eu
alvarez	ae l . b eo . l e . j eu
morisot	m o . l i . j o
schulz	s yu l . ch eu
moraes	m o . l a . e . s eu
ogburn	o . g eu . b eo n
loewi	l oe . b i
asso	a . s o
ellsworth	e l . j eu . wo . s eu
gennaro	j e n . n a . l o
bias	b i . a . s eu
sergi	s e . l eu . h i
bougainville	b u . g eo n . b i l
nukualofa	n u . k u . a l . l o . p a
lyle	l a . i l
goldwyn	g o l . d eu . wi n
sardou	s a . l eu . d u
lea	l e . a
bast	b a . s eu . t eu
glaspell	g eu l . l ae . s eu . p e l
gandhi	g a n . d i
naomi	n a . o
taussig	t a . u . s i . g eu
negro	n i . g eu . l o
dallas	d ae l . l eo . s eu
mogadishu	m o . g a . d i . s yu
iceland	a . i . s eu l . l a n . d eu
burr	b eo
dumitru	d u . m i . t eu . l u
giambattista	j a m . b a . t i . s eu . t a
charlton	ch a l . t eo n
gianni	j a n . n i
colman	k o l . m eo n
guadalupe	g wa . d a l . l u . p e
clark	k eu l . l a . k eu
yemen	ye . m e n
voigt	p o . k eu . t eu
junker	yu ng . k eo
jane	j e . i n
paul	b a . u l
naipaul	n a . i . p o l
wilder	wa . i l . d eo
hazel	h e . i . j eu l
naess	n e . s eu
nino	n i . n o
moller	m o l . l eo
shelley	s ye l . l i
hedin	h e . d i n
abernethy	ae . b eo . n e . s i
martino	m a . l eu . t i . n o
rios	l i . o . s eu
attenborough	ae . t eu n . b eo . l eo
sale	s a . l eu
eystein	e . s eu . t a . i n
jakob	ya . k o . p eu
lynd	l i n . d eu
woodrow	u . d eu . l o
deaver	d i . b eo
constantin	k o n . s eu . t a n . t i n
monk	m eo ng . k eu
reichstein	l a . i . h i . s yu . t a . i n
konstantinos	k o n . s eu . t a n . t i . n o . s eu
chamberlain	ch e . i m . b eo l . l i n
bebel	b e . b e l
leroy	l i . l o . i
caen	k a ng
fouquet	p u . k e
espy	e . s eu . p i
prado	p eu . l a . d o
quisling	k eu . b i . s eu l . l i ng
doppler	d o . p eu l . l eo
max	m a g . s eu
armstrong	a m . s eu . t eu . l o ng
sluter	s eu l . l wi . t e . l eu
benson	b e n . s eu n
clapton	k eu l . l ae b . t eu n
hacker	h ae . k eo
martini	g u . i . d o
harwood	h a . u . d eu
elion	e l . l i . eo n
paloma	p a l . l o . m a
sanaa	s a . n a
bizet	b i . j e
anwari	a n . wa . l i
gwen	g eu . we n
rubinstein	l u . b i n . s yu . t a . i n
tolle	t o l . l e
treitschke	t eu . l a . i . ch i . k e
oren	o . l e n
memphis	m e m . p i . s eu
lilienthal	l i l . l i . e n . s o l
carr	k a
lahti	l a . t i
borja	b o . l eu . h a
ithaca	i . t a . k a
nicol	n i . k o l
diogenes	d i . o . g e . n e . s eu
rawlings	l o l . l i ng . s eu
andreev	a n . d eu . l e . ye . p eu
osbourne	o . s eu . b o n
ingarden	i ng . g a . l eu . d e n
youngstown	yeo ng . s eu . t a . u n
canterbury	k ae n . t eo . b e . l i
felipe	p e l . l i . p e
nike	n a . i . k i
adam	a . d a m
venezuela	b e . n e . s u . e l . l a
bandeira	b a n . d e . i . l a
alina	a l . l i . n a
haren	h a . l e n
rameau	l a . m o
houssay	u . s a . i
uganda	u . g a n . d a
laud	l o . d eu
marlin	m a l . l i n
priscilla	p eu . l i . s i l . l a
torsten	t o l . s eu . t eo n
mistral	m i . s eu . t eu . l a l
south	s a . u . s eu
mate	m e . i . t eu
klitzing	k eu l . l i . ch i ng
evelyn	i . b e l . l i n
hulse	h eo l . s eu
king	k i ng
muzio	m u . ch i . o
barkley	b a . k eu l . l i
maior	m a . i . o . l eu
freitas	p eu . l e . i . t a . s eu
lepsius	l e b . s i . u . s eu
joinville	j u . ae ng . b i l
kazakhstan	k a . j a . h eu . s eu . t a n
magellan	m a . j e l . l a n
sobrero	s o . b eu . l e . l o
gudrun	g u . d eu . l u n
giacometti	j a . k o . m e . t i
albert	ae l . b eo . t eu
pauli	p a . u l . l i
desiderius	d e . s i . d e . l i . u . s eu
montpelier	m o n . t eu . p i l . l i . eo
haarlem	h a . l eu l . l e m
mercator	m e . l eu . k a . t o . l eu
bloemfontein	b eu l . l u m . p o n . t e . i n
hayes	h e . i . s eu
wittenberg	b i . t e n . b e . l eu . k eu
corbin	k o . b i n
oran	o . l a ng
dollar	d a l . l eo
baal	b a . a l
cornelis	k o . l eu . n e l . l i . s eu
honig	h o . n i . g eu
roche	l o . ch e
williamson	wi l . l i . eo m . s eu n
tangier	t ae n . j i . eo
tanzania	t a n . j a . n i . a
mariana	m a . l i . a . n a
vauvenargues	b o . b eu . n a . l eu . g eu
ignacio	i . g eu . n a . s i . o
humphreys	h eo m . p eu . l i . s eu
gallo	g a l . l o
knies	k eu . n i . s eu
hollingworth	h o l . l i ng . wo . s eu
luigi	l u . i . j i
wollaston	u l . l eo . s eu . t eo n
haldane	h o l . d e . i n
basu	b a . s u
avvakum	a . b a . k u m
leo	l e . o
camilo	k a . m i l . l o
teller	t e l . l eo
alfieri	a l . p i . e . l i
languedoc	l a ng . g eu . d o . k eu
viking	b a . i . k i ng
gumplowicz	g u m . p eu l . l o . b i . ch i
denny	d e . n i
ramirez	l a . m i . l e . j eu
bessarabia	b e . s a . l a . b i . a
grekov	g eu . l e . k o . p eu
novi	n o . b i
passow	p a . s yo . p eu
ali	a l . l i
rabi	l a . b i
steger	s yu . t e . g eo
keita	k e . i . t a
bayle	b e l
kuhnau	k u . n a . u
ulanova	u l . l a . n o . b a
manchester	m ae n . ch e . s eu . t eo
gascoigne	g ae . s eu . k o . i n
alameda	a l . l eo . m i . d a
storm	s yu . t o . l eu m
camden	k ae m . d eo n
ryder	l a . i . d eo
laforgue	l a . p o . l eu . g eu
hayden	h e . i . d eu n
portman	p o . t eu . m a n
gupta	g u b . t a
greenspan	g eu . l i n . s eu . p eo n
halas	h a l . l a . s eu
ahn	a n
binet	b i . n e
seymour	s e . i . m u . eo
krasnodar	k eu . l a . s eu . n o . d a . l eu
benares	b e . n a . l e . s eu
tolkien	t o l . k i n
bossuet	b o . s wi . e
hermann	h e . l eu . m a n
yogi	yo . g i
piccoli	p i . k o l . l i
lefebvre	l eu . p e . b eu . l eu
guadalcanal	g wa . d a l . k a . n a l
vivaldi	b i . b a l . d i
coleridge	k o l . l i . j i
rita	l i . t a
pope	p o . p eu
wickham	wi . k eo m
tajikistan	t a . j i . k i . s eu . t a n
otis	o . t i . s eu
zion	s i . o n
torrens	t o . l eo n . s eu
borchert	b o . l eu . h e . l eu . t eu
kolbenheyer	k o l . b e n . h a . i . eo
pettenkofer	p e . t e n . k o . p eo
ilyushin	i l . l yu . s i n
hodge	h o . j i
lennox	l e . n o g . s eu
cambodia	k a m . b o . d i . a
saroyan	s a . l o . i . eo n
anselmo	a n . s e l . m o
hitchings	h i . ch i ng . s eu
wim	b i m
steffen	s eu . t e . p eu n
aguascalientes	a . g wa . s eu . k a l . l i . e n . t e . s eu
lilly	l i l . l i
ellis	e l . l i . s eu
ranger	l e . i n . j eo
flynn	p eu l . l i n
karlin	k a l . l i n
claudius	k eu l . l a . u . d i . u . s eu
petropavlovsk	p e . t eu . l o . p a . b eu . l o . s eu . k eu
penny	p e . n i
manning	m ae . n i ng
zhaozhen	j a . o . j eo n
stanton	s eu . t ae n . t eo n
gale	g e . i l
heyerdahl	h e . wi . e . l eu . d a l
mazowiecki	m a . j o . b i . e . ch eu . k i
tana	t a . n a
oldham	o l . d eu . h ae m
montreal	m o n . t eu . l i . o l
gatto	g a . t o
moser	m o . j eo
petersburg	p e . t e . s eu . b u . l eu . k eu
azad	a . j a . d eu
camerarius	k a . m e . l a . l i . u . s eu
zbigniew	j eu . b i . g eu . n i . e . p eu
tobey	t o . b i
aileen	e . i l . l i n
scalapino	s eu . k a l . l a . p i . n o
dowland	d a . u l . l eo n . d eu
ungaretti	u ng . g a . l e . t i
rostow	l o . s eu . t o . u
severin	s e . b eo . l i n
frankel	p eu . l a n . k e l
nightingale	n a . i . t i ng . g e . i l
lille	l i l
claxton	k eu l . l e g . s eu . t eo n
mendel	m e n . d e l
perrault	p e . l o
ricken	l i . k e n
wedekind	b e . d e . k i n . t eu
bush	b u . s i
ruggiero	l u . j i . e . l o
valdes	b a l . d e . s eu
port_au_prince	p o . l eu . t o . p eu . l ae ng . s eu
ezekiel	e . j e . k i . e l
diller	d i l . l eo
dern	d eo n
lomonosov	l o . m o . n o . s o . p eu
lardner	l a . d eu . n eo
baumgarten	b a . u m . g a . l eu . t e n
garnett	g a . n e s
guyana	g a . i . a . n a
wallenstein	b a l . l e n . s yu . t a . i n
joni	j o . n i
volta	b o l . t a
wood	u . d eu
holberg	h o l . b e . l eu
haber	h a . b eo
singleton	s i ng . g eu l . t o n
galileo	g a l . l i l . l e . o
moshe	m o . s ye
gabon	g a . b o ng
swaziland	s eu . wa . j i l . l a n . d eu
connolly	k o . n eo l . l i
millay	m i l . l e . i
riley	l a . i l . l i
ellie	e l . l i
maritain	m a . l i . t ae ng
armand	a . l eu . m a ng
montana	m o n . t ae . n a
nikolaeva	n i . k o l . l a . e . b a
artigas	a . l eu . t i . g a . s eu
schwabe	s yu . b a . b e
columbia	k eo l . l eo m . b i . a
fielding	p i l . d i ng
selznick	s e l . j eu . n i g
silvester	s i l . b e . s eu . t eo
mikhailov	m i . h a . i l . l o . p eu
fuentes	p u . e n . t e . s eu
alan	ae l . l eo n
korolenko	k o . l o l . l e n . k o
paxton	p ae g . s eu . t eo n
ontario	o n . t a . l i . o
vavilov	b a . b i l . l o . p eu
cassandra	k a . s a n . d eu . l a
wynn	wi n
chandra	ch a n . d eu . l a
morena	m o . l e . n a
swart	s eu . wa . l eu . t eu
middlesex	m i . d eu l . s e g . s eu
worms	b o . l eu m . s eu
ohm	o m
roland	l o l . l a ng
lachmann	l a . h eu . m a n
duvivier	d wi . b i . b i . e
abrams	a . b eu . l a m . s eu
dean	d i n
pallas	p a l . l a . s eu
ciriaco	k eu . l i . a . k o
besancon	b eu . j a ng . s o ng
hardwicke	h a . d eu . wi . k e
magnus	m a . g eu . n u . s eu
bernal	b eo . n eo l
georgette	j o . j e s
paraguay	p a . l a . g wa . i
hart	h a . t eu
reid	l i . d eu
zannini	j ae . n i . n i
comoros	k o . m o . l o
courtois	k u . l eu . t u . a
james	j e . i m . s eu
bassi	b a . s i
bridie	b eu . l a . i . d i
lincoln	l i ng . k eo n
barstow	b a . l eu . s eu . t o . u
ostade	o . s eu . t a . d e
buckley	b eo . k eu l . l i
bohr	b o . eo
markov	m a . l eu . k o . p eu
teixeira	t e . i . s ye . i . l a
prosper	p eu . l o . s eu . p e . l eu
bophuthatswana	b o . p eu . t a . ch eu . wa . n a
bellow	b e l . l o
hering	h e . l i ng
mendes	m e n . d e . s eu
rupert	l u . p eo . t eu
laurencin	l o . l a ng . s ae ng
ratner	l e . t eu . n eo
anthony	a n . t o . n i . o
bethell	b e . d e l
wesley	we . s eu l . l i
koopmans	k u . p eu . m eo n . s eu
principe	p eu . l i n . s i . p e
chamberlin	ch e . i m . b eo l . l i n
villa	b i l . l a
bayard	b a . ya . l eu
robespierre	l o . b e . s eu . p i . e . l eu
gogh	g o . h eu
jonas	yo . n a . s eu
lombardo	l o m . b a . l eu . d o
engler	e ng . g eu l . l eo
ribbentrop	l i . b e n . t eu . l o . p eu
risa	l i . s a
say	s e
buchner	b u . h eu . n eo
dodd	d a . d eu
adrian	e . i . d eu . l i . eo n
argentina	a . l eu . h e n . t i . n a
valencia	b a l . l e n . s i . a
algeria	a l . j e . l i
wangchuck	wa ng . ch u . k eu
michelet	m i . s yu l . l e
ritchie	l i . ch i
wagner	b a . g eu . n eo
antunes	a n . t u . n e . s eu
matias	m a . t i . a . s eu
klein	k eu l . l a . i n
pourcel	p u . l eu . s e l
christ	g u . s e . j u
potapenko	p o . t a . p e n . k o
cennini	ch e n . n i . n i
adalbert	a . d a l . b e . l eu . t eu
dietrich	d i . t eu . l i . s i
worcester	u . s eu . t eo
julia	j u l . l i . a
mignon	m i . n yo ng
dard	d a . d eu
benn	b e n
rietveld	l i . t eu . b e l . t eu
tennyson	t e . n i . s eu n
ottawa	o . t a . wa
benton	b e n . t eo n
alan	a l . l a n
suzanne	s u . j a n
caruso	k a . l u . s o
teasdale	t i . j eu . d e . i l
kessler	k e . s eu l . l eo
eyck	e . i . k eu
canetti	k a . n e . t i
bouton	b u . t o ng
levy	l e . b i
gladstone	g eu l . l ae . d eu . s eu . t eo n
addams	ae . d eo m . s eu
wend	we n . d eu
paola	p a . o l . l a
hawthorn	h o . s o n
wolverhampton	u l . b eo . h ae m . t eo n
peggy	p e . g i
renard	l eu . n a . l eu
ansel	eo n . s e l
hopper	h o . p eo
georgia	g eu . l u . j i . a
shearer	s i . eo . l eo
connecticut	k o . n e . t i . k eo s
branson	b eu . l ae n . s eu n
madeira	m a . d e . i . l a
queens	k wi n . j eu
newman	n yu . m eo n
newcomb	n yu . k eo m
geneva	j e . n e . b a
ludwik	l u . d eu . wi g
haugland	h e . u l . l a n
erickson	e . l i g . s eu n
ambrosius	a m . b eu . l o . s i . u . s eu
fini	p i . n i
hendrickson	h e n . d eu . l i g . s eu n
vella	b e l . l a
boyd	b o . i . d eu
hunker	h a n . k a
charlotte	s ya l . l eo s
tahiti	t a . h i . t i
dolce	d o l . ch e
arena	a . l e . n a
mata	m a . t a
neville	n e . b i l
marius	m a . l i . u . s eu
thayer	s e . i . eo
ullman	u l . m a n
hanzi	h a n . jj eu
jaruzelski	ya . l u . j e l . s eu . k i
dekker	d e . k eo
pomponazzi	p o m . p o . n a . ch i
lacey	l e . i . s i
osman	o . s eu . m a n
hans	h a n . s eu
schally	s ya l . l i
page	p e . i . j i
etienne	e . t i . e n
anatole	a . n a . t o l
hargreaves	h a . g eu . l i . b eu . s eu
rosse	l o . s eu
denise	d e . n i . j eu
sanguinetti	s a ng . g i . n e . t i
wight	wa . i . t eu
peterson	p i . t eo . s eu n
calderwood	k a l . d eo . u . d eu
shapley	s yae . p eu l . l i
posada	p o . s a . d a
juma	j u . m a
casper	k ae . s eu . p eo
cadillac	k ae . d i l . l a g
brady	b eu . l ae . d i
whittall	h wi s . t o l
vecellio	b e . ch e l . l i . o
lodi	l o . d i
richardson	l i . ch eo . d eu . s eu n
albania	a l . b a . n i . a
rudolf	l u . d o l . p eu
pierluigi	p i . e . l eu l . l u . i . j i
kirov	k i . l o . p eu
daisy	d a . i . s i
gibson	g i . b eu . s eu n
martin	m a . l eu . t i n
arnaud	a . l eu . n o
bryce	b eu . l a . i . s eu
prishvin	p eu . l i . s yu . b i n
helm	h e l . l eu m
hoskins	h o . s eu . k i n . s eu
virtanen	b i . l eu . t a . n e n
lucy	l u . s i
wheelock	h wi l . l a g
durham	d eo . l eo m
umberto	u m . b e . l eu . t o
josephus	yo . s e . p u . s eu
ann	ae n
encke	e ng . k e
touraine	t u . l e n
