auden	o . d eu n
pauker	p a . u . k e . l eu
daniel	d a . n i . e l
denis	d e . n i . s eu
conrad	k o n . l a . d eu
ransom	l ae n . s eo m
athos	e . i . s o . s eu
dedekind	d e . d e . k i n . t eu
musil	m u . j i l
bergen	b e . l eu . g e n
pisanello	p i . s a . n e l . l o
bartolommeo	b a . l eu . t o l . l o m . m e . o
pollack	p o l . l a g
blunt	b eu l . l eo n . t eu
kroeber	k eu . l o . b eo
christina	k eu . l i . s eu . t i . n a
simmons	s i . m o n . j eu
cornwell	k o n . wo l
kyrgyzstan	k i . l eu . g i n . s eu . s eu . t a n
west	we . s eu . t eu
palikir	p a l . l a . k i . l eu
diouf	d i . u . p eu
poisson	p u . a . s o ng
minsk	m i n . s eu . k eu
bahr	b a . l eu
rademacher	l a . d e . m a . h eo
scala	s eu . k a l . l a
ashkhabad	a . s yu . h a . b a . t eu
mojave	m o . h a . b i
behaim	b e . h a . i m
wieniawski	b i . e . n i . a . p eu . s eu . k i
appel	a . p e l
masaccio	m a . s a . ch o
lansing	l ae n . s i ng
sorokin	s o . l o . k i n
glendale	g eu l . l e n . d e . i l
deaver	d i . b eo
caputo	k a . p u . t o
mariano	m a . l i . a . n o
mccann	m ae g . k ae n
helgeland	h e l . g eo l . l eo n . d eu
khabarovsk	h a . b a . l o . p eu . s eu . k eu
naha	n a . h a
gale	g e . i l
flesch	p eu l . l e . s wi
pichon	p i . s yo ng
johnstown	j o n . s eu . t a . u n
brittan	b eu . l i . t eu n
riemenschneider	l i . m e n . s yu . n a . i . d eo
morgagni	m o . l eu . g a . n i
virchow	p i . l eu . h o
entebbe	e n . t e . b e
monmouth	m o n . m eo . s eu
firth	p eo . s eu
alam	a l . eo m
decker	d e . k eo
howe	h a . u
sterne	s eu . t eo n
almqvist	a l . l eu m . k eu . b i . s eu . t eu
boethius	b o . i . t i . u . s eu
berthold	b e . l eu . t o l . t eu
seifert	s a . i . p e . l eu . t eu
tatum	t e . i . t eo m
cattell	k eo . t e l
davidoff	d ae . b i . d o . p eu
luanda	l u . a n . d a
louis	l u . i . s eu
jenny	j e . n i
debs	d e . b eu . s eu
insel	i n . s e l
pontoppidan	p o n . t o . p i . d a n
magdalena	m a g . d a l . l e . n a
raymond	l e . m o ng
arden	a . d eu n
angelou	ae n . j e l . l u
rodrigues	l o . d eu . l i . g e . s eu
enos	e . n o . s eu
theodor	t e . eo . d o . eo
schleicher	s yu l . l a . i . h eo
lipps	l i b . s eu
randolph	l ae n . d o l . p eu
despiau	d e . s eu . p i . o
banville	b a ng . b i l
jeans	j i n . s eu
gompers	g o m . p eo . s eu
noto	n o . t o
sanaa	s a . n a
south	s a . u . s eu
wallace	wo l . l i . s eu
pregl	p eu . l e . g eu l
saran	s a . l a n
sharon	s ya . l o n
spontini	s eu . p o n . t i . n i
humphreys	h eo m . p eu . l i . s eu
buhari	b u . h a . l i
habermas	h a . b eo . m a . s eu
hendrickson	h e n . d eu . l i g . s eu n
sokoloff	s o . k o l . l o . p eu
lama	l a . m a
herzog	h e . eo . ch o . k eu
riefenstahl	l i . p e n . s yu . t a l
sharif	s ya . l i . p eu
walcott	wo l . k eo s
eddie	e . d i
shchepkin	s i . ch e b . k i n
gainsborough	g e . i n . j eu . b eo . l eo
feldstein	p e l . d eu . s eu . t a . i n
nassau	n a . s a . u
ireland	a . i l . l ae n . d eu
lean	l i n
hegel	h e . g e l
lubin	l u . b i n
holger	h o l . g e . l eu
boise	b o . i . s i
utrecht	wi . t eu . l e . h eu . t eu
arab	a . l a b
morgan	m o . l eu . g eo n
gossen	g o . s e n
stokowski	s eu . t o . k o . p eu . s eu . k i
salih	ss a l . l i . h eu
gattuso	g a . t u . s o
altman	o l . t eu . m eo n
medici	m e . d i . ch i
hearn	h o n
dornbusch	d o n . b u . s i
pearl	p eo l
sonya	s o . n ya
casper	k ae . s eu . p eo
daphne	d a . p eu . n e
redford	l e . d eu . p eo . d eu
dickens	d i . k i n . j eu
basseterre	b a . s eu . t e . l eu
augustine	eo . g eo . s eu . t i n
kemal	k e . m a l
michael	m a . i . k eu l
elaine	i l . l e . i n
zaragoza	s a . l a . g o . s a
camden	k ae m . d eo n
christ	g u . s e . j u
lobe	l o . b e
ratzenhofer	l a . ch e n . h o . p eo
francke	p eu . l a ng . k e
southey	s a . u . d i
beckmann	b e . k eu . m a n
jevons	j e . b eo n . s eu
lilongwe	l i l . l o ng . g we
kursk	k u . l eu . s eu . k eu
knies	k eu . n i . s eu
beddoes	b e . d o . s eu
shockley	s yo . k eu l . l i
smollett	s eu . m o l . l e s
saillant	s a . ya ng
theo	t e . o
wickham	wi . k eo m
kilpinen	k i l . p i . n e n
brunat	b eu . l wi . n a
yala	ya l . l a
lyle	l a . i l
goodman	g u s . m ae n
comte	k o ng . t eu
sofia	s o . p i . a
andes	a n . d e . s eu
ion	i . o n
churchill	ch eo . ch i l
cueva	k u . e . b a
baruch	b a . l u . k eu
ricken	l i . k e n
pushkin	p u . s i . k i n
aldrin	o l . d eu . l i n
goodnow	g u s . n o . u
werfel	b e . l eu . p e l
laredo	l a . l e . d o
hart	h a . t eu
laurens	l o . l a ng . s eu
clarendon	k eu l . l ae . l eo n . d eo n
shoup	s yu . p eu
pitt	p i . t eu
kimberly	k i m . b eo l . l i
sylvester	s i l . b e . s eu . t eo
haneke	h a . n e . k e
gilles	j i l . s eu
lander	l ae n . d eo
kremer	k eu . l e . m eo
szigeti	s i . g e . t i
frenchman	p eu . l a ng . s eu . i n
mauriac	m o . l i . a g
key	k e . i
christa	k eu . l i . s eu
del	d e l
bodo	b o . d o
taine	t e n
franken	p eu . l a ng . k e n
halma	h ae l . m eo
copland	k o . p eu l . l ae n . d eu
mobile	m o . b a . i l
schlick	s yu l . l i . k eu
forst	p o . l eu . s eu . t eu
jaruzelski	ya . l u . j e l . s eu . k i
vos	b o . s eu
kristin	k eu . l i . s eu . t i n
doha	d o . h a
samoa	s a . m o . a
hamel	h a . m e l
london	l eo n . d eo n
kipling	k i . p eu l . l i ng
coolidge	k u l . l i . j i
france	p eu . l a ng . s eu
griffiths	g eu . l i . p i . s eu
duclos	d wi . k eu l . l o
adorno	a . d o . l eu . n o
lev	ye . p eu
polo	p o l . l o
freiligrath	p eu . l a . i l . l i . g eu . l a . t eu
dundee	d eo n . d i
stein	s yu . t a . i n
northampton	n o . s ae m . p eu . t eo n
gomes	g o . m e . s eu
cara	k a . l a
erikson	e . l i g . s eu n
tricia	t eu . l i . s i . a
johannesburg	yo . h a . n e . s eu . b eo . g eu
zak	j ae g
brooks	b eu . l u g . s eu
imre	i m . l e
hudson	h eo . d eu . s eu n
herford	h e . eo . p o . t eu
kaganovich	k a . g a . n o . b i . ch i
anderson	ae n . d eo . s eu n
bagehot	b ae . j eo s
rod	l o . d eu
kirchner	k i . l eu . h i . n eo
basov	b a . s o . p eu
woodrow	u . d eu . l o
garvey	g a . b i
baxter	b ae g . s eu . t eo
katherine	k ae . s eo . l i n
andre	a n . d eu . l e
voltaire	b o l . t e . l eu
silber	s i l . b eo
jawara	j a . wa . l a
madeline	m ae . d eu l . l i n
nadine	n e . i . d i n
lind	l i n . d eu
ker	k eo
lina	l i . n a
vinogradoff	b i . n o . g eu . l a . d o . p eu
brynner	b eu . l i . n eo
pietro	p i . e . t eu . l o
buchenwald	b u . h e n . b a l . t eu
graaf	g eu . l a . p eu
jacques	j a . k eu
freda	p eu . l e . d a
hannah	h ae . n a
parish	p ae . l i . s wi
rosalie	l o . j a l . l i
wrightson	l a . i . t eu . s eu n
windaus	b i n . d a . u . s eu
seyni	s e . i . n i
herz	h e . l eu . ch eu
debbie	d e . b i
barlach	b a . l eu l . l a . h eu
britt	b eu . l i s
viotti	b i . o . t i
kann	k a n
hansen	h a n . s e n
cronaca	k eu . l o . n a . k a
picasso	p i . k a . s o
scranton	s eu . k eu . l ae n . t eo n
say	s e
khartoum	h a . l eu . t u m
serafimovich	s e . l a . p i . m o . b i . ch i
allah	a l . l a
smeaton	s eu . m i . t eo n
hedy	h e . d i
boulanger	b u l . l a ng . j e
moshe	m o . s ye
espronceda	e . s eu . p eu . l o n . s e . d a
frits	p eu . l i . ch eu
nouvel	n u . b e l
rodgers	l o . j eo . s eu
noel	n o . e l
helga	h e l . g a
rolls	l o l . s eu
gold	g o l . d eu
mozambique	m o . j a m . b i . k eu
william	wi l . l i . eo m
paris	p a . l i
montgomery	m o ng . g o . m e . l i
elena	e l . l e . n a
gaza	g a . j a
kenny	k e . n i
catilina	k a . t i l . l i . n a
celia	s e l . l i . a
berchem	b eo . ch e m
glickman	g eu l . l i . k eu . m eo n
adama	a . d a . m a
goldmann	g o l . d eu . m a n
witt	wi s
perrier	p e . l i . e
normandy	n o . l eu . m a ng . d i
eiffel	e . p e l
lai	l a . i
shield	s wi l . d eu
carlo	k a . l eu l . l o
burstein	b eo . s eu . t a . i n
gaia	g a . i . a
daryl	d ae . l i l
disraeli	d i . j eu . l e . i l . l i
morelli	m o . l e l . l i
piel	p i . e l
stephenson	s eu . t i . b eu n . s eu n
freytag	p eu . l a . i . t a . k eu
steinem	s eu . t a . i . n eo m
gapon	g a . p o n
sluter	s eu l . l wi . t e . l eu
turin	t u . l i n
bolkiah	b o l . k i . a
werth	we l . s eu
macleod	m ae . k eu l . l a . u . d eu
abilene	ae . b i l . l i n
alfieri	a l . p i . e . l i
buch	b u . h eu
cournot	k u . l eu . n o
dartmouth	d a . t eu . m eo . s eu
lahti	l a . t i
semper	j e m . p eo
bandaranaike	b a n . d a . l a . n a . i . k e
boring	b o . l i ng
gryphius	g eu . l i . p i . u . s eu
eysenck	a . i . s eo n . k eu
eckardt	e . k a . l eu . t eu
samantha	s a . m a n . d a
gisela	j i . j e l . l a
lardner	l a . d eu . n eo
peres	p e . l e . s eu
fullerton	p u l . l eo . t eo n
pershing	p eo . s i ng
nina	n i . n a
cassandra	k a . s a n . d eu . l a
abell	a . b e l
whymper	h wi m . p eo
rochester	l o . ch e . s eu . t eo
nadia	n a . d i . a
mclaren	m ae g . l a . l e n
friche	p eu . l i . ch e
kivi	k i . b i
arjun	a . j u n
zelaya	j e . l a . ya
laurel	l a . u . l e l
gable	g e . i . b eu l
nika	n i . k a
lorrain	l o . l ae ng
kirsten	k eo . s eu . t i n
kepler	k e . p eu l . l eo
marr	m a . l eu
gettysburg	g e . t i . j eu . b eo . g eu
holl	h o l
bacon	b e . i . k eo n
fern	p eo n
casanova	k a . s a . n o . b a
rogers	l o . j eo . s eu
pauli	p a . u l . l i
kapp	k a . p eu
kensington	k e n . j i ng . t eo n
hanover	h a . n o . b eo
seton	s i . t eo n
finland	p i n . l a n . d eu
murillo	m u . l i . yo
larson	l a . s eu n
arminius	a . l eu . m i . n i . u . s eu
ohio	o . h a . i . o
horatio	h eo . l e . i . s yo
zapata	s a . p a . t a
thyssen	t i . s e n
wheatstone	h wi . t eu . s eu . t o n
lanson	l a ng . s o ng
scherman	s ye . l eu . m a n
krom	k eu . l o m
claes	k eu l . l a . s eu
nie	n ye
copernicus	k o . p e . l eu . n i . k u . s eu
picard	p i . k a . l eu
grasse	g eu . l ae . s eu
carlyle	k a l . l a . i l
baccelli	b a . s e l . l i
kitchener	k i . ch i . n eo
midway	m i . d eu . we . i
dale	d e . i l
massimo	m a . s i . m o
drake	d eu . l e . i . k eu
willy	b i l . l i
patagonia	p a . t a . g o . n i . a
magyar	m a . j a . l eu
langer	l a ng . g eo
salvador	s a l . b a . d o . l eu
drury	d eu . l u . eo . l i
ribera	l i . b e . l a
gatto	g a . t o
wolfram	wo l . p eu . l a m
mahoney	m a . h o . n i
corsica	k o . l eu . s i . k a
helge	h e l . g e
konstantinos	k o n . s eu . t a n . t i . n o . s eu
rene	l eu . n e
veronica	b e . l o . n i . k a
veronese	b e . l o . n e . s e
doreen	d o . l i n
mckay	m ae g . k e . i
baldus	b a l . d u . s eu
charles	ch a l . s eu
glenn	g eu l . l e n
cesarotti	ch e . s a . l o . t i
lou	l u
gabrielle	g a . b eu . l i . e l
hansard	h ae n . s eo . d eu
hearst	h eo . s eu . t eu
gerald	j e . l eo l . d eu
anwari	a n . wa . l i
chesterton	ch e . s eu . t eo . t eo n
sylvain	s i l . b ae ng
duisburg	d wi . s eu . b u . l eu . k eu
harte	h a . t eu
sean	s yo n
melba	m e l . b a
henry	h e n . l i
woodworth	u . d eu . wo . s eu
lothian	l o . d i . eo n
nathaniel	n eo . d ae . n i . eo l
hobhouse	h o b . h a . u . s eu
goldberg	g o l . d eu . b eo . g eu
gillette	j i l . l e s
bouillon	b u . i . yo ng
latvia	l a . t eu . b i . a
guadalupe	g wa . d a l . l u . p e
dreyfus	d eu . l e . p wi . s eu
lafontaine	l a . p o ng . t e n
antunes	a n . t u . n e . s eu
valerie	b a l . l e . l i
xavier	j a . b i . e . l eu
ness	n e . s eu
myburgh	m a . i . b eo . g eu
robinson	l o . b i n . s eu n
barthes	b a . l eu . t eu
brangwyn	b eu . l ae ng . g wi n
odilon	o . d i l . l o ng
chissano	s i . s a . n o
veneziano	b e . n e . ch i . a . n o
raul	l a . u l
blunden	b eu l . l eo n . d eo n
pople	p o . p eu l
lahore	l a . h o . l eu
beust	b o . i . s eu . t eu
baylor	b ae . i l . l eo
sauvy	s o . b i
chaumont	s yo . m o ng
krim	k eu . l i m
albo	ae l . b o
mcgrath	m ae g . g eu . l a . s eu
heseltine	h e . s eu l . t a . i n
huysmans	wi . s eu . m a ng . s eu
quintana	j i n . t a . n a
conrad	k o n . l ae . d eu
poliziano	p o l . l i . ch i . a . n o
merritt	m e . l i . t eu
stoyanov	s eu . t o . ya . n o . p eu
most	m o . s eu . t eu
quesada	k we . s eu . d a
victor	b i g . t eo
hedin	h e . d i n
schmidt	s yu . m i . t eu
verhoeven	b eo . h o . b e n
blackburn	b eu l . l ae g . b eo n
marino	m a . l i . n o
radbruch	l a . d eu . b eu . l u . h eu
osborne	o . j eu . b eo n
mariana	m a . l i . a . n a
glass	g eu l . l a . s eu
jolivet	j o l . l i . b e
valois	b a l . l u . a
belgrade	b e l . g eu . l a . d eu
dobson	d o . b eu . s eu n
norbert	n o . l eu . b e . l eu . t eu
hayden	h e . i . d eu n
ardennes	a . l eu . d e n
chautemps	s yo . t a ng
mahan	m eo . h ae n
felicia	p e l . l i . s i . a
priscilla	p eu . l i . s i l . l a
siegen	j i . g e n
clapeyron	k eu l . l a . p e . l o ng
gallo	g a l . l o
foucault	p u . k o
kant	k a n . t eu
chester	ch e . s eu . t eo
montero	m o n . t e . l o
nils	n i l . s eu
ochirbat	o . ch i . l eu . b a . t eu
alton	a l . t o n
korolenko	k o . l o l . l e n . k o
akhmatova	a . h eu . m a . t o . b a
mayhew	m e . i . h yu
nilson	n i l . s o n
bishop	b i . s yo b
rautio	l o . t i . o
irwin	eo . wi n
wolcott	wo l . k o . t eu
podolsky	p o . d o l . s eu . k i
winifred	wi n . p eu . l e . d eu
erfurt	e . l eu . p u . l eu . t eu
marshall	m a . s yeo l
messer	m e . s eo
stakhanov	s eu . tt a . h a . n o . p eu
hinds	h a . i n . j eu
solana	s o l . l a . n a
tavares	t a . b a . l e . s eu
pieter	p i . t eo
lisbon	l i . s eu . b o n
sweeney	s eu . wi . n i
tweed	d e . d o
pepe	p e . p e
zambezi	j a m . b e . j i
anton	a n . t o n
quasimodo	k wa . s i . m o . d o
arrhenius	a . l e . n i . u . s eu
gleysteen	g eu l . l a . i . s eu . t i n
feynman	p a . i n . m eo n
strand	s eu . t eu . l ae n . d eu
luxemburg	l u g . s e m . b u . l eu . k eu
housman	h a . u . s eu . m eo n
shaftesbury	s yae . p eu . ch eu . b e . l i
perret	p e . l e
candela	k a ng . d e l . l a
lvov	l i . b o . p eu
oren	o . l e n
livius	l i . b i . u . s eu
chappe	s ya . p eu
ob	o . b eu
maistre	m e . s eu . t eu . l eu
pippin	p i . p i n
algeciras	a l . h e . s i . l a . s eu
gladkov	g eu l . l a s . k o . p eu
faulkner	p o . k eu . n eo
alessandro	a l . l e . s a n . d eu . l o
remo	l e . m o
flanagan	p eu l . l ae . n eo . g eo n
freitas	p eu . l e . i . t a . s eu
ramo	l a . m o
tan	t a n
garland	g a l . l eo n . d eu
gould	g u l . d eu
compton	k o m . p eu . t eo n
benjamin	b ae ng . j a . m ae ng
sim	s i m
pike	p a . i . k eu
harnack	h a . l eu . n a . k eu
bethel	b e . d e l
ozenfant	o . j a ng . p a ng
marianne	m a . l i . a n . n eu
verwey	p e . l eu . we . i
carlson	k a l . s eu n
lautner	l o . t eu . n eo
spranger	s yu . p eu . l a ng . g eo
melanie	m e l . l a . n i
burnett	b eo . n e s
niki	n i . k i
jacobs	j e . i . k o b . s eu
dmitry	d eu . m i . t eu . l i
ast	a . s eu . t eu
ashcroft	ae . s yu . k eu . l o . p eu . t eu
agnew	ae . g eu . n yu
wycherley	wi . ch eo l . l i
welch	we l . ch i
shepherd	s e . p eo . d eu
sansovino	s a n . s o . b i . n o
galton	g o l . t eo n
mordecai	m o . l eu . d eu . g ae
meany	m i . n i
puente	p u . e n . t e
desai	d e . s a . i
altamira	a l . t a . m i . l a
fitzpatrick	p i . ch eu . p ae . t eu . l i g
ripley	l i . p eu l . l i
baum	b a . u m
packer	p ae . k eo
bocage	b o . k a . j e
belcher	b e l . ch eo
spada	s eu . p a . d a
horace	h o . l a . t i . u . s eu
besancon	b eu . j a ng . s o ng
salas	s a l . l a . s eu
clara	k eu l . l a . l a
boyce	b o . i . s eu
kantor	k ae n . t eo
kaverin	k a . b e . l i n
indira	i n . d i . l a
navarro	n a . b a . l o
nevelson	n i . b e l . s eu n
george	g e . o . l eu . g e
aurora	a . u . l o . l a
helena	h e l . l e . n a
ivan	i . b a n
roussel	l u . s e l
milhaud	m i . yo
horacio	h o . l a . s i . o
durand	d yu . l a n . d eu
diallo	d i . ae l . l o
pizarro	p i . s a . l o
miguel	m i . g e l
polevoi	p o l . l e . b o . i
harrow	h ae . l o
lipmann	l i . p eu . m eo n
barranquilla	b a . l a ng . k i . ya
buxtehude	b u g . s eu . t e . h u . d e
shipley	s i . p eu l . l i
lauder	l o . d eo
ayer	e . i . eo
reykjavik	l e . i . k ya . b i . k eu
bowker	b o . u . k eo
schiele	s i l . l e
eck	e . k eu
dias	d i . eo . s eu
offenbach	o . p e n . b a . h eu
aston	ae . s eu . t eo n
mate	m e . i . t eu
adolphe	a . d o l . p eu
aguirre	a . g i . l e
flory	p eu l . l o . l i
hebrides	h e . b eu . l i . d i . s eu
henri	a ng . l i
razin	l a . j i n
gambia	g a m . b i . a
clement	k eu l . l e . m e n . t eu
stephens	s eu . t i . b eu n . s eu
boris	b o . l i . s eu
thomsen	t o m . s e n
barrie	b ae . l i
pete	p i . t eu
ord	o . d eu
christenson	k eu . l i . s eu . t eo n . s eu n
bratislava	b eu . l a . t i . s eu l . l a . b a
pavlova	p a . b eu l . l o . b a
pirelli	p i . l e l . l i
stilwell	s eu . t i l . we l
mccoy	m ae g . k o . i
vogt	p o . k eu . t eu
chamisso	s ya . m i . s o
rudolph	l u . d o l . p eu
vientiane	b i . e n . t i . a n
illinois	i l . l i . n o . i
beveridge	b e . b eo . l i . j i
butterfield	b eo . t eo . p i l . d eu
nukualofa	n u . k u . a l . l o . p a
indiana	i n . d e . e . n a
alfredo	a l . p eu . l e . d o
calder	k o l . d eo
bidwell	b i . d eu . we l
scheidemann	s ya . i . d e . m a n
stiglitz	s eu . t i . g eu l . l i . ch eu
kafka	k a . p eu . k a
slobodan	s eu l . l o . b o . d a n
cruyff	k eu . l u . i . p eu
denzel	d e n . j eo l
toscanelli	t o . s eu . k a . n e l . l i
botsford	b o . ch eu . p o . d eu
toffler	t o . p eu l . l eo
debussy	d eu . b wi . s i
orr	o . eo
ferrer	p e . l eo
axel	a g . s e l
sikorski	s i . k o . l eu . s eu . k i
watson	wa s . s eu n
frederic	p eu . l e . d eo . l i g
piscator	p i . s eu . k a . t o . l eu
laforgue	l a . p o . l eu . g eu
havel	h a . b e l
ray	l e . i
baltimore	b o l . t i . m o . eo
wallon	wa l . l o ng
pareto	p a . l e . t o
read	l i . d eu
loren	l o . l e n
primakov	p eu . l i . m a . k o . p eu
eyring	a . i . l i ng
fiennes	p a . i n . j eu
macrae	m ae g . l e . i
indus	i n . d eo . s eu
ehrenfeld	e . l eo n . p e l . d eu
pisarev	p i . s a . l e . p eu
thornton	s o n . t eu n
edwin	e . d eu . wi n
caetano	kk a . e . tt a . n u
detroit	d i . t eu . l o . i . t eu
kaplan	k ae . p eu l . l a n
labaki	l a . b a . k i
archer	a . ch eo
szilard	j i l . l a . d eu
braine	b eu . l e . i n
hoche	o . s yu
namur	n a . m u . l eu
bragg	b eu . l ae . g eu
bunsen	b u n . j e n
bertini	b eo . t i . n i
eusebio	e . u . s e . b i . u
rwanda	l eu . wa n . d a
kurt	k u . l eu . t eu
dornier	d o . l eu . n i . e
brescia	b eu . l e . s i . a
suess	j wi . s eu
abir	a . b i . l eu
zeman	j e . m a n
parry	p e . l i
hanson	h ae n . s eu n
mahmoud	m a . m u . d eu
bergengruen	b e . l eu . g e n . g eu . l wi n
urban	u . l eu . b a n
lauren	l o . l e n
bourgeois	b u . l eu . j u . a
hartle	h a . t eu l
winfried	wi n . p eu . l e . d eu
villon	b i . yo ng
percival	p eo . s i . b eo l
rehnquist	l e n . k wi . s eu . t eu
benda	b a ng . d a
clough	k eu l . l a . p eu
motta	m o . t a
goldwyn	g o l . d eu . wi n
symonds	s i . m eo n . j eu
manhattan	m ae n . h ae . t eu n
alban	a l . b a n
diefenbaker	d i . p e n . b e . i . k eo
blake	b eu l . l e . i . k eu
almond	a l . m o n . d eu
ashley	ae . s yu l . l i
daugherty	d o . h eo . t i
nobel	n o . b e l
wilder	wa . i l . d eo
tyndall	t i n . d eu l
potter	p o . t eo
lully	l wi l . l i
hamann	h a . m a n
jens	ye n . s eu
maxwell	m ae g . s eu . we l
india	i n . d i . a
mckenzie	m ae g . k e n . j i
rosenthal	l o . j e n . t a l
hamza	h a m . j a
fortune	p o . ch eo n
heifetz	h a . i . p e . ch eu
virgil	b eo . j i l
hench	h e n . ch i
philip	b i l . l i b
walpole	wo l . p o l
gabrieli	g a . b eu . l i . e l . l i
heckman	h e . k eu . m eo n
knut	k eu . n u . t eu
novoa	n o . b o . a
weber	we . b eo
bingham	b i ng . h ae m
hague	h e . i . g eu
fiorentino	p i . o . l e n . t i . n o
devon	d e . b eo n
whipple	h wi . p eu l
saar	j a . l eu
munk	m u ng . k eu
zinn	j i n
bordeaux	b o . l eu . d o
chambers	ch e . i m . b eo . s eu
einthoven	e . i n . t eu . h o . b e n
forsyth	p o . s a . i . s eu
bisset	b i . s e s
ferguson	p eo . g eo . s eu n
weiss	b a . i . s eu
omar	o . m a
koch	k o . h eu
scheler	s ye l . l eo
brandes	b eu . l a . d e . s eu
bohemia	b o . h e . m i . a
wood	u . d eu
dannemann	d a . n e . m a n
schwann	s yu . b a n
hibernia	h a . i . b eo . n i . a
yorke	yo . k eu
jamaica	j a . m e . i . k a
josephson	j o . j i . p eu . s eu n
steichen	s eu . t a . i . k eo n
hedtoft	h e . d eu . t o . p eu . t eu
speyer	s yu . p a . i . eo
brussels	b eu . l wi . s e l
beckett	b e . k e . t eu
maritain	m a . l i . t ae ng
stresemann	s yu . t eu . l e . j e . m a n
collett	k o l . l e . t eu
enver	e n . b e . l eu
jacobo	h a . k o . b o
wordsworth	wo . j eu . wo . s eu
banjul	b a n . j u l
olsen	o l . s eu n
italo	i . t a l . l o
parsons	p a . s eu n . s eu
swanson	s eu . wa n . s eu n
teague	t i . g eu
brooklyn	b eu . l u . k eu l . l i n
fulbright	p u l . b eu . l a . i . t eu
uribe	u . l i . b e
roland	l o l . l a n . d eu
salman	s a l . m a n
weinberger	wa . i n . b eo . g eo
lowie	l o . wi
cube	k yu . b i g
buffalo	b eo . p eo l . l o
farmington	p a . m i ng . t eo n
milne	m i l . l eu n
heim	h a . i m
karlfeldt	k a l . p e l . t eu
hobsbawm	h o b . s eu . b o m
seward	s yu . eo . d eu
harvey	h a . b i
drucker	d eu . l eo . k eo
farjeon	p a . j eo n
braga	b eu . l a . g a
serrano	s e . l a . n o
medawar	m e . d eo . wo
chandra	ch a n . d eu . l a
marcuse	m a . l eu . k u . j e
malik	m a l . l i . k eu
blass	b eu . l e . s eu
karajan	k a . l a . ya n
karsavina	k a . l eu . s a . b i . n a
cornelio	k o . l eu . n e l . l i . o
phelps	p e l . p eu . s eu
lorraine	l o . l e n
vigeland	b i . g e l . l a n
cellini	ch e l . l i . n i
tana	t a . n a
merz	m e . l eu . ch eu
michal	m a . i . k eu l
lang	l a ng
lukas	l u . k a . s eu
spitteler	s yu . p i . t e l . l eo
ellen	e l . l e n
sikorsky	s i . k o . l eu . s eu . k i
teller	t e l . l eo
haig	h e . i . g eu
annette	a . n e . t eu
obi	o . b i
leonard	l e . o . n a . d eu
vladimir	b eu l . l a . d i . m i . l eu
haarlem	h a . l eu l . l e m
kulik	k u l . l i . k eu
cramer	k eu . l ae . m eo
greg	g eu . l e . g eu
blaine	b eu l . l e . i n
djilas	j i l . l a . s eu
warren	wo . l eo n
lash	l ae . s wi
pyongyang	p yeo ng . ya ng
weddell	we . d eu l
wallach	b a l . l a . h eu
kohlrausch	k o l . l a . u . s yu
armando	a . l eu . m a n . d o
castiglione	k a . s eu . t i l . l i . o . n e
jonas	yo . n a . s eu
carlton	k a l . t eu n
isabella	i . s a . b e l . l a
mount	m a . u n . t eu
corbin	k o . b i n
batyushkov	b a . t yu . s yu . k o . p eu
grigorovich	g eu . l i . g o . l o . b i . ch i
ndiaye	n eu . j ya . ye
hopper	h o . p eo
christian	k eu . l i . s eu . ch eo n
viola	b i . o l . l a
ting	t i ng
chandrasekhar	ch a n . d eu . l a . s e . k a . l eu
dost	d o . s eu . t eu
black	b eu l . l ae g
vives	b i . b e . s eu
xenophon	k eu . s e . n o . p o n
stuart	s eu . t yu . eo . t eu
suarez	s u . a . l e . j eu
fritz	p eu . l i . ch eu
roque	l o . k e
firestone	p a . i . eo . s eu . t o n
lusaka	l u . s a . k a
kania	k a . n i . a
rudd	l eo . d eu
polynesia	p o l . l i . n e . s i . a
edison	e . d i . s eu n
burgess	b eo . j i . s eu
achilles	a . k i l . l e . s eu
oregon	o . l i . g eo n
zambia	j a m . b i . a
vega	b e . g a
nunn	n eo n
hanslick	h a n . s eu l . l i . k eu
fini	p i . n i
jade	j e . i . d eu
enoch	e . n o g
wolfrum	wo l . p eu . l eo m
townsend	t a . u n . s e n . d eu
ibrahim	i . b eu . l a . h i m
kilby	k i l . b i
radu	l a . d u
metastasio	m e . t a . s eu . t a . s i . o
ruo	l wo
sherriff	s ye . l i . p eu
brenan	b eu . l e . n eo n
ronan	l o . n a n
duluth	d eo l . l u . s eu
groethuysen	g eu . l e . t wi . j ae ng
nelson	n e l . s eu n
hubertus	h u . b e . l eu . t u . s eu
klondike	k eu l . l o n . d a . i . k eu
swan	s eu . wa n
byrd	b eo . d eu
andrea	a n . d eu . l e . a
moritz	m o . l i . ch eu
backhaus	b a . k eu . h a . u . s eu
hasenclever	h a . j e n . k eu l . l e . b eo
herb	h eo . b eu
vienna	b i . e n . n a
lord	l o . d eu
carla	k a l . l a
joanne	j o . ae n
eijkman	e . i . k eu . m a n
polly	p o l . l i
bayle	b e l
stolypin	s eu . t o l . l i . p i n
lilley	l i l . l i
frankfort	p eu . l ae ng . k eu . p eo . t eu
abdul	a b . d u l
cavour	k a . b o . u . l eu
belarus	b e l . l o . l u . s i
wyler	wa . i l . l eo
eichmann	a . i . h i . m a n
dina	d i . n a
rosebery	l o . j eu . b eo . l i
sickingen	j i . k i ng . g e n
minaux	m i . n o
whitney	h wi . t eu . n i
fort	p o . l eu
potanin	p o . t a . n i n
mogadishu	m o . g a . d i . s yu
inga	i ng . g a
sally	s ae l . l i
furmanov	p u . l eu . m a . n o . p eu
corneille	k o . l eu . n e . yu
milt	m i l . t eu
bergman	b eo . g eu . m eo n
reeves	l i . b eu . s eu
segni	s e . n i
dario	d a . l i . o
huggins	h eo . g i n . s eu
wernicke	b e . l eu . n i . k e
theodore	s i . eo . d o . eo
romeo	l o . m e . o
burnet	b eo . n e s
ponchielli	p o n . k i . e l . l i
beza	b e . j a
escudero	e . s eu . k u . d e . l o
noah	n o . a
mitterrand	m i . t e . l a ng
verga	b e . l eu . g a
laptev	l a b . t e . p eu
calvin	k a l . b ae ng
kruczkowski	k eu . l u . ch i . k o . p eu . s eu . k i
luba	l u . b a
fraser	p eu . l e . i . j eo
nigel	n a . i . j eo l
laurie	l o . l i
pam	p ae m
edmund	e . d eu . m u n . d eu
portman	p o . t eu . m a n
christopher	k eu . l i . s eu . t o . p eo
doisy	d o . i . j i
prus	p eu . l u . s eu
din	d i n
dora	d o . l a
ivanov	i . b a . n o . p eu
stanley	s eu . t ae n . l i
pierce	p i . eo . s eu
milos	m i l . l o . s eu
noether	n oe . t eo
asser	a . s e . l eu
cosa	k o . s a
apollinaire	a . p o l . l i . n e . l eu
zurich	ch wi . l i . h i
maurice	m o . l i . s eu
bayreuth	b a . i . l o . i . t eu
magellan	m a . j e l . l a n
charlotte	s ya l . l eo s
zhaozhen	j a . o . j eo n
cuthbert	k eo . s eu . b eo . t eu
chelmsford	ch e l . l eu m . s eu . p eo . d eu
fet	p e . t eu
bakhtin	b a . h eu . ch i n
lorenzo	l o . l e n . ch o
spemann	s yu . p e . m a n
caravaggio	k a . l a . b a . j o
ontario	o n . t a . l i . o
camdessus	k a ng . d eu . s wi
hulse	h eo l . s eu
gini	j i . n i
fonvizin	p o n . b i . j i n
lancashire	l ae ng . k eo . s yeo
carver	k a . b eo
teresa	t e . l e . s a
berry	b e . l i
ignatiev	i . g eu . n a . t i . ye . p eu
scofield	s eu . k o . p i l . d eu
zeeman	j e . m a n
manila	m a . n i l . l a
albania	a l . b a . n i . a
aruba	a . l u . b a
konstanz	k o n . s eu . t a n . ch eu
janusz	ya . n u . s i
halas	h a l . l a . s eu
iceland	a . i . s eu l . l a n . d eu
manzoni	m a n . ch o . n i
easton	i . s eu . t eo n
wigner	wi . g eu . n eo
highland	h a . i . l ae n . d eu
palgrave	p o l . g eu . l e . i . b eu
brady	b eu . l ae . d i
arnauld	a . l eu . n o
quesnay	k e . n e
junqueiro	j u n . k e . i . l u
colin	k o l . l ae ng
sebastian	s eo . b ae . s eu . ch eo n
canada	k ae . n a . d a
frankland	p eu . l ae ng . k eu l . l ae n . d eu
surikov	s u . l i . k o . p eu
dayton	d e . i . t eo n
marvell	m a . b eo l
spyri	s yu . p i . l i
winch	wi n . ch i
torrens	t o . l eo n . s eu
calhoun	k a l . h u n
fisk	p i . s eu . k eu
endre	e n . d eu . l e
dunant	d wi . n a ng
hill	h i l
stoltenberg	s yu . t o l . t e n . b e . l eu . k eu
rossi	l o . s i
dimitri	d i . m i . t eu . l i
shawn	s yo n
schawlow	s yo l . l o
juliet	j u l . l i . e s
gough	g o . p u
schultz	s yu l . ch eu
dowdeswell	d o . d e . s eu . b e l
salt	s o l . t eu
sitwell	s i . t eu . we l
millikan	m i l . l i . k eo n
lehmbruck	l e m . b eu . l u . k eu
schrieffer	s yu . l i . p eo
trevelyan	t eu . l i . b e l . l i . eo n
sagan	s e . i . g eo n
adriano	a . d eu . l i . a . n o
chung	j eo ng
minogue	m i . n o . g eu
rydberg	l wi . d eu . b e . l i
davisson	d e . i . b i . s eu n
pablo	p a . b eu l . l o
godard	g o . d a . l eu
clearwater	k eu l . l i . eo . wo . t eo
kenneth	k e . n i . s eu
holley	h o l . l i
stahl	s yu . t a l
ella	e l . l a
clemens	k eu l . l e . m e n . s eu
wiesel	b i . s e l
milford	m i l . p eo . d eu
poe	p o
palade	p eo l . l e . i . d eu
hort	h o l . t eu
donat	d o . n a . t eu
piaf	p i . a . p eu
peruzzi	p e . l u . ch i
miller	m i l . l eo
lelewel	l e l . l e . b e l
rumsfeld	l eo m . j eu . p e l . d eu
mance	m ae n . s eu
pettit	p e . t i . t eu
berenson	b e . l eo n . s eu n
gogarten	g o . g a . l eu . t e n
lutoslawski	l u . t o . s eu l . l a . p eu . s eu . k i
goddard	g o . d eo . d eu
schumann	s yu . m a n
berzelius	b e . l eu . s e l . l i . u . s eu
brenner	b eu . l e . n eo
bedford	b e . d eu . p eo . d eu
mann	m a n
tang	d a ng
spener	s yu . p e . n eo
asam	a . j a m
bernhard	b eo n . h a . d eu
audubon	o . d yu . b o n
seychelles	s e . i . s ye l
lacey	l e . i . s i
holberg	h o l . b e . l eu
silvester	s i l . b e . s eu . t eo
peel	p i l
manet	m a . n e
rome	l o . m a
danny	d ae . n i
brutus	b eu . l u . t u . s eu
bougainville	b u . g eo n . b i l
jones	j o n . s eu
capote	k eo . p o . t i
julianus	yu l . l i . a . n u . s eu
rios	l i . o . s eu
henrik	h e n . l i . k eu
muzio	m u . ch i . o
naples	n a . p o l . l i
michel	m i . s ye l
kira	k i . l a
azad	a . j a . d eu
bangemann	b a ng . g e . m a n
laski	l ae . s eu . k i
jaroslav	ya . l o . s eu l . l a . p eu
sarton	s a . t eo n
franz	p eu . l a n . ch eu
couperin	k u . p eu . l ae ng
nurmi	n u . l eu . m i
gibbs	g i . b eu . s eu
theobald	s i . eo . b eo l . d eu
brauns	b eu . l o n . j eu
erick	e . l i g
lilly	l i l . l i
gloucester	g eu l . l o . s eu . t eo
hull	h eo l
harrington	h ae . l i ng . t eo n
vico	b i . k o
carrillo	k a . l i l . l o
manger	m ae ng . g eo
trieste	t eu . l i . e . s eu . t e
borges	b o . l eu . h e . s eu
schwan	s yu . b a n
gayoom	g a . yu m
frisch	p eu . l i . s yu
hue	wi . e
ferrara	p e . l a . l a
greco	g eu . l e . k o
cossa	k o . s a
re	l e
margarita	m a . g a . l i . t a
sakharov	s a . h a . l o . p eu
hawthorn	h o . s o n
steiner	s yu . t a . i . n eo
gunderson	g eo n . d eo . s eu n
bellman	b e l . m a n
hebra	h e . b eu . l a
severini	s e . b e . l i . n i
kreisler	k eu . l a . i . s eu l . l eo
broadway	b eu . l o . d eu . we . i
cigna	s i . g eu . n a
bunche	b eo n . ch i
junker	yu ng . k eo
europe	yu . l eo b
irons	a . i . eo n . s eu
eduard	e . d u . a . l eu . t eu
magnani	m a . n ya . n i
ruud	l wi . t eu
conakry	k o . n a . k eu . l i
todor	t o . d o . l eu
husserl	h u . s eo l
maia	m a . i . a
wilke	wi l . k eu
sultan	s u l . t a n
klopstock	k eu l . l o b . s yu . t o . k eu
mafeking	m a . p e . k i ng
messerer	m e . s e . l e . l eu
northrop	n o . s eu . l eo b
millan	m i l . l eo n
wundt	b u n . t eu
hepplewhite	h e . p eu l . h wa . i . t eu
kiesinger	k i . j i ng . g eo
kempff	k e m . p eu
curzon	k eo . j eu n
freiburg	p eu . l a . i . b u . l eu . k eu
barrera	b a . l e . l a
margaret	m a . g eo . l i . t eu
iraq	i . l a . k eu
eggleston	e . g eu l . s eu . t eo n
warhol	wo . h o l
cardano	k a . l eu . d a . n o
vanuatu	b a . n u . a . t u
berman	b eo . m a n
fontane	p o n . t a . n e
kondo	k o n . d o
dragan	d eu . l a . g a n
robb	l o b
greenville	g eu . l i n . b i l
curtis	k eo . t i . s eu
bloemfontein	b eu l . l u m . p o n . t e . i n
ball	b o l
longo	l o ng . g o
kirov	k i . l o . p eu
penrose	p e n . l o . s eu
stanislav	s eu . t a . n i . s eu l . l a . p eu
michael	m i . s we l
midas	m i . d a . s eu
kee	k i
luise	l u . i . j e
duvivier	d wi . b i . b i . e
matute	m a . t u . t e
bek	b e g
kate	k e . i . t eu
gesell	g e . j e l
ambrose	ae m . b eu . l o . j eu
brightman	b eu . l a . i . t eu . m a n
caplet	k ae . p eu l . l i s
purdy	p eo . d i
buckle	b eo . k eu l
fromm	p eu . l o m
marne	m a . l eu n
downey	d o . n i
melton	m e l . t o n
mesquita	m e . s eu . k i . t a
hofmeister	h o . p eu . m a . i . s eu . t eo
nazareth	n a . s a . l e s
portugal	p o . l eu . t u . g a l
ives	a . i . b eu . j eu
varela	b a . l e . l a
biddle	b i . d eu l
pinto	p i n . t o
chatterton	ch ae . t eo . t eo n
babylon	b a . b i l . l o n
chao	ch a . o
koopmans	k u . p eu . m eo n . s eu
paavo	p a . b o
dacca	d a . k a
memphis	m e m . p i . s eu
maurizio	m a . u . l i . ch i . o
iain	i . eo n
landes	l ae n . j eu
luria	l u . l i . a
vidal	b i . d a l
hasan	h a . s a n
liebermann	l i . b e . l eu . m a n
wartburg	b a . l eu . t eu . b u . l eu . k eu
gilson	j i l . s o ng
dianne	d a . i . ae n
carothers	k ae . l eo . d eo . s eu
mora	m o . l a
schultze	s yu l . ch e
pascal	p a . s eu . k a l
passow	p a . s yo . p eu
das	d a . s eu
justin	j eo . s eu . t i n
feininger	p a . i . n i ng . eo
verner	b e . l eu . n eo
caucasus	k o . k a . s eo . s eu
beaumarchais	b o . m a . l eu . s ye
mill	m i l
leipzig	l a . i . p eu . ch i . h i
gorbachev	g o . l eu . b a . ch o . p eu
karin	k a . l i n
gaul	g o l
blackstone	b eu l . l ae g . s eu . t o n
reynolds	l e . i . n o l . j eu
gross	g eu . l o . s eu
silveira	s i l . b e . i . l a
woodward	u . d eu . wo . d eu
painter	p e . i n . t eo
schongauer	s yo n . g a . u . eo
blakeslee	b eu l . l e . i . k eu . s eu l . l i
malin	m a l . l i n
semyonov	s e . m yo . n o . p eu
lennon	l e . n o n
solvay	s o l . b e . i
paloma	p a l . l o . m a
victorien	b i g . t o . l i . ae ng
castigliano	k a . s eu . t i l . l i . a . n o
laurencin	l o . l a ng . s ae ng
kennedy	k e . n e . d i
ignacio	i . g eu . n a . s i . o
kevin	k e . b i n
reppe	l e . p e
salmon	s a l . m o ng
vorontsov	b o . l o n . ch o . p eu
colman	k o l . m eo n
klimt	k eu l . l i m . t eu
rawlinson	l o l . l i n . s eu n
vince	b i n . s eu
beatrice	b e . a . t eu . l i . s eu
slim	s eu l . l i m
lem	l e m
brockman	b eu . l o . k eu . m a n
goujon	g u . j o ng
simons	s a . i . m eo n . j eu
cassini	k a . s i . n i
benigno	b e . n i . g eu . n o
denton	d e n . t eu n
iran	i . l a n
rosa	l o . j a
ned	n e . d eu
eudora	yu . d o . l a
kingstown	k i ng . s eu . t a . u n
shaw	s yo
fernando	p e . l eu . n a n . d o
ayala	a . ya l . l a
lydia	l i . d i . a
steve	s eu . t i . b eu
diego	d i . e . g o
perm	p e . l eu m
novikov	n o . b i . k o . p eu
gilman	g i l . m eo n
nernst	n e . l eu n . s eu . t eu
pomponazzi	p o m . p o . n a . ch i
arturo	a . l eu . t u . l o
gjellerup	g i . e l . l e . l u . p eu
rolando	l o l . l a n . d o
quebec	k we . b e g
orel	o . l e l
kretschmer	k eu . l e . ch i . m eo
garner	g a . n eo
lange	l a ng . e
dior	d i . o . l eu
elise	e l . l i . s eu
camillo	k a . m i l . l o
waters	wo . t eo . s eu
adani	a . d a . n i
borg	b o . g eu
montemayor	m o n . t e . m a . yo . l eu
worthington	wo . s i ng . t eo n
candolle	k a ng . d o l
beard	b i . eo . d eu
courtney	k o . t eu . n i
gadamer	g a . d a . m eo
falkberget	p a l . k eu . b e . l eu . g e
babe	b e . i . b eu
niebuhr	n i . b u . eo
coventry	k o . b eo n . t eu . l i
kinnock	k i . n o g
levin	l e . b i n
frances	p eu . l ae n . s i . s eu
barone	b a . l o . n e
kennan	k e . n eo n
cram	k eu . l ae m
gasparri	g a . s eu . p a . l i
farley	p a l . l i
melo	m e l . l o
morgenstern	m o . l eu . g e n . s yu . t e . l eu n
ana	a . n a
eliade	e l . l i . a . d e
med	m e . d eu
lyon	l i . o ng
august	a . u . g u . s eu . t eu
dolce	d o l . ch e
bose	b o . s eu
proust	p eu . l u . s eu . t eu
elman	e l . m eo n
benin	b e . n ae ng
huch	h u . h eu
chain	ch e . i n
dodson	d a s . s eu n
nerva	n e . l eu . b a
erik	e . l i . k eu
jonson	j o n . s eu n
alexis	a l . l e g . s i
brand	b eu . l ae n . d eu
childe	ch a . i l . d eu
nye	n a . i
nathalie	n a . t a l . l i
jansky	j ae n . s eu . k i
lassus	l a . s u . s eu
chanel	s ya . n e l
beaverbrook	b i . b eo . b eu . l u g
fiji	p i . j i
honeywell	h a . n i . we l
davenport	d ae . b eu n . p o . t eu
barrow	b a . l o . u
auerbach	a . u . eo . b a . h eu
greenland	g eu . l i n . l a n . d eu
summers	s eo . m eo . s eu
jain	j e . i n
macmillan	m ae g . m i l . l a n
thorndike	s o n . d a . i . k eu
rudin	l u . d i n
eddy	e . d i
vinci	b i n . ch i
yangon	ya ng . g o n
desmond	d e . j eu . m eo n . d eu
holstein	h o l . s eu . t a . i n
pfeiffer	p a . i . p eo
augusta	o . g eo . s eu . t a
goodyear	g u s . i . eo
seymour	s e . i . m u . eo
jacobus	ya . k o . b wi . s eu
vittorio	b i . t o . l i . o
geoff	j e . p eu
silvestre	s i l . b e . s eu . t eu . l eu
naumann	n a . u . m a n
tulasne	t u l . l a . s eu n
eugenio	e . u . j e . n i . o
chic	ch i g
boz	b o . j eu
kreutzer	k eu . l o . i . ch eo
hilton	h i l . t eo n
byron	b a . i . l eo n
ribbentrop	l i . b e n . t eu . l o . p eu
emmanuel	e . m a . n wi . e l
hennebique	e n . b i . k eu
zagreb	j a . g eu . l e . b eu
avogadro	a . b o . g a . d eu . l o
chaucer	ch o . s eo
gunther	g eo n . s eo
greer	g eu . l i . eo
holmes	h o m . s eu
wellington	we l . l i ng . t eo n
annabel	a . n a . b e l
alexandria	a l . l e g . s a n . d eu . l i . a
jospin	j o . s eu . p ae ng
noyce	n o . i . s eu
ochab	o . h a . p eu
vigano	b i . g a . n o
abrams	a . b eu . l a m . s eu
bjork	b i . yo . k eu
steinmetz	s eu . t a . i n . m e . ch eu
puig	p eu . i . g eu
irene	i . l e . i n
moussa	m u . s a
monet	m o . n e
meir	m e . i . l eu
petrus	b e . d eu . l o
benvenuto	b e n . b e . n u . t o
lyttelton	l i . t eu l . t eo n
imhoff	i m . h o . p eu
vasilevskaya	b a . s i l . l e . p eu . s eu . k a . ya
ivy	a . i . b i
amundsen	a . m u n . j e n
steel	s eu . t i l
ash	ae . s wi
laval	l a . b a l
herbart	h e . l eu . b a . l eu . t eu
gregor	g eu . l e . g o . l eu
strasburger	s yu . t eu . l a . s eu . b u . l eu . g eo
edvard	e . d eu . b a . l eu
kadun	k a . d u n
patel	p a . t e l
torsten	t o l . s eu . t eo n
coral	k o . l o l
tobey	t o . b i
mara	m a . l a
herriot	e . l i . o
galilei	g a l . l i l . l e . i
bismarck	b i . j eu . m a . k eu
sabin	s e . i . b i n
therese	t e . l e . j eu
larsen	l a . l eu . s e n
hettner	h e . t eu . n eo
cartwright	k a . t eu . l a . i . t eu
bataille	b a . t a . yu
danny	d a . n i
bulgakov	b u l . g a . k o . p eu
rhine	l a . i n
bjerknes	b i . e . l eu . k eu . n e . s eu
haas	h a . s eu
giambattista	j a m . b a . t i . s eu . t a
maggie	m ae . g i
behring	b e . l i ng
wim	b i m
defoe	d i . p o
cartan	k a . l eu . t a ng
pope	p o . p eu
vivien	b i . b i . eo n
estremadura	e . s eu . t eu . l e . m a . d u . l a
mader	m a . d eo
bournonville	b u . l eu . n o ng . b i l
hotchkiss	h o . ch i . k i . s eu
alberts	ae l . b eo . ch eu
ada	e . i . d eo
cope	k o . p eu
eliana	e l . l i . a . n a
lion	l i . o n
palissy	p a l . l i . s i
burnley	b eo n . l i
frost	p eu . l o . s eu . t eu
leszek	l e . s ye . k eu
botticelli	b o . t i . ch e l . l i
melchior	m e l . k i . o . l eu
dufy	d wi . p i
masson	m a . s o ng
boothroyd	b u . s eu . l o . i . d eu
bradbury	b eu . l ae . d eu . b eo . l i
parly	p a . l eu l . l i
bhutan	b u . t a n
jouvet	j u . b e
chomsky	ch o m . s eu . k i
reiners	l a . i . n eo . j eu
welhaven	b e l . h a . b e n
reischauer	l a . i . s ya . wo
esaias	e . s a . i . a . s eu
wald	wo l . d eu
kern	k eo n
peshawar	p e . s ya . wa . l eu
fick	p i . k eu
kelsen	k e l . j e n
percy	p eo . s i
diaz	d i . a . s eu
durban	d eo . b a n
glasgow	g eu l . l ae . s eu . g o
boye	b o . wi . e
dixon	d i g . s eu n
felipe	p e l . l i . p e
matthew	m a . t ae
blum	b eu l . l eo m
antonio	a n . t o . n i . o
agnes	a . g eu . n e . s eu
toland	t o l . l eo n . d eu
bates	b e . i . ch eu
eritrea	e . l i . t eu . l e . a
gadda	g a . d a
griffith	g eu . l i . p i . s eu
moreira	m o . l e . i . l a
alameda	a l . l eo . m i . d a
steno	s eu . t e . n o
tobias	t o . b i . a . s eu
halter	h a l . t eo
bernstein	b eo n . s eu . t a . i n
packard	p ae g . k eo . d eu
kamal	k a . m a l
lyndon	l i n . d eu n
canton	g wa ng . d u ng
krupp	k eu . l u . p eu
fisher	p i . s yeo
felder	p e l . d eo
paganini	p a . g a . n i . n i
vertov	b e . l eu . t o . p eu
caxias	k a . s i . a . s eu
fonteyn	p o n . t e . i n
malawi	m a l . l a . wi
alia	a l . l i . a
maryland	m e . l i l . l ae n . d eu
selim	s e l . l i m
snow	s eu . n o
balenciaga	b a l . l e n . s i . a . g a
capuana	k a . p u . a . n a
bristol	b eu . l i . s eu . t eu l
bergmann	b e . l eu . k eu . m a n
peron	p e . l o n
mel	m e l
massa	m a . s a
picabia	p i . k a . b i . a
carter	k a . t eo
barrymore	b e . l i . m o . eo
amelia	a . m e l . l i . a
volga	b o l . g a
taft	t ae . p eu . t eu
bentham	b e n . d a m
gracia	g eu . l a . s i . a
moscow	m o . s eu . k eu . b a
gerber	g eo . b eo
strafford	s eu . t eu . l ae . p eo . d eu
sen	s e n
allende	a . ye n . d e
sherman	s yeo . m eo n
chiesa	k i . e . s a
beadle	b i . d eu l
spenser	s eu . p e n . s eo
franklin	p eu . l ae ng . k eu l . l i n
marta	m a . l eu . t a
anaheim	ae . n eo . h a . i m
barroso	b a . l o . s u
hanna	h a n . n a
evansville	e . b eo n . j eu . b i l
arne	a . l eu . n e
collin	k o l . l i n
prior	p eu . l a . i . eo
montana	m o n . t ae . n a
toni	t a . n i
madeira	m a . d e . i . l a
eileen	a . i l . l i n
richelieu	l i . s yu l . l i . oe
mussolini	m u s . s o l . l i . n i
oldenburg	o l . d e n . b u . l eu . k eu
brunner	b eu . l u . n eo
guy	g a . i
jue	j we
curie	k wi . l i
pigalle	p i . g a l
begin	b e . g i n
dufour	d u . p o . b o ng
nicolae	n i . k o l . l a . e
emile	e . m i l
macy	m e . i . s i
hersey	h eo . s i
arbos	a . l eu . b o . s eu
mubarak	m u . b a . l a . k eu
soto	s o . t o
byers	b a . i . eo . s eu
crabbe	k eu . l ae . b eu
isherwood	i . s yeo . u . d eu
richie	l i . ch i
sydenham	s i . d eu . n eo m
myron	m i . l o n
marcus	m a . l eu . k u . s eu
scalia	s eu . k ae l . l i . a
italy	i . t a l . l i . a
perry	p e . l i
starr	s eu . t a
blythe	b eu l . l i . d eu
piazzetta	p i . a . ch e . t a
gotthelf	g o . t eu . h e l . p eu
garrison	g ae . l i . s eu n
maurois	m o . l eu . wa
calgary	k ae l . g eo . l i
strachey	s eu . t eu . l e . i . ch i
munro	m eo n . l o
errol	e . l eo l
ely	i l . l i
cox	k o g . s eu
winthrop	wi n . s eu . l eo b
mal	m a l
cassin	k a . s ae ng
miami	m a . i . e . m i
lambert	l a m . b e . l eu . t eu
vittorini	b i . t o . l i . n i
perkin	p eo . k i n
gibson	g i . b eu . s eu n
nijmegen	n e . i . m e . g e n
zunzunegui	s u n . s u . n e . g i
heckler	h e . k eu l . l eo
raya	l a . ya
farrell	p ae . l eo l
moudud	m u . d u . d eu
bardem	b a . d e m
kier	k a . ya
foreman	p o . m eo n
orville	o . b i l
tirana	t i . l a . n a
zetkin	ch e . t eu . k i n
hurley	h eo l . l i
libya	l i . b i . a
herren	h e . l e n
goffman	g o . p eu . m eo n
montherlant	m o ng . t e . l eu l . l a ng
mistral	m i . s eu . t eu . l a l
hertford	h a . t eu . p eo . d eu
josie	j o . s wi
brundage	b eu . l eo n . d i . j i
canning	k ae . n i ng
bilbao	b i l . b a . o
kautsky	k a . u . ch eu . k i
babbage	b ae . b i . j i
helsinki	h e l . s i ng . k i
matisse	m a . t i . s eu
jozef	yo . j e . p eu
alvin	ae l . b i n
marcel	m a . l eu . s e l
osler	o . s eu l . l eo
tiger	t a . i . g eo
colonna	k o l . l o n . n a
sydney	s i . d eu . n i
hain	h e . i n
jaspers	ya . s eu . p eo . s eu
rozier	l o . j i . e
montfort	m o ng . p o . l eu
rivlin	l i . b eu l . l i n
cato	k a . t o
bronte	b eu . l o n . t e
mohawk	m o . h o . k eu
ramos	l a . m o . s eu
saroyan	s a . l o . i . eo n
andorra	a n . d o . l a
champollion	s ya ng . p o l . l i . o ng
bangladesh	b a ng . g eu l . l a . d e . s i
rasputin	l a . s eu . p u . t i n
hal	h ae l
scripps	s eu . k eu . l i b . s eu
prendergast	p eu . l e n . d eo . g a . s eu . t eu
addison	ae . d i . s eu n
lauderdale	l o . d eo . d e . i l
parrington	p ae . l i ng . t eo n
bill	b i l
margery	m a . j e . l i
brno	b eu . l eu . n o
cukor	k u . k eo
bernardo	b e . l eu . n a . l eu . d o
bandiera	b a n . d i . e . l a
pirquet	p i . l eu . k e
lanzhan	l a n . j a n
carpentier	k a . l eu . p e n . t i . e . l eu
dominique	d o . m i . n i . k eu
bunin	b u . n i n
gladstone	g eu l . l ae . d eu . s eu . t eo n
verdier	b e . l eu . d i . e
manfred	m a n . p eu . l e . t eu
naess	n e . s eu
jamal	j a . m a l
montesquieu	m o ng . t e . s eu . k i . oe
sombart	j o m . b a . l eu . t eu
banda	b a n . d a
ilse	i l . s eu
gartner	g a . t eu . n eo
gori	g o . l i
ezer	e . j e . l eu
diogenes	d i . o . g e . n e . s eu
muriel	m yu . l i . e l
elmo	e l . m o
austin	o . s eu . t i n
sabri	s a . b eu . l i
gaetano	g a . e . t a . n o
miles	m a . i l . s eu
galbraith	k ae l . b eu . l e . i . s eu
turgot	t wi . l eu . g o
wentworth	we n . t eu . wo . s eu
milestone	m a . i l . s eu . t o n
bednorz	b e . d eu . n o . l eu . ch eu
dubrovnik	d u . b eu . l o . b eu . n i . k eu
markham	m a . k a m
borough	b o . l o
tosti	t o . s eu . t i
boccherini	b o . k e . l i . n i
vesaas	b e . s o . s eu
sinowatz	j i . n o . b a . ch eu
bentley	b e n . t eu . l i
leverrier	l eu . b e . l i . e
jaap	ya . p eu
ruskin	l eo . s eu . k i n
bangalore	b a ng . g a l . l o . l eu
granit	g eu . l a . n i . t eu
lawrence	l o . l e n . s eu
obrecht	o . b eu . l e . h i . t eu
bianchi	b i . a ng . k i
duisenberg	d o . i . s e n . b e . l eu . h eu
moldova	m o l . d o . b a
camus	k a . m wi
schreker	s yu . l e . k eo
golgi	g o l . j i
waltari	b a l . t a . l i
condo	k o n . d o
thatcher	d ae . ch eo
marini	m a . l i . n i
licht	l i . h i . t eu
mou	m eo . u
albuquerque	ae l . b eo . k eo . k i
auckland	o . k eu l . l ae n . d eu
cohan	k o . h ae n
barna	b a . n a
chekhov	ch e . h o . p eu
goethals	g o . s eo l . s eu
frederik	p eu . l e . d e . l i . k eu
pater	p e . i . t eo
sucre	s u . k eu . l e
malus	m a l . l wi . s eu
sherry	s ye . l i
joni	j o . n i
maupassant	m o . p a . s a ng
burr	b eo
nolde	n o l . d e
claus	k eu l . l a . u . s eu
munich	m wi n . h e n
zeppelin	ch e . p e l . l i n
andri	a n . d eu . l i . ch i
angell	e . i n . j eo l
collier	k o l . l i . eo
mbasogo	eu m . b a . s o . g o
xie	s ye
ram	l ae m
hancock	h ae n . k o g
jakarta	j a . k a . l eu . t a
ermanno	e . l a . m a n . n o
gemma	j e . m a
lillian	l i l . l i . eo n
villanueva	b i l . l a . n u . e . b a
ankara	a ng . k a . l a
renner	l e . n eo
lewes	l u . i . s eu
seligman	s e l . l i . g eu . m eo n
deakin	d i . k i n
tomas	t o . m a . s eu
petrie	p i . t eu . l i
bacchus	b a . k eo . s eu
dirichlet	d i . l i . k eu l . l e
prague	p eu . l a . g eu
novosibirsk	n o . b o . s i . b i . l eu . s eu . k eu
golding	g o l . d i ng
leeuwenhoek	l e . b e n . h u . k eu
jennings	j e . n i ng . s eu
giddens	g i . d eu n . s eu
ogden	o . g eu . d eo n
newcomb	n yu . k eo m
petri	p e . t eu . l i
maxim	m a g . s i m
neverov	n e . b e . l o . p eu
clinton	k eu l . l i n . t eo n
jouhaux	j u . o
ricky	l i . k i
kochanowski	k o . h a . n o . p eu . s eu . k i
klaproth	k eu l . l a . p eu . l o . t eu
boyer	b o . i . eo
lilian	l i l . l i . a ng
leipold	l a . i . p o l . t eu
hodgson	h o . j i . s eu n
botha	b o . t a
fairbanks	p e . eo . b ae ng . k eu . s eu
bonney	b o . n i
atlas	a . t eu l . l a . s eu
nasir	n a . s i . l eu
beuys	b o . i . s eu
hathaway	h ae . s eo . we . i
buddy	b eo . d i
basra	b a . s eu . l a
macbeth	m ae g . b e . s eu
roy	l o . i
delgado	d e l . g a . d o
chateaubriand	s ya . t o . b eu . l i . a ng
medhurst	m e . d eu . h eo . s eu . t eu
aspinall	a . s eu . p i . n a l
swedenborg	s eu . b e . d e n . b o . l i
campigli	k a m . p i l . l i
bamako	b a . m a . k o
booth	b u . d eu
celan	ch e l . l a n
leif	l e . i . p eu
santer	s a ng . t e . l eu
venter	b e n . t eo
rodrigo	l o . d eu . l i . g o
laurent	l o . l a ng
burma	b eo . m a
isabelle	i . j a . b e l
lyn	l i n
dumas	d wi . m a
vento	b e n . t o
irkutsk	i . l eu . k u . ch eu . k eu
aubert	o . b e . l eu
montes	m o n . t e . s eu
frazier	p eu . l e . i . j eo
romain	l o . m ae ng
lucy	l u . ss i
weidman	wa . i . d eu . m eo n
maciel	m a . s i . e l
westinghouse	we . s eu . t i ng . h a . u . s eu
shelton	s ye l . t eo n
hugo	wi . g o
usher	eo . s yeo
poul	p o . u l
girard	j i . l a . d eu
frida	p eu . l i . d a
tempest	t e m . p e . s eu . t eu
zahn	j ae n
managua	m a . n a . g wa
tom	t o m
estrada	e . s eu . t eu . l a . d a
stodola	s eu . t o . d o . l a
annika	a . n i . k a
asher	a . s e l
joaquim	h o . a . k i m
ben	b e n
girardon	j i . l a . l eu . d o ng
tunisia	t wi . n i . j i
basso	b a . s o
nixon	n i g . s eu n
serao	s e . l a . o
lenin	l e . n i n
lucie	l u . s i
mousa	m u . s a
ralph	l ae l . p eu
blixen	b eu l . l i g . s e n
rolland	l o l . l a ng
flaubert	p eu l . l o . b e . l eu
verlaine	b e . l eu l . l e n
yale	ye . i l
quantz	k eu . b a n . ch eu
jarre	j a . l eu
jocelyn	j o . s e l . l i n
max	m a g . s eu
iowa	a . i . o . wa
hieronymus	h i . e . l o . n i . m u . s eu
paulus	p a . u l . l u . s eu
neef	n i . p eu
staudinger	s yu . t a . u . d i ng . g eo
monrovia	m o n . l o . b i . a
goldsmith	g o l . d eu . s eu . m i . s eu
libreville	l i . b eu . l eu . b i l
cavalcanti	k a . b a l . k a n . t i
augustin	o . g u . s eu . t i n
vader	b e . i . d eo
bernard	b eo . n a . d eu
hyndman	h a . i n . d eu . m eo n
edmundo	e . d eu . m o n . d eu
fitch	p i . ch i
stammler	s yu . t a m . l eo
khomeini	h o . m e . i . n i
albinoni	a l . b i . n o . n i
ponce	p o n . s eu
trinidad	t eu . l i . n i . d a . d eu
magee	m ae . g i
bassett	b a . s e s
lie	l i
kollwitz	k o l . b i . ch eu
lilienthal	l i l . l i . e n . s o l
yaounde	ya . u n . d e
jakobson	ya . k o b . s eu n
poole	p u l
yehudi	ye . h u . d i
emma	e . m a
keaton	k i . t eu n
maas	m a . s eu
angara	a n . g a . l a
testa	t e . s eu . t a
quentin	k wo n . t i n
gonzales	g o n . s a l . l e . s eu
filipov	p i l . l i . p o . p eu
cochrane	k o . k eu . l eo n
luke	l u g . k eu
dudley	d eo . d eu l . l i
papini	p a . p i . n i
lamennais	l a . m eu . n e
verdi	b e . l eu . d i
wheelock	h wi l . l a g
bonneville	b o . n e . b i l
yitzhak	i . ch eu . h a . k eu
charlottetown	s ya l . l eo s . t a . u n
nureyev	n u . l e . ye . p eu
teasdale	t i . j eu . d e . i l
jayne	j e . i n
olga	o l . g a
ruiz	l u . i . j eu
gaillard	g a . i . ya . l eu
barletta	b a . l eu l . l e . t a
theodore	t e . o . d o . l eu
albers	a l . b e . l eu . s eu
short	s yo . t eu
cavaignac	k a . b e . n ya . k eu
pettersson	p e . t eo . s eu n
morice	m o . l i . s eu
stieglitz	s eu . t i . g eu l . l i . ch eu
filmer	p i l . m eo
kaas	k a . s eu
pretoria	p eu . l i . t o . l i . a
hugh	h yu
fedin	p e . d i n
jascha	ya . s ya
scarborough	s eu . k a . b o . l o
zeeland	j e l . l a n . d eu
alfonso	a l . p o n . s o
prescott	p eu . l e . s eu . k eo s
ross	l o . s eu
wyatt	wa . i . eo s
boyle	b o . i l
wilton	wi l . t eo n
charles	s ya . l eu l
niels	n i l . s eu
senior	s i . n i . eo
horn	h o . l eu n
nouri	n u . l i
juma	j u . m a
edgar	e . d eu . g a . l eu
hayek	h a . i . e . k eu
cardinal	k a . d i . n a l
pollock	p o l . l o g
buisson	b wi . s o ng
bullock	b u l . l eo g
ryszard	l i . s eu . j a . d eu
barents	b a . l e n . ch eu
adams	ae . d eo m . s eu
carrera	k a . l e . l a
pelliot	p e l . l i . o
lana	l a . n a
cheshire	ch e . s yeo
newman	n yu . m eo n
briscoe	b eu . l i . s eu . k o
michelet	m i . s yu l . l e
michels	m i . h e l . s eu
brasilia	b eu . l a . j i l . l i . a
reich	l a . i . h i
helmholtz	h e l . l eu m . h o l . ch eu
petrograd	p e . t eu . l o . g eu . l a . d eu
louis	l u . i
blok	b eu l . l o . k eu
grenada	g eu . l e . n a . d a
appia	a . p i . a
joan	yo . a ng
tarrant	t a . l a n . t eu
revere	l i . b i . eo
willem	b i l . l e m
friedman	p eu . l i . d eu . m a n
eric	e . l i g
danilo	d a . n i l . l o
clouzot	k eu l . l u . j o
smiles	s eu . m a . i l . s eu
wittenberg	b i . t e n . b e . l eu . k eu
berenger	b e . l i n . j eo
rama	l a . m a
johannes	yo . h a . n e . s eu
mississippi	m i . s i . s i . p i
vic	b i g
houdon	u . d o ng
torino	t o . l i . n o
norway	n o . l eu . we . i
wilberforce	wi l . b eo . p o . s eu
monticelli	m o ng . t i . s e l . l i
whittall	h wi s . t o l
fragonard	p eu . l a . g o . n a . l eu
pacino	p a . ch i . n o
simeon	s i . m eu . o n
cadiz	k a . d i . s eu
binyon	b i . n i . eo n
hammer	h a . m eo
alison	ae l . l i . s eu n
steffi	s yu . t e . p i
punsalmaagiyn	p u n . s a l . m a . g i n
travolta	t eu . l a . b o l . t a
oistrakh	o . i . s eu . t eu . l a . h eu
greta	g eu . l e . t a
yogi	yo . g i
dlamini	d eu l . l a . m i . n i
maseru	m a . s e . l u
melvin	m e l . b i n
cairns	k e . i n . j eu
bracton	b eu . l ae g . t eo n
dover	d o . b eo
lenoir	l eu . n u . a . l eu
frankel	p eu . l a n . k e l
cambiaso	k a m . b i . a . s o
maugham	m o m
count	k a . u n . t eu
granville	g eu . l ae n . b i l
abigail	ae . b i . g ae . i l
lot	l o s
lamartine	l a . m a . l eu . t i n
waley	we . i l . l i
cleve	k eu l . l e . b e
martinon	m a . l eu . t i . n o ng
butenandt	b u . t e . n a n . t eu
gwen	g eu . we n
noronha	n o . l o . n ya
duane	d yu . a n
britten	b eu . l i . t eu n
forbes	p o . b eu . s eu
giauque	j i . o . k eu
lemaitre	l eu . m e . t eu . l eu
bevin	b e . b i n
habsburg	h a b . s eu . b u . l eu . k eu
johansson	yo . h a n . s o n
mahmood	m a . h eu . m u . d eu
garcia	g a . l eu . s i . a
alicia	ae l . l i . s ya
honda	h o n . d a
krishna	k eu . l i . s yu . n a
ines	i . n e . s eu
berlage	b e . l eu l . l a . h e
reuben	l eu . u . b e n
reiner	l a . i . n eo
jam	j ae m
concepcion	k o n . s e b . s i . o n
stewart	s eu . t yu . eo . t eu
roth	l o . t eu
henderson	h e n . d eo . s eu n
dorsey	d o . eo . s i
kekkonen	k e . k o . n e n
charlotte	s ya l . l o . t eu
durant	d yu . l ae n . t eu
thoreau	s o . l o
donnie	d o . n i
peary	p i . eo . l i
agostino	a . g o . s eu . t i . n o
erdmann	e . l eu . d eu . m a n
haag	h e . i . g eu
lowell	l o . we l
henne	h e . n i
paramaribo	p a . l a . m a . l i . b o
limerick	l i . m eo . l i g
tallis	t ae l . l i . s eu
canto	k a n . t o
galway	g o l . we . i
erickson	e . l i g . s eu n
mercier	m e . l eu . s i . e
sassoon	s eo . s u n
timothy	t i . m eo . s i
kalimantan	k a l . l i . m a n . t a n
amelie	a . m e l . l i . e
mulroney	m eo l . l o . n i
grieg	g eu . l i . g eu
igor	i . g o . l eu
eckermann	e . k eo . m a n
napolitano	n a . p o l . l i . t a . n o
green	g eu . l i n
vaduz	p a . d u . ch eu
lasso	l a . s o
shea	s ye . i
flaherty	p eu l . l a . eo . t i
crespo	k eu . l e . s eu . p o
haley	h a l . l i
vesuvius	b e . s u . b i . o
kessler	k e . s eu l . l eo
colorado	k o l . l o . l a . d o
volkov	b o l . k o . p eu
williamson	wi l . l i . eo m . s eu n
como	k o . m o
long	l o ng
giddings	g i . d i ng . s eu
langley	l ae ng . g eu l . l i
angelika	a ng . g e l . l i . k a
harlow	h a l . l o
armstrong	a m . s eu . t eu . l o ng
tyler	t a . i l . l eo
will	wi l
wise	wa . i . j eu
ackermann	a . k eo . m a n
badajoz	b a . d a . h o . s eu
asturias	a . s eu . t u . l i . a . s eu
grafton	g eu . l a . p eu . t eu n
filchner	p i l . h i . n eo
sadat	s a . d a . t eu
arboleda	a . l eu . b o l . l e . d a
ludwig	l u . t eu . b i . h i
pembroke	p e m . b eu . l u g
hilferding	h i l . p eo . d i ng
tiselius	t i . s e l . l i . u . s eu
arago	a . l a . g o
patton	p ae . t eu n
stirner	s yu . t i . l eu . n eo
holz	h o l . ch eu
frederick	p eu . l e . d e . l i g
polanyi	p o l . l a . n i
montreuil	m o ng . t eu . l eu . yu
fiori	p i . o . l i
amontons	a . m o ng . t o ng
abadan	a . b a . d a n
thelma	d e l . m a
simpson	s i n . p eu . s eu n
haber	h a . b eo
wendy	we n . d i
freemantle	p eu . l i . m ae n . t eu l
armand	a . l eu . m a ng
maldives	m o l . d i . b eu
cain	k a . i n
khalid	k a l . l i . d eu
uzi	u . j i
dylan	d i l . l eo n
ciriaco	k eu . l i . a . k o
cabanas	k a . b a . n a . s eu
adriana	a . d eu . l i . a . n a
haugland	h e . u l . l a n
lino	l i . n o
oakeshott	o . k eu . s yeo . t eu
buford	b eo . p o . d eu
ellis	e l . l i . s eu
kohn	k o n
nujoma	n u . j o . m a
fredericton	p eu . l e . d eo . l i g . t eo n
bartlett	b a . t eu l . l i s
trollope	t eu . l o l . l eo b
reid	l i . d eu
burg	b u . l eu . g eu
rous	l a . u . s eu
windhoek	b i n . t eu . h u . k eu
schwab	s yu . b a . p eu
chevrolet	s i . b o . l e
tegucigalpa	t e . g u . s i . g a l . p a
gottsched	g o . t eu . s ye . t eu
bowden	b o . u . d e n
ovechkin	o . b e . ch i . k i n
lagrange	l a . g eu . l a ng . j u
levine	l eo . b a . i n
dorian	d o . l i . a n
chemnitz	k e m . n i . ch eu
copenhagen	k o . p e n . h a . g e n
bury	b eo . l i
hofstadter	h o . p eu . s eu . t ae . t eo
nancy	n a ng . s i
keswick	k e . s eu . wi g
musset	m wi . s e
clausewitz	k eu l . l a . u . j e . b i . ch eu
rumsey	l eo m . j i
haiti	a . i . t i
chris	k eu . l i . s eu
santoro	s a n . t o . l o
wellesley	we l . j eu l . l i
kenton	k e n . t eo n
muirhead	m yu . eo . h e . d eu
heather	h e . d eo
gamarra	g a . m a . l a
rand	l ae n . d eu
hoffa	h o . p a
kees	k i . s eu
dam	d a m
dunlop	d eo n . l o b
nehru	n e . l u
sue	s wi
tina	t i . n a
washington	wo . s i ng . t eo n
onsager	o n . s a . g eo
kingsley	k i ng . j eu l . l i
ellison	e l . l i . s eu n
fanning	p ae . n i ng
ravel	l a . b e l
andres	a n . d eu . l e . s eu
navarre	n a . b a . l eu
heidegger	h a . i . d e . g eo
cornelis	k o . l eu . n e l . l i . s eu
gluck	g eu l . l u . k eu
carr	k a
dana	d e . i . n a
susanne	j u . j a . n e
necker	n e . k e . l eu
lyonnet	l i . o . n e
ems	e m . s eu
owen	o . we n
yemen	ye . m e n
irina	i . l i . n a
monte	m o n . t e
irvine	eo . b i n
scipio	s eu . k i . p i . o
goa	g o . a
whittier	h wi . t i . eo
koepp	k o . p eu
turco	t u . l eu . k o
bremen	b eu . l e . m e n
winchester	wi n . ch e . s eu . t eo
brindley	b eu . l i n . d eu l . l i
ferris	p e . l i . s eu
ulises	yu l . l i . s i . s eu
indianapolis	i n . d i . ae . n a . p o l . l i . s eu
maureen	m o . l i n
odessa	o . d e . s a
milan	m i l . l a . n o
cyril	k i . l i l . l o . s eu
jepsen	j e . p eu . s eu n
dagmar	d a . g eu . m a . l eu
fleet	p eu l . l i . t eu
lennart	l e n . n a . l eu . t eu
krupskaya	k eu . l u . p eu . s eu . k a . ya
olena	o l . n e . n a
rudenko	l u . d e n . k o
burney	b eo . n i
gunnar	g u n . n a . l eu
temin	t e . m i n
dawes	d o . s eu
mathews	m ae . t yu . s eu
landgrebe	l ae n . d eu . g eu . l e . b e
boulder	b o . u l . d eo
husseini	h u . s e . i . n i
sydow	s i . d o
gonzalez	g o n . s a l . l e . s eu
ericson	e . l i g . s eu n
heidenstam	h e . i . d e n . s eu . t a m
becket	b e . k e . t eu
keyserling	k a . i . j eo l . l i ng
hoffman	h o . p eu . m a n
blumberg	b eu l . l eo m . b eo . g eu
nicolle	n i . k o l
drinkwater	d eu . l i ng . k eu . wo . t eo
pottinger	p o . t i n . j eo
nebraska	n e . b eu . l ae . s eu . k a
daniels	d a . n i . e l . j eu
bonnard	b o . n a . l eu
taverner	t a . b e . n eo
haller	h a l . l eo
werner	b e . l eu . n eo
mach	m a . h a
menzel	m e n . j e l
cairnes	k e . eo n . s eu
bruno	b eu . l u . n o
comoros	k o . m o . l o
thailand	t a . i
becher	b e . h eo
gil	g i l
gozzoli	g o . ch o l . l i
bowman	b o . m eo n
radcliffe	l ae . d eu . k eu l . l i . p eu
edel	e . d e l
card	k a . d eu
festus	p e . s eu . t eo . s eu
prager	p eu . l a . g eo
edna	e . d eu . n a
oliver	o l . l i . b eo
meyers	m e . i . eo . s eu
brooke	b eu . l u g
messier	m e . s i . e
hildebrand	h i l . d e . b eu . l a n . d eu
lima	l i . m a
krzysztof	k eu . s i . s yu . t o . p eu
posse	p o . s e
ward	wo . d eu
samar	s a . m a . l eu
ottawa	o . t a . wa
albany	o l . b eo . n i
conway	k o n . we . i
nolte	n o l . t e
panama	p a . n a . m a
petra	p e . t eu . l a
darling	d a l . l i ng
eriksen	e . l i g . s e n
josephus	yo . s e . p u . s eu
lofting	l o . p eu . t i ng
kathryn	k ae . s eo . l i n
wheatley	wi . t eu l . l i
hampton	h ae m . p eu . t eo n
nesmeyanov	n e . s eu . m e . ya . n o . p eu
castlereagh	k ae . s eu l . l e . i
carmel	k a . l eu . m e l
oman	o . m a n
keeley	k e l . l i
bliss	b eu l . l i . s eu
merriman	m e . l i . m eo n
tyutchev	t yu . ch e . p eu
reynaud	l e . n o
borge	b o . l eu . g eu
poulet	p u l . l e
horkheimer	h o . l eu . k eu . h a . i . m eo
damen	d e . i . m eo n
rivero	l i . b e . l o
neher	n e . eo
hawks	h o . k eu . s eu
beardsley	b i . eo . j eu l . l i
banach	b a . n a . h eu
anouilh	a . n u . i
fridtjof	p eu . l i . d eu . s yo . p eu
norris	n o . l i . s eu
dreiser	d eu . l a . i . j eo
eustachio	yu . s eu . t a . k i . o
palmerston	p a l . m eo . s eu . t o n
bessel	b e . s e l
twining	t eu . wa . i . n i ng
derby	d eo . b i
gilels	g i l . l e l . s eu
gallegos	g a l . l e . g o . s eu
jose	j o . j e
utrillo	yu . t eu . l i l . l o
zimbabwe	j i m . b a . b eu . we
artur	a . t eo
frege	p eu . l e . g e
nimitz	n i . m i . ch eu
slovakia	s eu l . l o . b a . k i . a
osbourne	o . s eu . b o n
speakes	s eu . p i . k eu . s eu
wiener	wi . n eo
vischer	p i . s yeo
bell	b e l
cash	k ae . s i
indra	i n . d eu . l a
patti	p ae . t i
fessenden	p e . s e n . d e n
zamboni	j a m . b o . n i
gaj	g a . i
basin	b a . s i n
frans	p eu . l a n . s eu
flavio	p eu l . l a . b i . o
hawaii	h a . wa . i
marrakech	m a . l a . k e . s i
malden	m o l . d e n
boole	b u l
roman	l o . m a n
ellie	e l . l i
weierstrass	b a . i . eo . s yu . t eu . l a . s eu
madrid	m a . d eu . l i . d eu
fernandez	p e . l eu . n a n . d e . s eu
junkers	yu ng . k eo . s eu
grillparzer	g eu . l i l . p a . l eu . ch eo
melville	m e l . b i l
kampala	k a m . p a l . l a
asquith	ae . s eu . k wi . s eu
hulbert	h eo l . b eo . t eu
robertson	l o . b eo . t eu . s eu n
proudhon	p eu . l u . d o ng
irving	eo . b i ng
andrzejewski	a n . j e . ye . p eu . s eu . k i
lujo	l u . j o
gramme	g eu . l a m
stimson	s eu . t i m . s eu n
colby	k o l . b i
abbot	a . b o . t eu
mackenzie	m ae . k e n . j i
martha	m a . s a
wali	wa . l i
huguenot	wi . g eu . n o
sams	s ae m . s eu
augusto	a . u . g u . s eu . t o
marin	m a . l ae ng
red	l e . d eu
witherspoon	wi . d eo . s eu . p u n
bean	b i n
dole	d o l
asia	a . s i . a
faith	p e . i . s eu
saunders	s eo n . d eo . s eu
marton	m a . l eu . t o n
pevsner	p e . p eu . s eu . n eo
eisenstein	a . i . j e n . s yu . t a . i n
gonzalo	g o n . s a l . l o
oppert	o . p e . l eu . t eu
duncan	d eo ng . k eo n
langmuir	l ae ng . m yu . eo
duncan	d eo n . k eo n
zion	s i . o n
hertz	h e . l eu . jj eu
anchorage	ae ng . k eo . l i . j i
attenborough	ae . t eu n . b eo . l eo
constantine	k o ng . s eu . t a ng . t i n
mia	m i . a
fried	p eu . l a . i . d eu
capone	k a . p o . n e
tischbein	t i . s yu . b a . i n
harmon	h a . m eo n
camerarius	k a . m e . l a . l i . u . s eu
fosse	p o . s e
dolan	d o l . l eo n
lance	l ae n . s eu
reinhardt	l a . i n . h a . l eu . t eu
june	j yu n
amado	a . m a . d o
haavelmo	h o . b e l . m o
pasternak	p a . s eu . t e . l eu . n a . k eu
abbe	a . b e
couto	k o . t u
billy	b i l . l i
knowles	n o l . s eu
dion	d i . o ng
jantzen	j a n . ch e n
flanders	p eu l . l ae n . d eo . s eu
nichols	n i . k o l . s eu
field	p i l . d eu
mitch	m i . ch i
milles	m i l . l e . s eu
edward	e . d eu . b a . l eu . t eu
connelly	k o . n eo l . l i
chandler	ch ae n . d eu l . l eo
biya	b i . ya
milo	m i l . l o
monteverdi	m o n . t e . b e . l eu . d i
yassin	ya . s i n
juan	h u . a n
blackwell	b eu l . l ae g . we l
michelle	m i . s ye l
cooper	k u . p eo
manrique	m a n . l i . k e
willemstad	b i l . l e m . s eu . t a . t eu
cornell	k o . n e l
falconet	p a l . k o . n e
blanche	b eu l . l a ng . s wi
linares	l i . n a . l e . s eu
wilson	wi l . s eu n
buber	b u . b eo
vieuxtemps	b i . oe . t a ng
andreas	a n . d eu . l e . a . s eu
kinck	k i ng . k eu
fleischer	p eu l . l a . i . s yeo
denver	d e n . b eo
aasen	o . s e n
maguire	m ae g . g wa . i . eo
berg	b eo . g eu
levy	l e . b i
eichendorff	a . i . h e n . d o . l eu . p eu
hidalgo	i . d a l . g o
clarence	k eu l . l ae . l eo n . s eu
platen	p eu l . l a . t e n
doherty	d o . h eo . t i
smith	s eu . m i . s eu
valadon	b a l . l a . d o ng
kanin	k a . n i n
santorio	s a n . t o . l i . o
francis	p eu . l a ng . s i . s eu
concord	k o ng . k o . d eu
connor	k o . n eo
huntington	h eo n . t i ng . t eo n
panofsky	p a . n o . p eu . s eu . k i
dyson	d a . i . s eu n
andersen	a n . d e . l eu . s e n
boyd	b o . i . d eu
ober	o . b eo
mahendra	m a . h e n . d eu . l a
algeria	a l . j e . l i
kircher	k i . l eu . h eo
gere	g i . eo
bertrand	b e . l eu . t eu . l a ng
randy	l ae n . d i
bales	b e . i l . j eu
lund	l u n . d eu
lacy	l e . i . s i
hopp	h o . p eu
fowles	p a . u l . j eu
harrisburg	h ae . l i . s eu . b eo . g eu
gesner	g e . s eu . n eo
cortona	k o . l eu . t o . n a
walt	wo l . t eu
maier	m a . i . e . l eu
dryden	d eu . l a . i . d eu n
lambeth	l ae m . b eo . s eu
ithaca	i . t a . k a
murray	m a . l e
bloomington	b eu l . l u . m i ng . t eo n
lao	l a . o
burman	b eo . m a
rietveld	l i . t eu . b e l . t eu
greenfield	g eu . l i n . p i l . d eu
horner	h o . n eo
sargent	s a . j eo n . t eu
focke	p o . k e
samuel	s a . m u . e l
omsk	o m . s eu . k eu
ghiberti	g i . b e . l eu . t i
maxim	m ae g . s i m
plekhanov	p eu l . l e . h a . n o . p eu
alva	a l . b a
madagascar	m a . d a . g a . s eu . k a . l eu
keith	k i . s eu
durante	d yu . l a n . t e
isabel	i . s a . b e l
calfa	ch a l . p a
valentine	b a l . l e n . t a . i n
porta	p o . l eu . t a
scholz	s yo l . ch eu
boveri	b o . b e . l i
tamara	t a . m a . l a
dortmund	d o . l eu . t eu . m u n . t eu
monnier	m o . n i . e
renata	l e . n a . t a
elsa	e l . j a
bass	b ae . s eu
sobrero	s o . b eu . l e . l o
judy	j u . d i
meyer	m a . i . eo
hilda	h i l . d a
glemp	g eu l . l e m . p eu
kundt	k u n . t eu
kyle	k a . i l
medford	m ae . d eu . p o . d eu
poussin	p u . s ae ng
mraz	m eu . l a . j eu
bopp	b o . p eu
lockhart	l o g . h a . t eu
ehrlich	e . l eu l . l i . h i
appert	a . p e . l eu
lindsay	l i n . j i
whitelaw	h wa . i . t eu l . l o
grau	g eu . l a . u
hutchins	h eo . ch i n . s eu
lucille	l u . s i l
soupault	s u . p o
norma	n o . m a
snider	s eu . n a . i . d eo
molander	m o l . l a n . d eo
vailland	b a . ya ng
nipkow	n i b . k o
colbert	k o l . b e . l eu
warsaw	b a . l eu . s ya . b a
nezval	n e . j eu . b a l
sem	s e m
anatole	a . n a . t o l
gutenberg	g u . t e n . b e . l eu . k eu
severus	s e . b e . l u . s eu
ismail	i . s eu . m a . i l
rolf	l o l . p eu
jellinek	ye l . l i . n e . k eu
piazzi	p i . a . ch i
beaver	b i . b eo
carey	k e . l i
holliday	h o l . l i . d e . i
damiani	d a . m i . a . n i
mazowiecki	m a . j o . b i . e . ch eu . k i
fulton	p u l . t eo n
chiara	k i . a . l a
albertville	a l . b e . l eu . b i l
ericsson	e . l i g . s eu n
dow	d a . u
tura	t u . l a
grote	g eu . l o . t eu
steinbeck	s eu . t a . i n . b e g
stiller	s eu . t i l . l e . l eu
speight	s eu . p e . i . t eu
michigan	m i . s i . g a n
page	p e . i . j i
alston	e l . s eu . t o n
mott	m o . t eu
renzo	l e n . j o
marjorie	m a . j eo . l i
bradford	b eu . l e . d eu . p o . d eu
sulla	s u l . l a
deborah	d e . b o . l a
guido	g u . i . d o
lefebvre	l eu . p e . b eu . l eu
hemingway	h e . m i ng . we . i
moses	m o . s e . s eu
coppola	k o . p eu l . l a
norfolk	n o . p eo g
hermes	h e . l eu . m e . s eu
daladier	d a l . l a . d i . e
bram	b eu . l a m
denny	d e . n i
vespucci	b e . s eu . p u . ch i
derbyshire	d eo . b i . s yeo
acs	ae g . s eu
edouard	e . d u . a . l eu
haworth	h a . s eu
faye	p e . i
tendryakov	t e n . d eu . l ya . k o . p eu
ziegler	ch i . g eu l . l eo
bob	b a b
markus	m a . k eo . s eu
daley	d e . i l . l i
bowyer	b a . u . eo
borlaug	b o l . l o . g eu
dolphin	d o l . p i n
perrault	p e . l o
tuvalu	t u . b a l . l u
nike	n a . i . k i
egorov	ye . g o . l o . p eu
brzezinski	b eu . l e . j i n . s eu . k i
hitch	h i . ch i
madras	m a . d eu . l a . s eu
cone	k o n
schliemann	s yu l . l i . m a n
akron	ae . k eu . l eo n
andrade	a n . d eu . l a . d e
dowson	d a . u . s eu n
henie	h e . n i
dyer	d a . i . eo
rainwater	l e . i n . wo . t eo
devi	d e . b i
jorge	j o . l eu . j e
hacker	h ae . k eo
schlegel	s yu l . l e . g e l
eli	e l . l i
hartmut	h a . l eu . t eu . m u . t eu
ghosh	g o . s i
lill	l i l
fahim	p a . h i m
topelius	t o . p e l . l i . u . s eu
byelorussia	b e l . l o . l u . s i
butte	b yu . t eu
rosetta	l o . j e . t a
araujo	a . l a . u . j o
perez	p e . l e . j eu
blount	b eu l . l a . u . t eu
fuentes	p u . e n . t e . s eu
uccello	u . ch e l . l o
heckscher	h e . k eu . s ye . l eu
jeanette	j i . n e s
branco	b eu . l a ng . k o
vinay	b i . n a . i
leeds	l i . j eu
freddie	p eu . l e . d i
kumar	k u . m a . l eu
kiss	k i . s i
wieland	b i l . l a n . t eu
liebmann	l i . p eu . m a n
penelope	p e . n e l . l o . p e
shakespeare	s ye . i g . s eu . p i . eo
perreau	p e . l o
marek	m a . l e g
siemens	j i . m e n . s eu
putnam	p eo . t eu . n eo m
gresham	g eu . l e . s yeo m
ioan	i . o . a n
damascus	d a . m a . s eu . k u . s eu
jacoby	j a . k o . b i
baer	b e . eo
brendel	b eu . l e n . d e l
karrer	k a . l eo
ramirez	l a . m i . l e . j eu
poland	p o l . l a n . d eu
hoskins	h o . s eu . k i n . s eu
lorenzen	l o . l e n . j e n
prado	p eu . l a . d o
atwood	ae . t u . d eu
loy	l o . i
jasper	j a . s eu . p eo
brundtland	b eu . l u n . t eu l . l a n
itzhak	i . j a g
neutra	n o . i . t eu . l a
hansson	h a n . s o n
granger	g eu . l e . i n . j eo
pelle	p e l . l e
unsworth	eo n . s eu . wo . s eu
leonid	l e . o . n i . t eu
salem	s a l . l e m
ernst	e . l eu n . s eu . t eu
nicolas	n i . k eo l . l eo . s eu
sanderson	s ae n . d eo . s eu n
helen	h e l . l e n
both	b o . s eu
morrison	m o . l i . s eu n
maine	m e . i n
leyte	l e . i . t e
stroessner	s eu . t eu . l o . e . s eu . n e . l eu
mang	m a ng
pearson	p i . eo . s eu n
pinel	p i . n e l
diane	d a . i . a n
strang	s eu . t eu . l ae ng
raabe	l a . b e
haris	h a . l i . s eu
schreyer	s yu . l a . i . eo
lorena	l o . l e . n a
mickey	m i . k i
doris	d o . l i . s eu
mira	m i . l a
aguascalientes	a . g wa . s eu . k a l . l i . e n . t e . s eu
orestes	o . l e . s eu . t e . s eu
scheele	s ye l . l e
bizet	b i . j e
atahualpa	a . t a . wa l . p a
ulanova	u l . l a . n o . b a
cugnot	k wi . n yo
arenas	a . l e . n a . s eu
hynninen	h a . i n . n i . n e n
makin	m a . k i n
ewing	yu . i ng
armen	a . l eu . m e n
ekman	e . k eu . m a n
eminescu	e . m i . n e . s eu . k u
smetana	s eu . m e . t a . n a
perkins	p eo . k i n . s eu
boucher	b a . u . ch eo
peccei	p e . ch e . i
montoya	m o n . t o . ya
gloria	g eu l . l o . l i . a
tracy	t eu . l e . i . s i
andreev	a n . d eu . l e . ye . p eu
courteline	k u . l eu . t eu l . l i n
bettina	b e . t i . n a
korn	k o n
maillol	m a . yo l
hankel	h a ng . k e l
paisiello	p a . i . s i . e l . l o
pedro	p e . d eu . l o
campra	k a ng . p eu . l a
featherstone	p i . d eo . s eu . t o n
abba	a . b a
lagos	l a . g o . s eu
gertsen	g e . l eu . ch e n
cano	k a . n o
inglis	i ng . g eu l . l i . s eu
hoxha	h o . j a
amiel	a . m i . e l
merlin	m eo l . l i n
orson	o . s eo n
pettenkofer	p e . t e n . k o . p eo
perutz	p eo . l u . ch eu
itzik	i . ch i . k eu
nadar	n a . d a . l eu
pilcher	p i . ch eo
landau	l a n . d a . u
mano	m a . n o
respighi	l e . s eu . p i . g i
downs	d a . u n . s eu
purcell	p eo . s e l
azevedo	a . j e . b e . d o
bikila	b i . k i l . l a
weingartner	b a . i n . g a . l eu . t eu . n eo
wole	wo l . l e
lippmann	l i . p eu . m a n
rousseau	l u . s o
alencar	a l . l e n . k a . l eu
leoni	l e . o . n i
benjamin	b e n . j a . m i n
salvini	s a l . b i . n i
hooke	h u g
langdon	l ae ng . d eo n
crosby	k eu . l o . s eu . b i
sandra	s ae n . d eu . l a
hernandez	h e . l eu . n a n . d e . s eu
cicero	k i . k e . l o
caprivi	k a . p eu . l i . b i
piero	p i . e . l o
kathy	k ae . s i
malta	m o l . t a
haidar	h a . i . d a . l eu
alexander	a l . l e g . s a n . d eu . l eu
sweden	s eu . we . d e n
uzbekistan	u . j eu . b e . k i . s eu . t a n
millard	m i l . l eo . d eu
brecht	b eu . l e . h i . t eu
sonja	s o . n ya
marchais	m a . l eu . s ye
baird	b e . eo . d eu
graves	g eu . l a . b eu . s a n
mackay	m ae g . k e . i
fechner	p e . h i . n eo
duchamp	d wi . s ya ng
marquis	m a . l eu . k i . s eu
chile	ch i l . l e
gamba	g a m . b a
wittfogel	b i . t eu . p o . g e l
petty	p e . t i
ricketts	l i . k e . ch eu
bartley	b a . t eu . l i
tucker	t eo . k eo
aram	a . l a m
amara	a . m a . l a
charlie	ch a l . l i
nicky	n i . k i
mike	m a . i . k eu
antwerp	ae n . t eu . wo . p eu
nicholas	n i . k o l . l eo . s eu
lepidus	l e . p i . d u . s eu
bassi	b a . s i
browning	b eu . l a . u . n i ng
renoir	l eu . n u . a . l eu
rivera	l i . b e . l a
gerstner	g eo . s eu . n eo
tam	t a m
cornelius	k o . l eu . n e l . l i . u . s eu
dixie	d i g . s i
marty	m a . l eu . t i
maximilian	m a g . s i . m i l . l i . a n
fittig	p i . t i . h i
pessoa	p e . s o . a
lech	l e . h eu
cullen	k eo l . l e n
beaufort	b o . p eo . t eu
eugene	yu . j i n
longman	l o ng . m ae n
mauritius	m o . l i . s yeo . s eu
combs	k o m . s eu
robin	l o . b i n
muskogee	m u . s eu . k o . g i
serge	s e . l eu . g e
brasseur	b eu . l a . s oe . l eu
roux	l u
guerra	g e . l a
neumann	n o . i . m a n
vaughan	b o n
palmiro	p a l . m i . l o
santana	s a n . t a . n a
adrienne	e . i . d eu . l i . e n
daniell	d a . n i . e l
penderecki	p e n . d e . l e . ch eu . k i
foggia	p o . j i . a
dines	d a . i n . s eu
haren	h a . l e n
cyrus	k i . l o . s eu
stockwell	s eu . t o g . we l
kramer	k eu . l e . i . m eo
moravia	m o . l a . b i . a
canaro	k a . n a . l o
bale	b e . i l
stonehenge	s eu . t o n . h e n . j i
varenius	b a . l e . n i . u . s eu
innsbruck	i n . s eu . b eu . l u . k eu
sickel	j i . k e l
verne	b e . l eu n
modena	m o . d e . n a
mingdao	m i ng . d a . o
tashkent	t a . s yu . k e n . t eu
oskar	o . s eu . k a . l eu
cordelia	k o . d e l . l i . a
martin	m a . l eu . t i n
rodenbach	l o . d e n . b a . h eu
heath	h i . s eu
bly	b eu l . l a . i
miriam	m i . l i . eo m
rabelais	l a . b eu l . l e
negev	n e . g e . b eu
pascoli	p a . s eu . k o l . l i
gregg	g eu . l e . g eu
sanz	s a n . s eu
wolverhampton	u l . b eo . h ae m . t eo n
oscar	o . s eu . k a
montaigne	m o ng . t e . n yu
kovalenko	k o . b a l . l e n . k o
fazal	p a . j a l
kline	k eu l . l a . i n
grandi	g eu . l a n . d i
huston	h yu . s eu . t eo n
negro	n i . g eu . l o
bahar	b a . h a . l eu
carlsson	k a l . s o n
kalman	k a l . m a n
mackintosh	m ae . k i n . t o . s i
hastings	h e . i . s eu . t i ng . s eu
proctor	p eu . l o g . t eo
dan	d a n
russell	l eo . s e l
serena	s e . l i . n a
rossellini	l o . s e l . l i . n i
alberta	a l . b a . t a
sisley	s i . s eu l . l e
lachmann	l a . h eu . m a n
fisch	p i . s yeo
navarra	n a . b a . l a
claxton	k eu l . l e g . s eu . t eo n
tata	t a . t a
arnoldson	a . l eu . n o l . d eu . s o n
antoinette	a ng . t u . a . n e . t eu
remy	l e . m i
alice	ae l . l i . s eu
hofer	h o . p eo
suttner	j u . t eu . n eo
severo	s e . b e . l o
keiser	k a . i . j eo
weinheber	b a . i n . h e . b eo
franck	p eu . l a ng . k eu
champaigne	s a ng . p a . n yu
veen	b i n
henle	h e n . l e
guayaquil	g wa . ya . k i l
carola	k a . l o l . l a
abegg	a . b e . g eu
kierkegaard	k i . e . l eu . k e . g o . l eu
chamberlin	ch e . i m . b eo l . l i n
dod	d o . d eu
nizan	n i . j a ng
bushman	b u . s i . m eo n
heckel	h e . k e l
benedikt	b e . n e . d i g . t eu
anwar	a n . wa . l eu
gene	j i n
viking	b a . i . k i ng
dorset	d o . s e . t eu
bern	b e . l eu n
holbrooke	h o l . b eu . l u g
lepsius	l e b . s i . u . s eu
symington	s a . i . m i ng . t eo n
holzer	h o l . ch eo
bouchard	b u . s ya . l eu
kasper	k a . s eu . p eo
redmond	l e . d eu . m o n . d eu
northcliffe	n o . s eu . k eu l . l i . p eu
van	b a n
kuhn	k u n
romanov	l o . m a . n o . p eu
inez	a . i . n e . j eu
higgins	h i . g i n . s eu
giles	j a . i l . s eu
port_of_spain	p o . t eu . o . b eu . s eu . p e . i n
hobbs	h o b . s eu
eder	e . d eo
hamlin	h ae m . l i n
cambridge	k e . i m . b eu . l i . j i
weiner	wa . i . n eo
manchester	m ae n . ch e . s eu . t eo
porter	p o . t eo
andrews	ae n . d eu . l u . s eu
leon	l e . o ng
vaucanson	b o . k a ng . s o ng
johnston	j o n . s eu . t o n
gomez	g o . m e . j eu
moller	m o l . l eo
henrietta	h e n . l i . e . t a
romer	l o . m eo
sheraton	s ye . l eo . t eo n
medina	m e . d i . n a
ragusa	l a . g u . s a
kossel	k o . s e l
aleksander	a l . l e g . s a n . d eo
poncelet	p o ng . s eu l . l e
ribot	l i . b o
nicol	n i . k o l
root	l u . t eu
fritsch	p eu . l i . ch i
krueger	k eu . l u . g eo
margarete	m a . l eu . g a . l e . t e
curtiz	k eo . t i . s eu
cartier	k a . l eu . t i . e
peggy	p e . g i
leskov	l e . s eu . k o . p eu
gareth	g ae . l i . s eu
walker	wo . k eo
sarney	s a . l eu . n e . i
sanchez	s a n . ch e . s eu
clare	k eu l . l e . eo
martin	m a . l eu . t ae ng
heisenberg	h a . i . j e n . b e . l eu . k eu
jara	h a . l a
michie	m i . ch i . e
tolkien	t o l . k i n
sholokhov	s yo l . l o . h o . p eu
kaunda	k a . u n . d a
thebes	t e . b e
meinecke	m a . i . n e . k e
limburg	l i m . b u . l eu . h eu
perlman	p eo l . m a n
regiomontanus	l e . g i . o . m o n . t a . n u . s eu
revueltas	l e . b u . e l . t a
man	m ae n
hay	h e . i
overbeck	o . b eo . b e . k eu
crome	k eu . l o m
oklahoma	o . k eu l . l eo . h o . m a
discovery	d i . s eu . k eo . b eo . l i
brentano	b eu . l e n . t a . n o
tolle	t o l . l e
solo	s o l . l o
kraepelin	k eu . l e . p e l . l i n
argento	a . l eu . j e n . t o
orlando	o l . l ae n . d o
ambrosius	a m . b eu . l o . s i . u . s eu
alaska	a l . l ae . s eu . k a
kuibyshev	k u . i . b i . s ye . p eu
cabrera	k a . b eu . l e . l a
evans	e . b eo n . s eu
nimu	n i . m u
philadelpia	p i l . l a . d e l . p i . a
bayard	b a . ya . l eu
majuro	m a . j u . l o
matthew	m ae . s yu
memling	m e m . l i ng
ancona	a n . k o . n a
stowe	s eu . t o
bowring	b o . u . l i ng
galileo	g a l . l i l . l e . o
ochoa	o . ch o . a
rosen	l o . s eu n
harrison	h ae . l i . s eu n
brighton	b eu . l a . i . t eu n
noir	n eu . wa . l eu
scholl	s eu . k o l
ira	a . i . l a
schmiedeberg	s yu . m i . d e . b e . l eu . k eu
fillmore	p i l . m o . eo
colmar	k o l . m a . l eu
grande	g eu . l ae n . d eu
fletcher	p eu l . l ae . ch eo
kerrigan	k e . l i . g eo n
dawkins	d o . k i n . s eu
amato	a . m a . t o
hooper	h u . p eo
blanqui	b eu l . l a ng . k i
phillips	p i l . l i b . s eu
bateson	b e . i . t eu . s eu n
heym	h a . i m
rommel	l o . m e l
guadalajara	g wa . d a l . l a . h a . l a
jenner	j e . n eo
julia	j u l . l i . a
josep	h o . s e b
verdun	b e . l eu . d oe ng
pickering	p i . k eo . l i ng
dingler	d i ng . g eu l . l eo
shapley	s yae . p eu l . l i
schmalenbach	s yu . m a l . l e n . b a . h eu
ungaro	u ng . g a . l o
samuelson	s a . m u . e l . s eu n
wingrove	wi n . g eu . l o . b eu
dallapiccola	d a l . l a . p i . k o l . l a
shaheen	s yae . h i n
vladivostok	b eu l . l a . d i . b o . s eu . t o . k eu
anderton	a n . d eo . t o n
vincent	b ae ng . s a ng
wien	b i n
whitehead	h wa . i . t eu . h e . d eu
sparks	s eu . p a g . s eu
mildred	m i l . d eu . l e . d eu
newlands	n yu . l ae n . j eu
gurley	g eo l . l i
naisbitt	n e . s eu . b i . t eu
mackinder	m ae . k i n . d eo
sapir	s a . p i . eo
clifton	k eu l . l i . p eu . t eo n
garfield	g a . p i l . d eu
reel	l i l
funke	p u ng . k e
bernal	b eo . n eo l
aleksandr	a l . l e g . s a n . d eu . l eu
irma	i . l eu . m a
duvall	d yu . b a l
pitcairn	p i s . k e . eo n
mannheim	m a n . h a . i m
scharnhorst	s ya . l eu n . h o . l eu . s eu . t eu
bridget	b eu . l i . j i . t eu
dawson	d o . s eu n
lewis	l u . i . s eu
rauf	l a . u . p eu
padgett	p ae . j e s
busoni	b u . s o . n i
gabriela	g a . b eu . l i . e l . l a
ciampi	ch a m . p i
fred	p eu . l e . d eu
harris	h ae . l i . s eu
petroni	p e . t eu . l o . n i
jay	j e . i
winston	wi n . s eu . t eo n
sandi	s ae n . d i
hyde	h a . i . d eu
conti	k o n . t i
hayat	h a . ya s
akbar	a . k eu . b a . l eu
sampson	s ae m . s eu n
goes	g u . s eu
aldington	o l . d i ng . t eo n
hoover	h u . b eo
rudy	l u . d i
kinnear	k eo . n i . eo
abraham	a . b eu . l a . h a m
brito	b eu . l i . t o
breton	b eu . l e . t eu n
joshi	j o . s i
diana	d i . a . n a
domingo	d o . m i ng . g o
karlsruhe	k a . l eu l . s eu . l u . e
einhorn	a . i n . h o n
beyer	b a . i . eo
galland	g a l . l a ng
duffy	d eo . p i
bonds	b o n . j eu
bron	b eu . l o n
hutson	h eo . t eu . s eu n
prata	p eu . l a . t a
saleh	s a l . l e
darcy	d a . s i
ortiz	o . l eu . t i . s eu
regis	l e . j i . s eu
gianfranco	j a n . p eu . l a ng . k o
ingenhousz	i ng . g e n . h o . u . s eu
olyphant	o l . l i . p eo n . t eu
palma	p a l . m a
messner	m e . s eu . n e . l eu
geissler	g a . i . s eu l . l eo
spallanzani	s eu . p a l . l a n . ch a . n i
mehta	m e . t a
hans	h a n . s eu
baldung	b a l . d u ng
jacobson	j e . i . k o b . s eu n
elmer	e l . m eo
palme	p a l . m e
istanbul	i . s eu . t a n . b u l
abebe	a . b e . b e
olivia	o l . l i . b i . a
peltier	p e l . t i . e
patrick	p a . t eu . l i . k eu
lamar	l a . m a
nobile	n o . b i l . l e
gogol	g o . g o l . l i
mauritz	m a . u . l i . ch eu
pere	p e . l eu
louise	l u . i . j eu
attar	ae . t a
gibbon	g i . b eo n
benn	b e n
habakkuk	h a . b a g . g u g
montalvo	m o n . t a l . b o
ashton	ae . s yu . t eo n
krasheninnikov	k eu . l a . s ye . n i n . n i . k o . p eu
nagy	n eo . j i
cambodia	k a m . b o . d i . a
bienville	b i . e n . b i l
mauboussin	m o . b eu . s a ng
dayan	d a . ya n
wangchuck	wa ng . ch u . k eu
angeles	e n . j e l . l e . s eu
elisa	e l . l i . s a
cremona	k eu . l e . m o . n a
mathis	m ae . t i . s eu
darwin	d a . wi n
witz	b i . ch eu
ferry	p e . l i
carole	k ae . l o l
canetti	k a . n e . t i
pankhurst	p ae ng . k eu . h eo . s eu . t eu
hanzi	h a n . jj eu
whitman	h wi . t eu . m eo n
goldstein	g o l . d eu . s eu . t a . i n
edith	e . d i . t eu
leonard	l e . n eo . d eu
delaunay	d eu l . l o . n e
branting	b eu . l a n . t i ng
melissa	m e l . l i . s a
fo	p o
gianni	j a n . n i
carolina	k ae . l o l . l a . i . n a
matthews	m ae . s yu . s eu
jansen	ya n . s e n
gioberti	j o . b e . l eu . t i
verde	b e . l eu . d e
giuliani	j u l . l i . a . n i
giono	j i . o . n o
ginastera	h i . n a . s eu . t e . l a
gregorius	g eu . l e . g o . l i . u . s eu
anselmo	a n . s e l . m o
hagen	h a . g e n
edelman	e . d eo l . m eo n
schleiermacher	s yu l . l a . i . eo . m a . h eo
ven	b e n
voight	b o . i . t eu
chad	ch a . d eu
wick	wi g
ganges	g ae n . j i . s eu
mandel	m ae n . d e l
terborch	t e . l eu . b o . l eu . h i
catherine	k ae . d eo . l i n
goode	g u . d eu
holbein	h o l . b a . i n
schwabe	s yu . b a . b e
nolan	n o l . l eo n
mesopotamia	m e . s o . p o . t a . m i . a
zannini	j ae . n i . n i
frances	p eu . l a n . s i . s eu
kummer	k u . m eo
bernhardt	b e . l eu . n a . l eu
richards	l i . ch eo . j eu
emin	e . m i n
ecker	e . k eo
freud	p eu . l o . i . t eu
brook	b eu . l u g
bach	b a . h eu
hefner	h e . p eu . n eo
masefield	m e . i . s eu . p i l . d eu
pott	p o . t eu
bakunin	b a . k u . n i n
gooch	g u . ch i
drew	d eu . l yu
brigitte	b eu . l i . j i s
soros	s o . l o . s eu
drexler	d eu . l e g . s eu l . l eo
glenda	g eu l . l e n . d a
nestor	n e . s eu . t o . l eu
voisin	b eu . wa . j ae ng
burgundy	b u . l eu . g o . n yu
lombardo	l o m . b a . l eu . d o
smellie	s eu . m e l . l i
pampas	p a m . p a . s eu
audrey	o . d eu . l i
durkheim	d wi . l eu . k e m
grove	g eu . l o . b eu
bear	b e . a
angus	ae ng . g eo . s eu
hodgkin	h o . j i . k i n
bernardino	b e . l eu . n a . l eu . d i . n o
wesleyan	we . s eu l . l i
behn	b e n
lincoln	l i ng . k eo n
coburn	k o . b eo n
walesa	b a . we n . s a
aden	a . d e n
mcguire	m ae g . g wa . i . eo
barnett	b a . n e s
lamb	l ae m
elvira	e l . b i . l a
khan	k a n
darby	d a . b i
topeka	t o . p i . k a
dunn	d eo n
bolt	b o l . t eu
dukas	d wi . k a
macedonia	m a . k e . d o . n i . a
monroy	m o n . l o . i
bali	b a l . l i
burnham	b eo n . h ae m
ramuz	l a . m wi
cassandre	k a . s a ng . d eu . l eu
bethlehem	b e . d eu l . l e . h e m
adil	a . d i l
bihar	b i . h a . l eu
violet	b a . i . o l . l e s
rostow	l o . s eu . t o . u
scorsese	s eu . k o l . s e . i . j i
buridan	b wi . l i . d a ng
menuhin	m e . n yu . i n
kuprin	k u . p eu . l i n
dempsey	d e m . s i
raj	l a . j i
cervantes	s e . l eu . b a n . t e . s eu
caro	k a . l o
spinoza	s eu . p i . n o . j a
arena	a . l e . n a
sforza	s eu . p o . l eu . j a
hazel	h e . i . j eu l
pasternack	p a . s eu . t eo . n e g
verona	b e . l o . n a
edi	e . d i
buchanan	b yu . k ae . n eo n
bluff	b eu l . l eo . p eu
bengt	b e ng . t eu
arce	a . l eu . s e
sor	s o . l eu
galle	g a l
joost	yo . s eu . t eu
sprengel	s yu . p eu . l e ng . g e l
klein	k eu l . l a . i n
himmler	h i m . l eo
lippi	l i . p i
indonesia	i n . d o . n e . s i . a
rosas	l o . s a . s eu
pompel	p o m . p e . i
nepal	n e . p a l
maki	m a . k i
lobo	l o . b o
peyton	p e . i . t eu n
pais	p a . i . s eu
hunter	h eo n . t eo
nath	n a . s eu
weller	we l . l eo
ingvar	i ng . b a . l eu
delibes	d eu l . l i . b eu
vitoria	b i g . t o . l i . a
delhi	d e l . l i
bellow	b e l . l o
zbigniew	j eu . b i . g eu . n i . e . p eu
boileau	b u . a l . l o
geist	g a . i . s eu . t eu
valencia	b a l . l e n . s i . a
escoffier	e . s eu . k o . p i . e
boccaccio	b o . k a . ch i . o
hayes	h e . i . s eu
paz	p a . s eu
gaborone	g a . b o . l o . n e
rubens	l u . b e n . s eu
santiago	s a n . t i . a . g o
masters	m a . s eu . t eo . s eu
bethe	b e . t e
laud	l o . d eu
sutherland	s eo . d eo l . l ae n . d eu
hertwig	h e . l eu . t eu . b i . h i
haeckel	h e . k e l
schilling	s i l . l i ng
elias	e l . l i . a . s eu
antoine	a ng . t u . a n
petzold	p e s . j o l . t eu
gail	g e . i l
stalin	s eu . t a l . l i n
bernier	b e . l eu . n i . e
kapitsa	k a . p i . ch a
gregory	g eu . l e . g o . l i
perec	p e . l e g
berti	b e . l eu . d i
vida	b i . d a
amanda	a . m a n . d a
balmer	b a l . m eo
ohm	o m
guzman	g u . j eu . m eo n
kempis	k e m . p i . s eu
little	l i . t eu l
carmichael	k a . m a . i . k eu l
taylor	t e . i l . l eo
farren	p ae . l eo n
hazlitt	h ae . j eu l . l i s
torres	t o . l e . s eu
templeton	t e m . p eu l . t eo n
ansel	eo n . s e l
lower	l o . b e . l eu
donen	d o . n eo n
block	b eu l . l o g
leno	l e . n o
fabry	p a . b eu . l i
gillespie	g i l . l e . s eu . p i
dominic	d o . m i . n i . k eu
carnap	k a . l eu . n a b
gilbert	g i l . b eo . t eu
sol	s o l
abdullah	a b . d u l . l a
trenton	t eu . l e n . t eo n
mathewson	m ae . t yu . s eu n
harsanyi	h eo . s ya . n i
minneapolis	m i . n i . ae . p o l . l i . s eu
stafford	s eu . t ae . p o . d eu
dunsany	d eo n . s e . i . n i
bayley	b e . i . l e . i
fuller	p u l . l eo
heymans	h a . i . m a n . s eu
garr	g a
trevor	t eu . l e . b eo
fromentin	p eu . l o . m a ng . t ae ng
boccioni	b o . ch o . n i
duval	d yu . b a l
updike	eo b . d a . i . k eu
addington	ae . d i ng . t eo n
gusou	g u . ss eo . u
malthus	m ae l . s eo . s eu
lasker	l ae . s eu . k eo
cendrars	s a ng . d eu . l a . l eu
broglie	b eu . l o . g eu l . l i
shelley	s ye l . l i
chianti	k a n . t i
unamuno	u . n a . m u . n o
jackie	j ae . k i
overton	o . b eo . t eu n
annemarie	a . n e . m a . l i
wade	wa . d e
clements	k eu l . l e . m eo n . ch eu
calypso	k a l . l i b . s o
cali	k a l . l i
angola	a ng . g o l . l a
carney	k a . n i
howard	h a . wo . d eu
aubrey	o . b eu . l i
moura	m o . l a
rollins	l o l . l i n . s eu
bow	b o . u
nightingale	n a . i . t i ng . g e . i l
hopkins	h o b . k i n . s eu
euclid	yu . k eu l . l i . d eu
tate	t e . i . t eu
lugar	l u . g a
esposito	e . s eu . p o . s i . t o
rajiv	l a . j i . b eu
hassel	h a . s e l
terry	t e . l i
jim	j i m
birmingham	b eo . m i ng . eo m
toivo	t o . i . b o
rice	l a . i . s eu
villa	b i l . l a
asimov	a . s i . m o . p eu
wlodzimierz	b eu l . l o . ch i . m i . e . l eu . ch eu
foerster	p oe . l eu . s eu . t eo
dupleix	d wi . p eu l . l e g . s eu
khalil	k a l . l i l
karina	k a . l i . n a
menger	m e ng . g eo
ralf	l a l . p eu
baal	b a . a l
klemperer	k eu l . l e m . p e . l eo
ueberweg	yu . b eo . b e g
arnim	a . l eu . n i m
dugan	d yu . g eo n
barnes	b a . n e . j eu
marion	m ae . l i . eo n
schiaparelli	s eu . k i . a . p a . l e l . l i
lucena	l u . s e . n a
elijah	e l . l i . ya
lagerkvist	l a . g e . l eu . k eu . b i . s eu . t eu
madison	m ae . d i . s eu n
leopold	l e . o . p o l . d eu
seipel	j a . i . p e l
hannibal	h a n . n i . b a l
rusk	l eo . s eu . k eu
galtung	g a l . t u ng
judith	yu . d i . t eu
ephesus	e . p e . s u . s eu
more	m o . eo
koster	k o . s eu . t eo
millay	m i l . l e . i
altissimo	a l . t i . s i . m o
konstantin	k o n . s eu . t a n . t i n
claude	k eu l . l a . u . d eu
kerschensteiner	k e . l eu . s ye n . s yu . t a . i . n eo
bruce	b eu . l u . s eu
curt	k u . l eu . t eu
henry	a ng . l i
vermeer	b e . l eu . m e . l eu
porsche	p o . l eu . s ye
regan	l i . g eo n
fries	p eu . l i . s eu
hallwachs	h a l . b a g . s eu
milstein	m i l . s eu . t e . i n
haskell	h a . s eu . k e l
phillip	p i l . l i b
maksim	m a g . s i m
marlowe	m a l . l o
congo	k o ng . g o
gerhardt	g e . l eu . h a . l eu . t eu
thompson	t o m . s eu n
grenville	g eu . l e n . b i l
pavese	p a . b e . s e
gossec	g o . s e . k eu
pufendorf	p u . p e n . d o . l eu . p eu
coubertin	k u . b e . l eu . t ae ng
flynn	p eu l . l i n
germany	d o g . i l
held	h e l . d eu
darlington	d a l . l i ng . t eo n
octave	o g . t a . b eu
arie	a . l i . e
tiffany	t i . p a . n i
phillippe	p i l . l i . p eu
renato	l e . n a . t o
dawn	d o n
ellington	e l . l i ng . t eo n
gielgud	g i l . g u . d eu
bowdler	b o . d eu l . l eo
ernest	eo . n i . s eu . t eu
somare	s o . m a . l e
jensen	ye n . s e n
nebojsa	n e . b o . i . s a
melinda	m e l . l i n . d a
runge	l u ng . g e
metz	m e . s eu
hebbel	h e . b e l
chernov	ch e . l eu . n o . p eu
sami	s a . m i
gounod	g u . n o
anthony	a n . t o . n i . o
wieman	wi . m eo n
pamela	p a . m e l . l a
grossi	g eu . l o . s i
bryce	b eu . l a . i . s eu
weyden	b a . i . d e n
racine	l a . s i n
johansen	yo . h a n . s e n
geiger	g a . i . g eo
mart	m a . l eu . t eu
ecevit	e . j e . b i . t eu
neisser	n a . i . s eo
francisco	p eu . l a n . s i . s eu . k o
davidson	d e . i . b i . s eu n
deed	d i . d eu
taglioni	t a l . l i . o . n i
alabama	ae l . l a . b ae . m a
steinberger	s eu . t a . i n . b eo . g eo
gobat	g o . b a
hensel	h e n . j e l
lamprecht	l a m . p eu . l e . h i . t eu
godwin	g o . d eu . wi n
somerset	s eo . m eo . s i s
zakaria	j a . k a . l i . a
arthur	a . d eo
canth	k a n . t eu
gordon	g o . d eu n
bolton	b o l . t eo n
mucha	m u . h a
janine	j e . n i n
athabasca	ae . s eo . b ae . s eu . k a
swinburne	s eu . wi n . b eo n
anthony	a n . s o . n i
giacosa	j a . k o . s a
buck	p eo l
amalia	a . m a l . l i . a
dante	d a n . t e
erin	e . l i n
poynting	p o . i n . t i ng
kiefer	k i . p eo
reddy	l e . d i
aman	a . m a n
koror	k o . l o . l eu
nowak	n o . wo . k eu
broch	b eu . l o . h eu
huntsville	h eo n . ch eu . b i l
auriol	o . l i . o l
edward	e . d eu . wo . d eu
golden	g o l . d eu n
alexander	a l . l e g . s a n . d eo
earle	eo l
joyner	j o . i . n eo
avery	e . b eo . l i
euler	o . i l . l eo
johnstone	j o n . s eu . t o n
titus	d i . d o . s eo
champlain	s ya ng . p eu l . l ae ng
maior	m a . i . o . l eu
wolsey	u l . j i
withers	wi . d eo . s eu
payne	p e n
johnson	yo n . s o n
foote	p u . t eu
voss	p o . s eu
reis	l a . i . s eu
belfort	b e l . p o
larkin	l a . k i n
koirala	k o . i . l a l . l a
kokoschka	k o . k o . s yu . k a
hoare	h o . eo
eisenhower	a . i . j e n . h a . wo
wiechert	b i . h e . l eu . t eu
aldo	a l . d o
costa	k o . s eu . t a
pirie	p a . i . l i
bonnet	b o . n e
stockholm	s eu . t o g . h o l . l eu m
smolensk	s eu . m o l . l e n . s eu . k eu
mili	m i l . l i
fein	p e . i n
benton	b e n . t eo n
remington	l e . m i ng . t eo n
meryl	m e . l i l
hodel	h o . d eu l
hinton	h i n . t eo n
rosse	l o . s eu
julie	j u l . l i
pallas	p a l . l a . s eu
freetown	p eu . l i . t a . u n
gundolf	g u n . d o l . p eu
sanders	s ae n . d eo . s eu
constantin	k o n . s eu . t a n . t i n
angela	a ng . g e l . l a
afghanistan	a . p eu . g a . n i . s eu . t a n
john	j o n
galli	g a l . l i
wilbur	wi l . b eo
carlos	k a . l eu l . l o . s eu
trendelenburg	t eu . l e n . d e l . l e n . b u . l eu . k eu
utah	yu . t a
ionesco	i . o . n e . s eu . k o
harcourt	h a . k o . t eu
cronin	k eu . l o . n i n
piccard	p i . k a . l eu
henriot	a ng . l i . o
sander	s ae n . d eo
castello	k a . s eu . t e l . l o
grahame	g eu . l e . i . eo m
rachel	l a . h e l
langland	l ae ng . g eu l . l eo n . d eu
hessen	h e . s e n
arkansas	a . k a n . s o
alford	a l . p o . d eu
magda	m a . g eu . d a
donnay	d o . n e
wakefield	we . i . k eu . p i l . d eu
bonnie	b o . n i
josephine	j o . s e . p i n
schnitzler	s yu . n i . ch eu l . l eo
binder	b a . i n . d eo
ruby	l u . b i
potsdam	p o . s eu . d a m
korneichuk	k o . l eu . n e . i . ch u . k eu
karol	k a . l o l
basu	b a . s u
farina	p a . l i . n a
goldin	g o l . d i n
presley	p eu . l e . s eu l . l i
marina	m a . l i . n a
huxley	h eo g . s eu l . l i
schuster	s eu . h u . s eu . t e . l eu
thom	t o m
augustus	a . u . g u . s eu . t u . s eu
gracchus	g eu . l a . k u . s eu
pimentel	p i . m e n . t e l
alessio	a l . l e . s i . o
wislicenus	b i . s eu l . l i . ch e . n u . s eu
vargas	b a . l eu . g a . s eu
giaever	g i . e . b eo
camara	k a . m a . l a
kolbe	k o l . b e
bouvet	b o . b i s
andersson	a n . d e . l eu . s o n
pechstein	p e . h i . s yu . t a . i n
pasto	p a . s eu . t o
onegin	o . n e . g i n
guiana	g i . a . n a
urbano	eo l . b a . n o
ellery	e l . l eo . l i
rubio	l u . b i . o
semenov	s e . m yo . n o . p eu
petersburg	p e . t e . s eu . b u . l eu . k eu
hunker	h a n . k a
rudiger	l u . d i . g eo
breuer	b eu . l o . i . eo
barstow	b a . l eu . s eu . t o . u
eisenstadt	a . i . j e n . s yu . t a . t eu
bari	b a . l i
law	l o
morel	m o . l e l
hurt	h eo . t eu
windelband	b i n . d e l . b a n . t eu
philippines	p i l . l i . p i n
obando	o . b a n . d o
toller	t o l . l eo
kronecker	k eu . l o . n e . k eo
seles	s e l . l e . s eu
geoffrey	j e . p eu . l i
dino	d i . n o
dorn	d o n
norman	n o . l eu . m a n
longford	l o ng . p o . d eu
seckel	s e . k eo l
doumergue	d u . m e . l eu . g eu
hensen	h e n . j e n
ling	l i ng
commons	k o . m eo n . s eu
annapolis	a . n a . p o l . l i . s eu
guggenheim	g u . g e n . h a . i m
bontempelli	b o n . t e m . p e l . l i
lacan	l a . k a ng
aldanov	a l . d a . n o . p eu
susanna	s u . s a n . n a
martha	m a . s ya
samuelsson	s a . m u . e l . s o n
algren	o l . g eu . l eo n
dicey	d a . i . s i
langevin	l a ng . j u . b ae ng
jeanne	j a n
dustin	d eo . s eu . t i n
eystein	e . s eu . t a . i n
kai	k a . i
beverly	b i . b eo . l i
bath	b a . s eu
monge	m o ng . j u
merle	m eo l
sommer	j o . m eo
hamm	h a m
herring	h e . l i ng
trygve	t eu . l wi . g eu . b e
molnar	m o l . n a
huguette	wi . g e . t eu
kutuzov	k u . t u . j o . p eu
gierek	g i . e . l e . k eu
chesterfield	ch e . s eu . t eo . p i l . d eu
tasso	t a . s o
gokhale	g o . k a l . l e
bess	b e . s eu
dirk	d eo . k eu
adelaide	ae . d eu l . l e . i . d eu
degas	d eu . g a
mead	m i . d eu
sid	s i . d eu
rude	l wi . d eu
summer	s a . m a
gay	g e . i
gajdusek	g a . i . d yu . s e g
laplace	l a . p eu l . l a . s eu
ouedraogo	u . e . d eu . l a . o . g o
temple	t e m . p eu l
yorktown	yo . k eu . t a . u n
asa	a . s a
ashraf	a . s yu . l a . p eu
idaho	a . i . d a . h o
serene	s e . l i n
nieuwland	n yu . l ae n . d eu
kachalov	k a . ch a l . l o . p eu
hewitt	h yu . i s
ogilvy	o . g eu l . b i
adler	a . d eu l . l eo
hewlett	h yu . l e s
margolis	m a . g o l . l i . s eu
hauser	h a . u . j eo
aylwin	a . i l . wi n
dean	d i n
savage	s e . b i . j i
nkrumah	eu n . k eu . l u . m a
kone	k o . n e
chicago	s i . k a . g o
hawn	h o n
iris	i . l i . s eu
serra	s e . l a
nascimento	n a . s i . m e n . t u
meadows	m i . d o . u . s eu
durham	d eo . l eo m
clark	k eu l . l a . k eu
dekker	d e . k eo
issac	a . i . j a g
bohr	b o . eo
phoebe	p o . i . b e
cagliari	k a l . l i . a . l i
huff	h eo . p eu
trujillo	t eu . l u . h i . yo
ellesmere	e l . j eu . m i . eo
basil	b ae . j eo l
peck	p e g
humboldt	h u m . b o l . t eu
glaspell	g eu l . l ae . s eu . p e l
stevie	s eu . t i . b i
pickford	p i g . p eo . d eu
alphonso	a l . p o n . s o
teitelbaum	t a . i . t e l . b a . u m
becker	b e . k eo
volta	b o l . t a
avvakum	a . b a . k u m
ferro	p e . l o
juliette	j wi l . l i . e . t eu
valentin	b a l . l e n . t i n
sullivan	s eo l . l i . b eo n
acheson	ae . ch i . s eu n
lennox	l e . n o g . s eu
blair	b eu l . l e . eo
ahn	a n
mendes	m e n . d e . s eu
hindustan	h i n . d u . s eu . t a n
johan	yo . h a n
danica	d a . n i . k a
bronzino	b eu . l o n . ch i . n o
albin	a l . b i n
idris	i . d eu . l i . s eu
chan	ch ae n
quinn	k wi n
mozart	m o . ch a . l eu . t eu
laufer	l a . u . p eo
ribeiro	l i . b e . i . l u
bast	b a . s eu . t eu
saxon	s ae g . s eu n
suslov	s u . s eu l . l o . p eu
grass	g eu . l a . s eu
cassel	k a . s e l
aragon	a . l a . g o n
gneisenau	g eu . n a . i . j e . n a . u
gayle	g e . i l
astley	ae . s eu . t eu l . l i
heron	h e . l o n
tamir	t a . m i . l eu
julian	yu l . l i . a . n u . s eu
petric	p e . t eu . l i g
warwickshire	wo . l i g . s yeo
calderwood	k a l . d eo . u . d eu
stipe	s eu . t i . p e
mali	m a l . l i
rowan	l o . eo n
benghazi	b e ng . g a . j i
philippe	p i l . l i . p eu
simi	s i . m i
hogan	h o . g eo n
stumpf	s yu . t u m . p eu
canova	k a . n o . b a
marlin	m a l . l i n
oresme	o . l e m
heck	h e g
gentile	j e n . t i l . l e
kean	k i n
butts	b eo . ch eu
biden	b a . i . d eu n
collins	k o l . l i n . s eu
pajou	p a . j u
erbakan	e . l eu . b a . k a n
souza	s u . j a
keats	k i . ch eu
negroponte	n e . g eu . l o . p o n . t e
stokes	s eu . t o . k eu . s eu
schaap	s eu . k a b
forester	p o . l e . s eu . t eo
dolph	d o l . p eu
cauchy	k o . s i
samson	s a m . s o n
pax	p a g . s eu
strick	s eu . t eu . l i g
flora	p eu l . l o . l a
breyer	b eu . l e . i . eo
schacht	s ya . h eu . t eu
osgood	o . s eu . g u s
chamberlain	ch e . i m . b eo l . l i n
bush	b u . s i
goncourt	g o ng . k u . l eu
clyde	k eu l . l a . i . d eu
hardie	h a . d i
uno	u . n o
wodehouse	u . d eu . h a . u . s eu
david	d e . i . b i . d eu
bradstreet	b eu . l ae . d eu . s eu . t eu . l i . t eu
masa	m a . s a
pires	p i . l e . s eu
acapulco	a . k a . p u l . k o
webb	we . b eu
barca	b a . l eu . k a
sangallo	s a ng . g a l . l o
hanon	a . n o ng
georges	j e . o . l eu . j e . s eu
nash	n ae . s i
dafoe	d e . p o
willoughby	wi l . l u . b i
erving	eo . b i ng
bertel	b e . l eu . t e l
adonis	a . d o . n i . s eu
wilkes	wi l . k eu . s eu
sheffield	s ye . p i l . d eu
pons	p o ng . s eu
ara	a . l a
teagarden	t i . g a . d eu n
marriott	m a . l i . o . t eu
abuja	a . b u . j a
delane	d i l . l e . i n
hubbard	h eo . b eo . d eu
espinoza	e . s eu . p i . n o . j a
siegel	s i . g e l
agnelli	a . n ye l . l i
vasconcelos	b a . s eu . k o n . s e l . l o . s eu
gill	g i l
mumford	m eo m . p eo . d eu
lindberg	l i n . d eu . b eo . g eu
enders	e n . d eo . s eu
rico	l i . k o
richet	l i . s ye
jagan	j e . i . g eo n
morais	m o . l a . i . s eu
uli	u l . l i
menelaos	m e . n e l . l a . o . s eu
alma	a l . m a
bautista	b a . t i . s eu . t a
pound	p a . u n . d eu
robles	l o . b eu l . l e . s eu
baden	b a . d e n
danieli	d a . n i . e l . l i
reichenbach	l a . i . h e n . b a . h eu
schmid	s yu . m i . d eu
morley	m o l . l i
servais	s e . l eu . b e
ulaanbaatar	u l . l a n . b a . t o . l eu
barney	b a . n i
ruska	l u . s eu . k a
goethe	g oe . t e
buono	b o . n o
loewe	l oe . b e
pisa	p i . s a
belloc	b e l . l o g
light	l a . i . t eu
lenormand	l eu . n o . l eu . m a ng
sumner	s eo m . n eo
wiley	wa . i l . l i
wilfred	wi l . p eu . l e . d eu
vicki	b i . k i
rotterdam	l o . t e . l eu . d a m
cadillac	k ae . d i l . l a g
hadley	h a . d eu l . l i
waugh	wo
toma	t o . m a
suva	s u . b a
jamestown	j e . i m . s eu . t a . u n
shostakovich	s yo . s eu . t a . k o . b i . ch i
dowden	d a . u . d eu n
glazunov	g eu l . l a . j u . n o . p eu
baker	b e . i . k eo
rebecca	l e . b e . k a
kazakhstan	k a . j a . h eu . s eu . t a n
carmona	k a . m o . n a
menderes	m e n . d e . l e . s eu
sosa	s o . s a
solti	s o l . t i
bree	b eu . l i
bromley	b eu . l o m . l i
mills	m i l . s eu
iacocca	a . i . eo . k o . k a
perth	p eo . s eu
sharp	s ya . p eu
liddell	l i . d eu l
harley	h a l . l i
southampton	s a . u . s ae m . p eu . t eo n
kissinger	k i . s i n . j eo
sologub	s o l . l o . g u . p eu
rugby	l eo g . b i
alvares	a l . b a . l e . s eu
antananarivo	a n . t a . n a . n a . l i . b o
alexandre	a l . l e g . s a ng . d eu . l eu
jordan	yo . l eu . d a n
nathan	n a . d a n
binding	b i n . d i ng
wolff	b o l . p eu
boswell	b o . j eu . we l
tasman	t a . s eu . m eo n
munsell	m eo n . s e l
nicolaus	n i . k o l . l a . u . s eu
martenot	m a . l eu . t eu . n o
reines	l a . i . n eo . s eu
puccini	p u . ch i . n i
aiken	e . i . k i n
staub	s eu . t a . u b
beets	b e . ch eu
touraine	t u . l e n
mongolia	m o ng . g o
jean	j a n
heidelberg	h a . i . d e l . b e . l eu . k eu
pollard	p o l . l a . d eu
eva	e . b a
nico	n i . k o
quirk	k wo g . k eu
monica	m o . n i . k a
petipa	p e . t i . p a
hulme	h yu m
maspero	m a . s eu . p e . l o
selznick	s e l . j eu . n i g
berne	b e . l eu n
gray	g eu . l e . i
springsteen	s eu . p eu . l i ng . s eu . t i n
probst	p eu . l o . b eu . s eu . t eu
georgetown	j o . j i . t a . u n
vance	b eo n . s eu
novgorod	n o . b eu . g o . l o . t eu
gerasimov	g e . l a . s i . m o . p eu
apollo	a . p o l . l o
wedgwood	we . j i . u . d eu
asso	a . s o
virtanen	b i . l eu . t a . n e n
scholes	s yo l . s eu
barron	b ae . l o n
bang	b a ng
hollingworth	h o l . l i ng . wo . s eu
barmen	b a . l eu . m e n
bradley	b eu . l ae . d eu l . l i
loschmidt	l o . s yu . m i . t eu
scheffel	s ye . p e l
schneider	s yu . n a . i . d eo
lynch	l i n . ch i
kolarov	k o l . l a . l o . p eu
grimmelshausen	g eu . l i . m e l . s eu . h a . u . j e n
cuvier	k wi . b i . e
gneist	g eu . n a . i . s eu . t eu
chernenko	ch e . l eu . n e n . k o
viktor	b i g . t o . l eu
kahn	k a n
hawkins	h o . k i n . s eu
thorvaldsen	t o . l eu . b a l . s e n
louisiana	l u . i . j i . ae . n a
claude	k eu l . l a . u . d e
olaf	o l . l a . p eu
krakow	k eu . l a . k o . p eu
rio	l i . u
niklas	n i . k eu l . l a . s eu
hargreaves	h a . g eu . l i . b eu . s eu
caruso	k a . l u . s o
nasser	n a . s e . l eu
falk	p o . k eu
herta	h e . l eu . t a
stone	s eu . t o n
james	j e . i m . s eu
kay	k e . i
richter	l i . h i . t eo
cobalt	k o . b a l . t eu
fizeau	p i . j o
cabell	k ae . b eo l
george	g e . o . l eu . g eu
alexandra	a l . l e g . s a n . d eu . l a
dunne	d eo n
athens	a . t e . n e
gris	g eu . l i . s eu
sigrid	s i . g eu . l i . d eu
serafin	s e . l a . p i n
svevo	s eu . b e . b o
ostade	o . s eu . t a . d e
faust	p a . u . s eu . t eu
rossetti	l o . s e . t i
francesco	p eu . l a n . ch e . s eu . k o
jeff	j e . p eu
orban	o . l eu . b eo n
bernauer	b e . l eu . n a . wo
peterborough	p i . t eo . b eo . l eo
nachtigal	n a . h eu . t i . g a l
kinsey	k i n . j e . i
melanchthon	m e l . l a n . h i . t o n
telford	t e l . p o . d eu
