arab	a . l a b
angell	e . i n . j eo l
seth	s e s
palmiro	p a l . m i . l o
deniz	d e . n i . j eu
pilcher	p i . ch eo
nicola	n i . k o l . l a
sheldon	s ye l . d eo n
alabama	ae l . l a . b ae . m a
bahar	b a . h a . l eu
lower	l o . b e . l eu
ney	n e
botsford	b o . ch eu . p o . d eu
petra	p e . t eu . l a
garland	g a l . l eo n . d eu
weinberger	wa . i n . b eo . g eo
danny	d ae . n i
everett	e . b eo . l e s
godwin	g o . d eu . wi n
alexandria	a l . l e g . s a n . d eu . l i . a
clifton	k eu l . l i . p eu . t eo n
caruso	k a . l u . s o
elton	e l . t eu n
spain	s eu . p e . i n
padua	p a . d u . a
touraine	t u . l e n
magendie	m a . j a ng . d i
krim	k eu . l i m
maurer	m a . u . l eo
korn	k o n
ephraim	e . p eu . l a . i m
ruiz	l u . i . j eu
barnett	b a . n e s
archer	a . ch eo
pickering	p i . k eo . l i ng
somalia	s o . m a l . l i . a
guardini	g wa . l eu . d i . n i
procter	p eu . l o g . t eo
sally	s ae l . l i
monique	m o . n i . k eu
rockefeller	l o g . p e l . l eo
voight	b o . i . t eu
brendel	b eu . l e n . d e l
collier	k o l . l i . eo
pisanello	p i . s a . n e l . l o
sudan	s u . d a n
buridan	b wi . l i . d a ng
hain	h e . i n
chavez	ch a . b e . s eu
espy	e . s eu . p i
jarry	j a . l i
pane	p e . i n
bonds	b o n . j eu
demeter	d e . m e . t e . l eu
mathis	m ae . t i . s eu
powell	p a . wo l
duchamp	d wi . s ya ng
marie	m a . l i
straub	s eu . t eu . l a . u . b eu
saussure	s o . s wi . l eu
johanna	yo . h a . n a
hardwicke	h a . d eu . wi . k e
martino	m a . l eu . t i . n o
nyers	n e . l eu . s i
thoreau	s o . l o
schnitzler	s yu . n i . ch eu l . l eo
ellison	e l . l i . s eu n
deville	d eu . b i l
andre	a n . d eu . l e
maxwell	m ae g . s eu . we l
sweet	s eu . wi . t eu
hoare	h o . eo
omaha	o . m a . h a
toma	t o . m a
gajdusek	g a . i . d yu . s e g
tussaud	t eo . s o
elena	e l . l e . n a
bonaparte	b o . n a . p a . l eu . t eu
schmitz	s yu . m i . ch eu
walden	we l . d eo n
harris	h ae . l i . s eu
cassin	k a . s ae ng
jammes	j a m
lipton	l i b . t eo n
petersburg	p e . t e . s eu . b u . l eu . k eu
miura	m i . u . l a
palikir	p a l . l a . k i . l eu
duer	d yu . eo
cordelia	k o . d e l . l i . a
sagan	s e . i . g eo n
batman	b ae . t eu . m ae n
blackburn	b eu l . l ae g . b eo n
franklin	p eu . l ae ng . k eu l . l i n
dufy	d wi . p i
borchardt	b o . l eu . h a . l eu . t eu
rosset	l o . s e . t eu
ari	ae . l i
monika	m o . n i . k a
malta	m o l . t a
smalley	s eu . m o l . l i
erikson	e . l i g . s eu n
picasso	p i . k a . s o
keswick	k e . s eu . wi g
allison	ae l . l i . s eu n
liechtenstein	l i . h i . t e n . s yu . t a . i n
falconet	p a l . k o . n e
chatterton	ch ae . t eo . t eo n
grant	g eu . l ae n . t eu
khalil	k a l . l i l
busoni	b u . s o . n i
quadri	k wa . d eu . l i
ludovic	l u . d o . b i
perot	p e . l o
poter	p o . t eo
irkutsk	i . l eu . k u . ch eu . k eu
mottelson	m o . t e l . s o n
northrop	n o . s eu . l eo b
ugo	u . g o
beatrix	b e . a . t eu . l i g . s eu
mun	m eo n
willi	b i l . l i
harlem	h a l . l e m
buber	b u . b eo
sofia	s o . p i . a
lessing	l e . s i ng
rostow	l o . s eu . t o . u
fonteyn	p o n . t e . i n
madge	m e . j wi
marlowe	m a l . l o
herrick	h e . l i g
monteux	m o ng . t oe
blackpool	b eu l . l ae g . p u l
galland	g a l . l a ng
marquand	m a . k wo n . d eu
luce	l u . s eu
graham	g eu . l e . i . eo m
medawar	m e . d eo . wo
discovery	d i . s eu . k eo . b eo . l i
posner	p o . j eu . n eo
baier	b a . i . eo
tad	t ae . d eu
babs	b a b . s eu
ortelius	o . l eu . t e l . l i . u . s eu
freeman	p eu . l i . m eo n
hassel	h a . s e l
menderes	m e n . d e . l e . s eu
dane	d e . i n
nicolas	n i . k eo l . l eo . s eu
spielberg	s eu . p i l . b eo . g eu
passow	p a . s yo . p eu
gustavo	g u . s eu . t a . b o
flaubert	p eu l . l o . b e . l eu
perl	p eo l
johnson	yo n . s o n
cardinal	k a . d i . n a l
gottfried	g o . t eu . p eu . l i . t eu
sprengel	s yu . p eu . l e ng . g e l
kate	k e . i . t eu
mai	m a . i
mendes	m e n . d e . s eu
claude	k eu l . l a . u . d e
asimov	a . s i . m o . p eu
abbot	a . b o . t eu
benjamin	b e n . j a . m i n
warburg	b a . l eu . b u . l eu . k eu
kathryn	k ae . s eo . l i n
emmerich	e . m eo . l i . h i
palembang	p a l . l e m . b a ng
ibrahim	i . b eu . l a . h i m
rodin	l o . d ae ng
abilene	ae . b i l . l i n
nansen	n a n . s e n
zweig	ch eu . b a . i . k eu
bowman	b o . m eo n
dora	d o . l a
bednorz	b e . d eu . n o . l eu . ch eu
revueltas	l e . b u . e l . t a
tuvalu	t u . b a l . l u
eisenstadt	a . i . j e n . s yu . t a . t eu
grew	g eu . l u
maclaren	m ae . k eu l . l ae . l eo n
insel	i n . s e l
siegel	s i . g e l
annika	a . n i . k a
alencar	a l . l e n . k a . l eu
sawyer	s o . i . eo
barrie	b ae . l i
tanguy	t a ng . g i
colt	k o l . t eu
simic	s i . m i . ch i
jansen	ya n . s e n
cadiz	k a . d i . s eu
bouillon	b u . i . yo ng
potapenko	p o . t a . p e n . k o
pitman	p i . t eu . m eo n
texas	t e g . s a . s eu
amiens	a . m i . ae ng
zane	j e . i n
campanella	k a m . p a . n e l . l a
ficino	p i . ch i . n o
durango	d u . l a ng . g o
vic	b i g
kundt	k u n . t eu
rommel	l o . m e l
higgins	h i . g i n . s eu
henry	a ng . l i
gosset	g o . s e s
rama	l a . m a
monty	m o n . t i
cram	k eu . l ae m
wheelock	h wi l . l a g
rice	l a . i . s eu
hanson	h ae n . s eu n
vitoria	b i g . t o . l i . a
edward	e . d eu . b a . l eu . t eu
marius	m a . l i . u . s eu
zhukov	j u . k o . p eu
mecklenburg	m e . k eu l . l e n . b u . l eu . k eu
easton	i . s eu . t eo n
nader	n e . i . d eo
claudia	k eu l . l a . u . d i . a
cassell	k a . s e l
brandenburg	b eu . l a n . d e n . b u . l eu . k eu
frei	p eu . l e . i
uwe	u . b e
ragusa	l a . g u . s a
gorky	g o . k i
leyte	l e . i . t e
lachmann	l a . h eu . m a n
polly	p o l . l i
nigel	n a . i . j eo l
morrison	m o . l i . s eu n
merkel	m e . l eu . k e l
lusaka	l u . s a . k a
patti	p ae . t i
gladys	g eu l . l a . i . d i . s eu
bahrain	b a . l e . i n
wallace	wo l . l a . s eu
frost	p eu . l o . s eu . t eu
bennett	b e . n e s
andes	a n . d e . s eu
frits	p eu . l i . ch eu
fernand	p e . l eu . n a ng
mellon	m e l . l eo n
mahmoud	m a . m u . d eu
taine	t e n
penny	p e . n i
odets	o . d e . ch eu
duvall	d yu . b a l
brentano	b eu . l e n . t a . n o
ismael	i . s eu . m a . e l
terra	t e . l a
mendelssohn	m e n . d e l . s eu . j o n
eusebio	e . u . s e . b i . u
kees	k i . s eu
aldington	o l . d i ng . t eo n
wiesel	b i . s e l
halle	h a l . l e
onsager	o n . s a . g eo
cassel	k a . s e l
freya	p eu . l o . i . ya
walter	wo l . t eo
hague	h e . i . g eu
carter	k a . t eo
hobsbawm	h o b . s eu . b o m
rabinowitz	l a . b i . n o . b i . ch eu
laurent	l o . l a ng
ibarbourou	i . b a . l eu . b u . l u
bridgetown	b eu . l i . j i . t a . u n
robin	l o . b i n
vidal	b i . d a l
cassandra	k a . s a n . d eu . l a
hofmann	h o . p eu . m a n
kantor	k ae n . t eo
perutz	p eo . l u . ch eu
bryce	b eu . l a . i . s eu
meryl	m e . l i l
roque	l o . k e
hacks	h a g . s eu
bisset	b i . s e s
haris	h a . l i . s eu
latham	l e . i . d a m
cochin	k o . ch i n
polk	p o . k eu
gretchen	g eu . l e . ch e n
aloysius	a l . l u . a . s i . u . s eu
matthew	m ae . s yu
bode	b o . d e
johnston	j o n . s eu . t o n
bebel	b e . b e l
basin	b a . s i n
etcheverry	e . ch wi . b e . l i
sachs	s ae g . s eu
piraeus	p i . l e . u . s eu
mississippi	m i . s i . s i . p i
bertil	b e . l eu . t i l
alfieri	a l . p i . e . l i
thornton	s o n . t eu n
mara	m a . l a
pullman	p u l . m eo n
opitz	o . p i . ch eu
darling	d a l . l i ng
darko	d a . l eu . k o
barth	b a . l eu . t eu
lennart	l e n . n a . l eu . t eu
lister	l i . s eu . t eo
kessel	k e . s e l
bree	b eu . l i
viotti	b i . o . t i
lie	l i
pachelbel	p a . h e l . b e l
ellsworth	e l . j eu . wo . s eu
bunsen	b u n . j e n
truman	t eu . l u . m eo n
wole	wo l . l e
mang	m a ng
eyre	e . eo
moura	m o . l a
thaddeus	d a . d ae . o
seaborg	s i . b o . g eu
grimm	g eu . l i m
clements	k eu l . l e . m eo n . ch eu
chiesa	k i . e . s a
wolfers	wo l . p eo . s eu
sert	s eo . t eu
kissinger	k i . s i n . j eo
tasha	t a . s ya
friedrich	p eu . l i . d eu . l i . h i
basu	b a . s u
sterne	s eu . t eo n
dowson	d a . u . s eu n
punsalmaagiyn	p u n . s a l . m a . g i n
hoss	h o . s eu
girard	j i . l a . d eu
fedin	p e . d i n
hopp	h o . p eu
faiz	p e . i . j eu
hewlett	h yu . l e s
clearwater	k eu l . l i . eo . wo . t eo
fuller	p u l . l eo
mitscherlich	m i . ch eo . l i . h i
pereira	p e . l e . i . l a
topeka	t o . p i . k a
laine	l e . i n
eminescu	e . m i . n e . s eu . k u
romano	l o . m a . n o
clarendon	k eu l . l ae . l eo n . d eo n
dorsey	d o . eo . s i
salih	ss a l . l i . h eu
verde	b e . l eu . d e
berlage	b e . l eu l . l a . h e
johannesburg	yo . h a . n e . s eu . b eo . g eu
juliet	j u l . l i . e s
garrison	g ae . l i . s eu n
markov	m a . l eu . k o . p eu
elliott	e l . l i . eo s
fouquet	p u . k e
dacca	d a . k a
secchi	s e . k i
poole	p u l
capa	k a . p a
lamy	l a . m i
finch	p i n . ch i
erich	e . l i . h i
schulz	s yu l . ch eu
ilyushin	i l . l yu . s i n
erastus	e . l a . s eu . t u . s eu
ferdinand	p e . l eu . d i . n a n . d eu
azad	a . j a . d eu
octave	o g . t a . b eu
whistler	h wi . s eu l . l eo
giuseppe	j u . s e . p e
nicolai	n i . k o l . l a . i
pizarro	p i . s a . l o
maggie	m ae . g i
rawlinson	l o l . l i n . s eu n
overton	o . b eo . t eu n
guinea	g i . n i
willcocks	wi l . k o g . s eu
prokofiev	p eu . l o . k o . p i . ye . p eu
lacombe	l a . k o m
nash	n ae . s i
nadar	n a . d a . l eu
poiseuille	p o . a . j eu . i . yu
ioffe	yo . p e
cecilia	s e . s i l . l i . a
hinton	h i n . t eo n
murmansk	m u . l eu . m a n . s eu . k eu
ouedraogo	u . e . d eu . l a . o . g o
sammy	s ae . m i
moroni	m o . l o . n i
shoemaker	s yu . m e . i . k eo
batchelor	b ae . ch e l . l eo
taunton	t o n . t eo n
sandburg	s ae n . d eu . b eo . g eu
inga	i ng . g a
bieber	b i . b eo
barr	b a
barnet	b a . n e s
bienville	b i . e n . b i l
natalie	n a . t a l . l i
canada	k ae . n a . d a
lucy	l u . ss i
arnauld	a . l eu . n o
hartle	h a . t eu l
ratner	l e . t eu . n eo
olive	o l . l i . b eu
grein	g eu . l a . i n
mumford	m eo m . p eo . d eu
hertford	h a . t eu . p eo . d eu
roman	l o . m a n
basque	b a . s eu . k eu
carol	k ae . l eo l
aldrin	o l . d eu . l i n
laughton	l o . t eu n
vella	b e l . l a
lund	l u n . d eu
tarkington	t a . k i ng . t eo n
masaccio	m a . s a . ch o
hellsing	h e l . s i ng
wedekind	b e . d e . k i n . t eu
tonga	t o ng . g a
stafford	s eu . t ae . p o . d eu
khamenei	h a . m e . n e . i
poe	p o
lancaster	l ae ng . k eo . s eu . t eo
cohan	k o . h ae n
pourcel	p u . l eu . s e l
mathews	m ae . t yu . s eu
patrick	p a . t eu . l i . k eu
george	g e . o . l eu . g eu
lesotho	l e . s o . t o
metternich	m e . t e . l eu . n i . h i
orenburg	o . l e n . b u . l eu . k eu
boulder	b o . u l . d eo
devi	d e . b i
kiev	k i . ye . p eu
madras	m a . d eu . l a . s eu
shipley	s i . p eu l . l i
hauptmann	h a . u b . t eu . m a n
lautner	l o . t eu . n eo
rocco	l o . k o
amir	a . m i . l eu
gainsborough	g e . i n . j eu . b eo . l eo
gertrude	g eo . t eu . l u . d eu
kurt	k u . l eu . t eu
naipaul	n a . i . p o l
kipling	k i . p eu l . l i ng
lothian	l o . d i . eo n
frakes	p eu . l e . i . k eu
ochirbat	o . ch i . l eu . b a . t eu
bernd	b e . l eu n . t eu
lindsey	l i n . j i
amontons	a . m o ng . t o ng
mackintosh	m ae . k i n . t o . s i
mayflower	m e . i . p eu l . l a . wo
mora	m o . l a
lepsius	l e b . s i . u . s eu
munk	m u ng . k eu
urbano	eo l . b a . n o
lothar	l o . t a . eo
harald	h a . l a l . t eu
richardson	l i . ch eo . d eu . s eu n
sadik	s a . d i . k eu
tansley	t ae n . s eu l . l i
mia	m i . a
fernandez	p e . l eu . n a n . d e . s eu
millais	m i l . l e . i
fiorentino	p i . o . l e n . t i . n o
jill	j i l
hobbes	h o b . s eu
eberhard	e . b e l . h a . l eu . t eu
russia	l eo . s i . a
peters	p i . t eo . s eu
chess	ch e . s eu
oldenburg	o l . d e n . b u . l eu . k eu
salim	s a l . l i m
marx	m a . l eu . k eu . s eu
kane	k e . i n
staffordshire	s eu . t ae . p eo . d eu . s yeo
philippi	b i l . l i b . b o
rodrigues	l o . d eu . l i . g e . s eu
richter	l i . h i . t eo
heyman	h e . i . m eo n
bengt	b e ng . t eu
stoss	s yu . t o . s eu
ross	l o . s eu
lotto	l o . t o
brussels	b eu . l wi . s e l
grillparzer	g eu . l i l . p a . l eu . ch eo
middlesex	m i . d eu l . s e g . s eu
mogens	m o . g e n . s eu
patton	p ae . t eu n
herbert	h eo . b eo . t eu
athabasca	ae . s eo . b ae . s eu . k a
nancy	n a ng . s i
bangkok	b a ng . k o g
yitzhak	i . ch eu . h a . k eu
philippa	p i l . l i . p a
baekeland	b e . i . k eu l . l ae n . d eu
huntington	h eo n . t i ng . t eo n
amin	a . m i n
boveri	b o . b e . l i
perkins	p eo . k i n . s eu
wilhelm	b i l . h e l . l eu m
frazer	p eu . l e . i . j eo
chagall	s ya . g a l
feldstein	p e l . d eu . s eu . t a . i n
benz	b e n . ch eu
rambo	l a m . b o
frank	p eu . l a ng . k eu
karrer	k a . l eo
australia	o . s eu . t eu . l e . i l . l i . a
bush	b u . s i
caro	k a . l o
gould	g u l . d eu
faure	p o . l e
jose	j o . j e
short	s yo . t eu
haskell	h a . s eu . k e l
francesca	p eu . l a n . ch e . s eu . k a
walter	b a l . t eo
dunstable	d eo n . s eu . t eo . b eu l
cornforth	k o n . p o . s eu
eads	i . j eu
molander	m o l . l a n . d eo
bacon	b e . i . k eo n
dessau	d e . s a . u
sargent	s a . j eo n . t eu
pepys	p i . p eu . s eu
samar	s a . m a . l eu
randy	l ae n . d i
wingrove	wi n . g eu . l o . b eu
afanasiev	a . p a . n a . s i . ye . p eu
gilbreth	g i l . b eu . l e . s eu
azerbaijan	a . j e . l eu . b a . i . j a n
schweizer	s yu . b a . i . ch eo
meg	m ae g
potanin	p o . t a . n i n
cabanas	k a . b a . n a . s eu
spenser	s eu . p e n . s eo
menelaos	m e . n e l . l a . o . s eu
queen	k wi n
haarlem	h a . l eu l . l e m
guyau	g wi . yo
ortiz	o . l eu . t i . s eu
rau	l a . u
torres	t o . l e . s eu
dee	d i
malthus	m ae l . s eo . s eu
sarajevo	s a . l a . ye . b o
hesse	h e . s e
cambiaso	k a m . b i . a . s o
evelyn	e . b eo l . l i n
foote	p u . t eu
luiz	l u . i . j eu
rabi	l a . b i
thorez	t o . l e . j eu
cesare	ch e . s a . l e
marino	m a . l i . n o
massa	m a . s a
schweitzer	s yu . b a . i . ch eo
machiavelli	m a . k i . a . b e l . l i
martenot	m a . l eu . t eu . n o
windsor	wi n . j eo
victor	b i g . t eo
cyndi	s i n . d i
ciano	ch i . a . n o
rumsey	l eo m . j i
lana	l a . n a
haidar	h a . i . d a . l eu
islamabad	i . s eu l . l a . m a . b a . d eu
binyon	b i . n i . eo n
solovyov	s o l . l o . b i . yo . p eu
wise	wa . i . j eu
dannemann	d a . n e . m a n
moretti	m o . l e . t i
runeberg	l u . n e . b e . l i
grass	g eu . l a . s eu
bundy	b eo n . d i
arndt	a . l eu n . t eu
stoyanov	s eu . t o . ya . n o . p eu
semyonov	s e . m yo . n o . p eu
santiago	s a n . t i . a . g o
perugino	p e . l u . j i . n o
violet	b a . i . o l . l e s
crommelynck	k eu . l o m . l ae ng . k eu
kondo	k o n . d o
boston	b o . s eu . t eo n
morton	m o . t eo n
essen	e . s e n
cheney	ch e . n i
waksman	wa g . s eu . m eo n
deaver	d i . b eo
eriksen	e . l i g . s e n
kapitsa	k a . p i . ch a
yates	ye . i . ch eu
moody	m u . d i
sickingen	j i . k i ng . g e n
matute	m a . t u . t e
garibaldi	g a . l i . b a l . d i
reading	l e . d i ng
manson	m ae n . s eu n
siewert	s i . wo . t eu
lisbon	l i . s eu . b o n
berzelius	b e . l eu . s e l . l i . u . s eu
kuprin	k u . p eu . l i n
hansen	h a n . s e n
griffis	g eu . l i . p i . s eu
muller	m eo l . l eo
woodrow	u . d eu . l o
campos	k a m . p u . s eu
doris	d o . l i . s eu
junker	yu ng . k eo
marriott	m a . l i . o . t eu
gusou	g u . ss eo . u
langbein	l ae ng . b a . i n
keon	k i . o n
abel	a . b e l
cabell	k ae . b eo l
lexington	l e g . s i ng . t eo n
shah	s ya . a
bartley	b a . t eu . l i
joseph	yo . s e b
serlio	s e . l eu l . l i . o
chissano	s i . s a . n o
sandi	s ae n . d i
artigas	a . l eu . t i . g a . s eu
chaim	k a . i m
arrhenius	a . l e . n i . u . s eu
salem	s a l . l e m
broglie	b eu . l o . g eu l . l i
albany	o l . b eo . n i
scofield	s eu . k o . p i l . d eu
hitchings	h i . ch i ng . s eu
boise	b o . i . s i
boussinesq	b u . s eu . n e . s eu . k eu
gable	g e . i . b eu l
gapon	g a . p o n
enzo	e n . j o
nebojsa	n e . b o . i . s a
giolitti	j o l . l i . t i
kaplan	k ae . p eu l . l a n
tyson	t a . i . s eu n
adler	a . d eu l . l eo
pfeffer	p e . p eo
malcolm	m ae l . k eo m
jacobs	j e . i . k o b . s eu
holst	h o l . s eu . t eu
buono	b o . n o
giuliano	j u l . l i . a . n o
tiepolo	t i . e . p o l . l o
claxton	k eu l . l e g . s eu . t eo n
eritrea	e . l i . t eu . l e . a
gunnar	g u n . n a . l eu
paola	p a . o l . l a
charpentier	s ya . l eu . p a ng . t i . e
romania	l u . m a . n i . a
wollaston	u l . l eo . s eu . t eo n
weinberg	wa . i n . b eo . g eu
farmington	p a . m i ng . t eo n
osbourne	o . s eu . b o n
fizeau	p i . j o
risa	l i . s a
worthington	wo . s i ng . t eo n
desmoulins	d e . m u l . l ae ng
crispin	k eu . l i . s eu . p i . n u . s eu
bern	b e . l eu n
cressent	k eu . l e . s a ng
westergaard	we . s eu . t eo . g a . d eu
black	b eu l . l ae g
garry	g e . l i
barna	b a . n a
ghana	g a . n a
cone	k o n
mikhailov	m i . h a . i l . l o . p eu
lake	l e . i . k eu
josephson	j o . j i . p eu . s eu n
jackson	j ae g . s eu n
trevithick	t eu . l e . b i . s i g
mcguire	m ae g . g wa . i . eo
kraus	k eu . l a . u . s eu
tehran	d e . h e . l a n
dante	d a n . t e
blanc	b eu l . l a ng
zelaya	j e . l a . ya
eggleston	e . g eu l . s eu . t eo n
julius	yu l . l i . u . s eu
ionesco	i . o . n e . s eu . k o
bonner	b o . n eo
bergius	b e . l eu . g i . u . s eu
southern	s eo . d eo n
poland	p o l . l a n . d eu
khorana	k o . l a . n a
albania	a l . b a . n i . a
josephus	yo . s e . p u . s eu
praga	p eu . l a . g a
block	b eu l . l o g
montreuil	m o ng . t eu . l eu . yu
sharp	s ya . p eu
prasad	p eu . l a . s a . d eu
gheorghiu	g e . o . l eu . g yu
jaroslav	ya . l o . s eu l . l a . p eu
renner	l e . n eo
abruzzi	a . b eu . l u . ch i
siegen	j i . g e n
dario	d a . l i . o
emanuel	e . m a . n u . e l
bophuthatswana	b o . p eu . t a . ch eu . wa . n a
machado	m a . ch a . d o
fort	p o . l eu
ouagadougou	wa . g a . d u . g u
matilda	m a . t i l . d a
hugo	wi . g o
koror	k o . l o . l eu
massenet	m a . s eu . n e
cennini	ch e n . n i . n i
hellen	h e l . l e n
kean	k i n
keiser	k a . i . j eo
stirner	s yu . t i . l eu . n eo
orestes	o . l e . s eu . t e . s eu
sulla	s u l . l a
goldie	g o l . d i
ulanova	u l . l a . n o . b a
adani	a . d a . n i
kalman	k a l . m a n
otis	o . t i . s eu
becher	b e . h eo
suk	s u . k eu
khomeini	h o . m e . i . n i
serao	s e . l a . o
leboeuf	l eu . b oe . p eu
root	l u . t eu
albers	a l . b e . l eu . s eu
seckel	s e . k eo l
mironov	m i . l o . n o . p eu
schelling	s ye l . l i ng
turkmenistan	t u . l eu . k eu . m e . n i . s eu . t a n
howell	h a . we l
larkin	l a . k i n
zacharias	j a . k a . l i . a . s eu
pire	p i . l eu
landes	l ae n . j eu
bangalore	b a ng . g a l . l o . l eu
kerschensteiner	k e . l eu . s ye n . s yu . t a . i . n eo
madeira	m a . d e . i . l a
hammerstein	h ae . m eo . s eu . t a . i n
schinkel	s i ng . k e l
ram	l ae m
buswell	b eo . s eu . we l
lynda	l i n . d a
pike	p a . i . k eu
colmar	k o l . m a . l eu
beth	b e . s eu
dryden	d eu . l a . i . d eu n
sophia	s o . p i . a
ribera	l i . b e . l a
solis	s o l . l i . s eu
sinai	s i . n a . i
kashmir	k a . s yu . m i . l eu
sears	ss i . eo . s eu
orban	o . l eu . b eo n
agnes	a . g eu . n e . s eu
arizona	ae . l i . j o . n a
hilton	h i l . t eo n
milan	m i l . l a . n o
eager	i . g eo
boethius	b o . i . t i . u . s eu
paris	p a . l i
cuthbert	k eo . s eu . b eo . t eu
abbe	a . b e
chester	ch e . s eu . t eo
biagio	b i . a . j i . o
kalimantan	k a l . l i . m a n . t a n
harrington	h ae . l i ng . t eo n
felix	p e l . l i g . s eu
basso	b a . s o
petrarca	p e . t eu . l a . l eu . k a
aslan	a . s eu l . l a n
vladimir	b eu l . l a . d i . m i . l eu
ramuz	l a . m wi
labuan	l a . b u . a n
lang	l a ng
funafuti	p u . n a . p u . t i
yao	ya . o
housman	h a . u . s eu . m eo n
polevoi	p o l . l e . b o . i
mansart	m a ng . s a . l eu
knox	n o g . s eu
valeri	b a l . l e . l i
helena	h e l . l e . n a
bettino	b e . t i . n o
koblenz	k o . b eu l . l e n . ch eu
bradford	b eu . l e . d eu . p o . d eu
snider	s eu . n a . i . d eo
cronaca	k eu . l o . n a . k a
arther	a . s eo
tana	t a . n a
honeywell	h a . n i . we l
donna	d o . n a
karim	k a . l i m
gerard	j e . l a . l eu
ventura	b e n . ch yu . l a
mondriaan	m o n . d eu . l i . a n
moers	m o . eo . s eu
amyot	a . m i . yo
poncelet	p o ng . s eu l . l e
branco	b eu . l a ng . k o
cornelio	k o . l eu . n e l . l i . o
rein	l e . i n
warsaw	b a . l eu . s ya . b a
brodsky	b eu . l o . d eu . s eu . k i
utrillo	yu . t eu . l i l . l o
babbitt	b a . b i . t eu
negro	n i . g eu . l o
yorke	yo . k eu
allan	ae l . l eo n
woods	u . j eu
zunzunegui	s u n . s u . n e . g i
flaherty	p eu l . l a . eo . t i
jim	j i m
hanoi	h a . n o . i
dover	d o . b eo
auriol	o . l i . o l
adriano	a . d eu . l i . a . n o
pankhurst	p ae ng . k eu . h eo . s eu . t eu
gilberto	j i l . b e . l eu . t o
bowen	b o . e n
stone	s eu . t o n
moustapha	m u . s eu . t a . p a
mori	m o . l i
carducci	k a . l eu . d u . ch i
mussolini	m u s . s o l . l i . n i
valero	b a l . l e . l o
gattuso	g a . t u . s o
bonn	b o n
elmo	e l . m o
casella	k a . s e l . l a
willem	b i l . l e m
hyde	h a . i . d eu
lot	l o s
ithaca	i . t a . k a
talbot	t o l . b eo s
federico	p e . d e . l i . k o
sankey	s ae ng . k i
inverness	i n . b eo . n e . s eu
fiji	p i . j i
will	wi l
braham	b eu . l ae . h eo m
smedley	s eu . m e . d eu l . l i
langdon	l ae ng . d eo n
goethals	g o . s eo l . s eu
smeaton	s eu . m i . t eo n
salvatore	s a l . b a . t o . l e
aguirre	a . g i . l e
afghanistan	a . p eu . g a . n i . s eu . t a n
edgeworth	e . j i . wo . s eu
winkler	b i ng . k eu l . l eo
kaas	k a . s eu
lubbock	l eo . b eo g
bouvet	b o . b i s
sen	s e n
kursk	k u . l eu . s eu . k eu
levin	l e . b i n
gamarra	g a . m a . l a
borrow	b o . l o
campo	k a m . p o
thorndike	s o n . d a . i . k eu
burman	b eo . m a
romanov	l o . m a . n o . p eu
penderecki	p e n . d e . l e . ch eu . k i
saleh	s a l . l e
mackay	m ae g . k e . i
bihar	b i . h a . l eu
carry	k e . eo . l i
pisarev	p i . s a . l e . p eu
ge	g e
dobrolyubov	d o . b eu . l u l . l yu . b o . p eu
lippmann	l i . p eu . m a n
paddy	p ae . d i
fryer	p eu . l a . i . eo
michelet	m i . s yu l . l e
toronto	t o . l o n . t o
weismann	b a . i . s eu . m a n
rhine	l a . i n
nevada	n e . b a . d a
deutsch	d o . i . ch i
heuss	h o . i . s eu
rex	l e g . s eu
andropov	a n . d eu . l o . p o . p eu
castlereagh	k ae . s eu l . l e . i
gallo	g a l . l o
kennedy	k e . n e . d i
hodge	h o . j i
kirov	k i . l o . p eu
dowden	d a . u . d eu n
vazov	b a . j o . p eu
margarete	m a . l eu . g a . l e . t e
vinay	b i . n a . i
dnieper	d eu . n e . p eu . l eu
billie	b i l . l i
dekker	d e . k eo
brahms	b eu . l a m . s eu
dirichlet	d i . l i . k eu l . l e
nevelson	n i . b e l . s eu n
vivienne	b i . b i . a n
glenda	g eu l . l e n . d a
byelorussia	b e l . l o . l u . s i
kayser	k a . i . j eo
rufus	l u . p eo . s eu
elman	e l . m eo n
bali	b a l . l i
trinidad	t eu . l i . n i . d a . d eu
reuben	l eu . u . b e n
dianne	d a . i . ae n
ruggiero	l u . j i . e . l o
gasparri	g a . s eu . p a . l i
gabin	g a . b ae ng
ephesus	e . p e . s u . s eu
wales	we . i l . s eu
thebes	t e . b e
petri	p e . t eu . l i
wynn	wi n
liberia	l a . i . b e . l i . a
korolenko	k o . l o l . l e n . k o
starr	s eu . t a
bjerknes	b i . e . l eu . k eu . n e . s eu
indiana	i n . d e . e . n a
waley	we . i l . l i
quayle	k we . i l
donne	d eo n
cosa	k o . s a
graf	g eu . l a . p eu
nepal	n e . p a l
hardy	h a . d i
sutherland	s eo . d eo l . l ae n . d eu
maher	m a . h e . l eu
summer	s a . m a
oslo	o . s eu l . l o
stockholm	s eu . t o g . h o l . l eu m
johnstown	j o n . s eu . t a . u n
cowan	k o . wa n
marvin	m a . b i n
judith	yu . d i . s eu
coppola	k o . p eu l . l a
simons	s a . i . m eo n . j eu
elise	e l . l i . s eu
piccinni	p i . ch i n . n i
reppe	l e . p e
caine	k e . i n
seligman	s e l . l i . g eu . m eo n
manuela	m a . n u . e l . l a
haugland	h e . u l . l a n
betjeman	b e . ch eo . m eo n
loewe	l oe . b e
rand	l ae n . d eu
borge	b o . l eu . g eu
sonya	s o . n ya
oresme	o . l e m
rombach	l o m . b a . h eu
carlo	k a . l eu l . l o
kuwait	k u . we . i . t eu
mabel	m a . b e l
crawford	k eu . l o . p eo . d eu
antonio	a n . t o . n i . o
angelou	ae n . j e l . l u
hamza	h a m . j a
ratzenhofer	l a . ch e n . h o . p eo
tallis	t ae l . l i . s eu
valentin	b a l . l e n . t i n
gioberti	j o . b e . l eu . t i
bismarck	b i . j eu . m a . k eu
hicks	h i g . s eu
roy	l o . i
motta	m o . t a
carroll	k ae . l o l
erwin	eo . wi n
lombroso	l o m . b eu . l o . s o
gaye	g e . i
daniele	d a . n i . e l
massachusetts	m ae . s a . ch u . s e . ch eu
neutra	n o . i . t eu . l a
henze	h e n . ch e
albano	a l . b a . n o
tiger	t a . i . g eo
entebbe	e n . t e . b e
tweed	d e . d o
waugh	wo
piel	p i . e l
caxias	k a . s i . a . s eu
mansfield	m ae n . s eu . p i l . d eu
ferenc	p e . l e n . ch eu
smetana	s eu . m e . t a . n a
barlach	b a . l eu l . l a . h eu
anja	a n . ya
santos	s a n . t u . s eu
pirandello	p i . l a n . d e l . l o
colby	k o l . b i
dunant	d wi . n a ng
ayer	e . i . eo
longo	l o ng . g o
twining	t eu . wa . i . n i ng
tasman	t a . s eu . m eo n
oakeshott	o . k eu . s yeo . t eu
kilkenny	k i l . k e . n i
tajo	t a . h o
wyler	wa . i l . l eo
tristan	t eu . l i . s eu . t a ng
henning	h e . n i ng
smith	s eu . m i . s eu
nazareth	n a . s a . l e s
benigno	b e . n i . g eu . n o
mencken	m e ng . k e n
chiara	k i . a . l a
sadi	s a . d i
laurens	l o . l a ng . s eu
honda	h o n . d a
bassi	b a . s i
bob	b a b
piston	p i . s eu . t eo n
delhi	d e l . l i
nerva	n e . l eu . b a
mendes	m e n . d i . s eu
defoe	d i . p o
ruud	l wi . t eu
carpenter	k a . p e n . t eo
potsdam	p o . s eu . d a m
baumann	b a . u . m a n
licht	l i . h i . t eu
chevrolet	s i . b o . l e
voss	p o . s eu
leroy	l i . l o . i
farley	p a l . l i
yvon	i . b o ng
portman	p o . t eu . m a n
salt	s o l . t eu
butterfield	b eo . t eo . p i l . d eu
obando	o . b a n . d o
sisley	s i . s eu l . l e
lagerkvist	l a . g e . l eu . k eu . b i . s eu . t eu
rasmussen	l a . s eu . m u . s e n
theresa	t e . l e . s a
grigorovich	g eu . l i . g o . l o . b i . ch i
branting	b eu . l a n . t i ng
ellie	e l . l i
bonsels	b o n . j e l . s eu
cathy	k ae . s i
rauschenbusch	l a . u . s yeo n . b u . s i
hans	h a n . s eu
lille	l i l
hatton	h ae . t eu n
schlick	s yu l . l i . k eu
dov	d o . b eu
ball	b o l
glasgow	g eu l . l ae . s eu . g o
carley	k a l . l i
auerbach	a . u . eo . b a . h eu
massinger	m ae . s i n . j eo
tracy	t eu . l e . i . s i
addison	ae . d i . s eu n
painter	p e . i n . t eo
mehta	m e . t a
miguel	m i . g e l
cadena	k a . d e . n a
bryusov	b eu . l yu . s o . p eu
arthur	a . d eo
gross	g eu . l o . s eu
omar	o . m a
scholz	s yo l . ch eu
rodolfo	l o . d o l . p o
lesser	l e . s eo
edmundo	e . d eu . m o n . d eu
italy	i . t a l . l i . a
hutchinson	h eo . ch i n . s eu n
jamal	j a . m a l
geissler	g a . i . s eu l . l eo
hardwick	h a . d eu . wi g
catilina	k a . t i l . l i . n a
seuse	j o . i . j e
welty	we l . t i
roberto	l o . b e . l eu . t o
reynolds	l e . i . n o l . j eu
nikolai	n i . k o l . l a . i
pauker	p a . u . k e . l eu
mccann	m ae g . k ae n
marina	m a . l i . n a
grasse	g eu . l ae . s eu
haynes	h e . i n . j eu
naumann	n a . u . m a n
basil	b ae . j eo l
quin	k wi n
marisa	m a . l i . s a
koerner	k oe . l eu . n eo
dowdeswell	d o . d e . s eu . b e l
ewing	yu . i ng
pompidou	p o ng . p i . d u
dixie	d i g . s i
surikov	s u . l i . k o . p eu
xie	s ye
katherine	k ae . s eo . l i n
parker	p a . k eo
bojan	b o . ya n
turgot	t wi . l eu . g o
moshe	m o . s ye
hawthorn	h o . s o n
landers	l ae n . d eo . s eu
elizabethe	e l . l i . j a . b e . s eu
gottsched	g o . t eu . s ye . t eu
lytton	l i . t eo n
sands	s ae n . j eu
brattain	b eu . l ae . t eu n
baku	b a . k u
hirsch	h eo . s wi
dordrecht	d o . l eu . t eu . l e . h i . t eu
boileau	b u . a l . l o
nehru	n e . l u
gascoigne	g ae . s eu . k o . i n
kassem	k a . s e m
malipiero	m a l . l i . p i . e . l o
maldives	m o l . d i . b eu
diller	d i l . l eo
noble	n o . b eu l
fran	p eu . l a n
ibsen	i b . s e n
blanco	b eu l . l a ng . k o
macedonia	m a . k e . d o . n i . a
saraiva	s a . l a . i . b a
pavlova	p a . b eu l . l o . b a
cottbus	k o s . b u . s eu
temin	t e . m i n
gaborone	g a . b o . l o . n e
napolitano	n a . p o l . l i . t a . n o
storm	s yu . t o . l eu m
pater	p e . i . t eo
jorge	j o . l eu . j e
giambattista	j a m . b a . t i . s eu . t a
drinkwater	d eu . l i ng . k eu . wo . t eo
nasir	n a . s i . l eu
cather	k ae . d eo
alekseev	a l . l e g . s e . ye . p eu
florida	p eu l . l o . l i . d a
zorrilla	s o . l i . ya
strang	s eu . t eu . l ae ng
junqueiro	j u n . k e . i . l u
kircher	k i . l eu . h eo
bourgeois	b u . l eu . j u . a
uccello	u . ch e l . l o
cornell	k o . n e l
ioan	i . o . a n
kempff	k e m . p eu
puig	p eu . i . g eu
orwell	o . we l
clifford	k eu l . l i . p eo . d eu
alexandra	a l . l e g . s a n . d eu . l a
perlman	p eo l . m a n
canova	k a . n o . b a
arcos	a . l eu . k o . s eu
bernier	b e . l eu . n i . e
diane	d a . i . a n
villon	b i . yo ng
jakobson	ya . k o b . s eu n
michigan	m i . s i . g a n
tiele	t i l . l e
zeppelin	ch e . p e l . l i n
watkins	wa s . k i n . s eu
everest	e . b e . l e . s eu . t eu
reinecke	l a . i . n e . k e
dubcek	d u . b eu . ch e . k eu
hagen	h a . g e n
hartley	h a . t eu l . l i
karlfeldt	k a l . p e l . t eu
todor	t o . d o . l eu
almeida	a l . m e . i . d a
boucher	b a . u . ch eo
goodnow	g u s . n o . u
padilla	p a . d i l . l a
pasternak	p a . s eu . t e . l eu . n a . k eu
camara	k a . m a . l a
diefenbaker	d i . p e n . b e . i . k eo
eden	e . d e n
sumarokov	s u . m a . l o . k o . p eu
walsh	wa l . s i
victoria	b i g . t o . l i . a
gullstrand	g u l . s eu . t eu . l a n . d eu
hereford	h e . l i . p eo . d eu
giusti	j u . s eu . t i
stern	s yu . t e . l eu n
markham	m a . k a m
georgia	g eu . l u . j i . a
geibel	g a . i . b e l
bogota	b o . g o . t a
scala	s eu . k a l . l a
hilda	h i l . d a
cyrus	k i . l o . s eu
winters	wi n . t eo . s eu
elba	e l . b a
bess	b e . s eu
loeb	l eo . b eu
baty	b a . t i
karol	k a . l o l
weder	we . d eo
david	d a . b i . d eu
toledo	t eo l . l i . d o
champlain	s ya ng . p eu l . l ae ng
prosper	p eu . l o . s eu . p e . l eu
antunes	a n . t u . n e . s eu
verhoeven	b eo . h o . b e n
detroit	d i . t eu . l o . i . t eu
degas	d eu . g a
battle	b ae . t eu l
reilly	l a . i l . l i
barber	b a . b eo
vento	b e n . t o
kiowa	k a . i . o . wa
vesuvius	b e . s u . b i . o
warner	wo . n eo
torrence	t o . l eo n . s eu
boghossian	b o . g o . s i . a ng
bromfield	b eu . l o m . p i l . d eu
jay	j e . i
armenia	a . l eu . m e . n i . a
engels	e ng . g e l . s eu
murry	m eo . l i
horowitz	h o . l o . b i . ch eu
chic	ch i g
benacerraf	b e . n a . s e . l a . p eu
millard	m i l . l eo . d eu
greely	g eu . l i l . l i
gregorio	g eu . l e . g o . l i . o
dafoe	d e . p o
justin	j eo . s eu . t i n
taglioni	t a l . l i . o . n i
nie	n ye
meister	m e . i . s eu . t eo
burnley	b eo n . l i
pearson	p i . eo . s eu n
wagner	b a . g eu . n eo
danzig	d a n . ch i . h i
ullman	u l . m a n
stalin	s eu . t a l . l i n
jerzy	ye . j i
sabin	s e . i . b i n
bose	b o . s eu
hanover	h a . n o . b eo
schwarz	s yu . wa l . ch eu
saran	s a . l a n
gay	g e . i
jamsa	j a m . s a
angelika	a ng . g e l . l i . k a
imhoff	i m . h o . p eu
narciso	n a . l eu . s i . s o
orel	o . l e l
koch	k o . h eu
leoncavallo	l e . o n . k a . b a l . l o
veronica	b e . l o . n i . k a
renault	l eu . n o
gianfranco	j a n . p eu . l a ng . k o
milne	m i l . l eu n
berkshire	b a . k eu . s yeo
richards	l i . ch eo . j eu
hals	h a l . s eu
bratislava	b eu . l a . t i . s eu l . l a . b a
lefebvre	l eu . p e . b eu . l eu
marty	m a . l eu . t i
linus	l i . n u . s eu
ronan	l o . n a n
lenz	l e n . ch eu
wolf	b o l . p eu
eddie	e . d i
dunn	d eo n
wayne	we . i n
reichenbach	l a . i . h e n . b a . h eu
qingxian	ch i ng . s ye n
beveridge	b e . b eo . l i . j i
kidd	k i . d eu
nathaniel	n eo . d ae . n i . eo l
heath	h i . s eu
scotland	s eu . k o . t eu l . l ae n . d eu
cyprus	s a . i . p eu . l eo . s eu
langevin	l a ng . j u . b ae ng
finsen	p i n . s e n
bell	b e l
aachen	a . h e n
curie	k wi . l i
gauguin	g o . g ae ng
izquierdo	i . s eu . k i . e . l eu . d o
maupassant	m o . p a . s a ng
gesner	g e . s eu . n eo
silvester	s i l . b e . s eu . t eo
zimbabwe	j i m . b a . b eu . we
penck	p e ng . k eu
desmond	d e . j eu . m eo n . d eu
courtois	k u . l eu . t u . a
anwar	a n . wa . l eu
gobineau	g o . b i . n o
hurt	h eo . t eu
nouri	n u . l i
kigali	k i . g a l . l i
clara	k eu l . l a . l a
annapolis	a . n a . p o l . l i . s eu
wilt	wi l . t eu
angora	a ng . g o . l a
kivi	k i . b i
lippi	l i . p i
hoover	h u . b eo
madsen	m ae . d eu . s eu n
udo	u . d o
umberto	u m . b e . l eu . t o
zamora	s a . m o . l a
rubinstein	l u . b i n . s yu . t a . i n
zapata	s a . p a . t a
cendrars	s a ng . d eu . l a . l eu
doyle	d o . i l
perret	p e . l e
foster	p o . s eu . t eo
garr	g a
mader	m a . d eo
wilder	wa . i l . d eo
cervantes	s e . l eu . b a n . t e . s eu
piaf	p i . a . p eu
manila	m a . n i l . l a
estonia	e . s eu . t o . n i . a
ricketts	l i . k e . ch eu
louisiana	l u . i . j i . ae . n a
getty	g e . t i
bayard	b a . ya . l eu
tammy	t ae . m i
hilty	h i l . t i
ralph	l ae l . p eu
gaspar	g a . s eu . p a
forbes	p o . b eu . s eu
christoph	k eu . l i . s eu . t o . p eu
candice	k ae n . d i . s eu
rahal	l a . h o . l eu
fokker	p o . k eo
alva	a l . b a
welch	we l . ch i
bardeen	b a . d i n
moreau	m o . l o
severo	s e . b e . l o
lehmbruck	l e m . b eu . l u . k eu
doe	d o
brescia	b eu . l e . s i . a
mayer	m a . i . eo
beck	b e g
neve	n e . b eu
gadda	g a . d a
hart	h a . t eu
tylor	t a . i l . l eo
templeton	t e m . p eu l . t eo n
caceres	k a . s e . l e . s eu
irvine	eo . b i n
raman	l a . m a n
buddy	b eo . d i
herzberg	h e . l eu . ch eu . b e . l eu . k eu
kowalski	k o . wa l . s eu . k i
giddings	g i . d i ng . s eu
pilon	p i l . l o ng
kensington	k e n . j i ng . t eo n
bellow	b e l . l o
melchior	m e l . k i . o . l eu
rolando	l o l . l a n . d o
banda	b a n . d a
jellinek	ye l . l i . n e . k eu
kirsch	k i . l eu . s wi
frisch	p eu . l i . s yu
kreutzer	k eu . l o . i . ch eo
danton	d a ng . t o ng
daladier	d a l . l a . d i . e
krzysztof	k eu . s i . s yu . t o . p eu
packer	p ae . k eo
palau	p a l . l a . u
wertheimer	b e . l eu . t eu . h a . i . m eo
camillo	k a . m i l . l o
boden	b o . d e n
hindenburg	h i n . d e n . b u . l eu . k eu
koster	k o . s eu . t eo
asuncion	a . s u n . s i . o n
hawke	h o . k eu
sean	s yo n
steinem	s eu . t a . i . n eo m
alfredo	a l . p eu . l e . d o
novak	n o . b a g
ash	ae . s wi
cane	k e . i n
weil	b a . i l
arnaldo	a . l eu . n a l . d o
philippines	p i l . l i . p i n
denver	d e n . b eo
nossack	n o . s a . k eu
constance	k o n . s eu . t a n . s eu
gibbs	g i . b eu . s eu
halifax	h ae l . l i . p ae g . s eu
drake	d eu . l e . i . k eu
nat	n ae s
lofting	l o . p eu . t i ng
timothy	t i . m eo . s i
swart	s eu . wa . l eu . t eu
townes	t a . u n . s eu
volcker	b o l . k eo
bath	b a . s eu
gianni	j a n . n i
harriet	h ae . l i . eo s
moore	m u . eo
ferreira	p e . l e . i . l a
hancock	h ae n . k o g
maximilian	m a g . s i . m i l . l i . a n
chemnitz	k e m . n i . ch eu
gambia	g a m . b i . a
calais	k a l . l e
goffman	g o . p eu . m eo n
rudy	l u . d i
fontaine	p o ng . t e n
seurat	s oe . l a
strasburger	s yu . t eu . l a . s eu . b u . l eu . g eo
liddell	l i . d eu l
hamburg	h a m . b u . l eu . k eu
thorne	ss o n
baumeister	b a . u . m a . i . s eu . t eo
richelieu	l i . s yu l . l i . oe
rey	l e . i
more	m o . eo
lasse	l a . s e
blunt	b eu l . l eo n . t eu
luciano	l u . ch i . a . n o
nero	n e . l o
leslie	l e . s eu l . l i
vladivostok	b eu l . l a . d i . b o . s eu . t o . k eu
gris	g eu . l i . s eu
woolley	u l . l i
maurus	m o . l wi . s eu
gere	g i . eo
nahum	n a . h u m
fernando	p e . l eu . n a n . d o
magellan	m a . j e l . l a n
quinn	k wi n
lennox	l e . n o g . s eu
clare	k eu l . l e . eo
dupont	d yu . p o ng
boyd	b o . i . d eu
hatch	h ae . ch i
langley	l ae ng . g eu l . l i
glaspell	g eu l . l ae . s eu . p e l
minogue	m i . n o . g eu
fredericton	p eu . l e . d eo . l i g . t eo n
gareth	g ae . l i . s eu
coventry	k o . b eo n . t eu . l i
gentz	g e n . ch eu
hurst	h eo . s eu . t eu
dayan	d a . ya n
merriman	m e . l i . m eo n
driesch	d eu . l i . s yu
reid	l i . d eu
crocker	k eu . l o . k eo
narayan	n a . l a . ya n
meany	m i . n i
gallio	g a l . l i . o
lucy	l u . s i
knut	k eu . n u . t eu
vivian	b i . b i . eo n
sauvy	s o . b i
charles	ch a l . s eu
africa	a . p eu . l i . k a
lepidus	l e . p i . d u . s eu
hayat	h a . ya s
malik	m a l . l i . k eu
lord	l o . d eu
quinton	k wi n . t eo n
fresno	p eu . l e . j eu . n o
elizabeth	e l . l i . j a . b e . s eu
uzbekistan	u . j eu . b e . k i . s eu . t a n
delgado	d e l . g a . d o
lash	l ae . s wi
valentino	b a l . l e n . t i . n o
feetham	p i . s ae m
pidgeon	p i . j eo n
braga	b eu . l a . g a
card	k a . d eu
doran	d o . l eo n
cruyff	k eu . l u . i . p eu
krogh	k eu . l o . g eu
blythe	b eu l . l i . d eu
abernethy	ae . b eo . n e . s i
ciampi	ch a m . p i
weidenreich	b a . i . d e n . l a . i . h i
malus	m a l . l wi . s eu
queneau	k eu . n o
piaget	p i . a . j e
ehrenburg	e . l e n . b u . l eu . g eu
hansson	h a n . s o n
brody	b eu . l o . d i
heseltine	h e . s eu l . t a . i n
midas	m i . d a . s eu
yunis	yu . n i . s eu
michel	m i . s ye l
eugenio	e . u . j e . n i . o
fraser	p eu . l e . i . j eo
habermas	h a . b eo . m a . s eu
dennis	d e . n i . s eu
fred	p eu . l e . d eu
nixon	n i g . s eu n
lahore	l a . h o . l eu
olivier	o l . l i . b i . e
perth	p eo . s eu
stoddard	s eu . t o . d a . d eu
andalusia	a n . d a l . l u . s i . a
schreyer	s yu . l a . i . eo
canaro	k a . n a . l o
berlioz	b e . l eu l . l i . o . j eu
racine	l a . s i n
sewell	s yu . eo l
martini	g u . i . d o
longchamp	l o ng . s ya ng
hemingway	h e . m i ng . we . i
vientiane	b i . e n . t i . a n
montessori	m o n . t e . s o . l i
negri	n e . g eu . l i
durant	d yu . l ae n . t eu
point	p o . i n . t eu
serafimovich	s e . l a . p i . m o . b i . ch i
chernov	ch e . l eu . n o . p eu
dallapiccola	d a l . l a . p i . k o l . l a
goncharov	g o n . ch a . l o . p eu
henri	a ng . l i
indianapolis	i n . d i . ae . n a . p o l . l i . s eu
brandon	b eu . l ae n . d eo n
miriam	m i . l i . eo m
volgograd	b o l . g o . g eu . l a . d eu
rolland	l o l . l a ng
hartung	a . l eu . t u ng
marian	m a . l i . a n
ivanov	i . b a . n o . p eu
herb	h eo . b eu
alfonsin	a l . p o n . s i n
altamira	a l . t a . m i . l a
millet	m i l . l e
segantini	s e . g a n . t i . n i
slovenia	s eu l . l o . b e . n i . a
frantisek	p eu . l a n . t i . s e g
baker	b e . i . k eo
blackstone	b eu l . l ae g . s eu . t o n
paderewski	p a . d e . l e . p eu . s eu . k i
kalb	k a l . p eu
hyatt	h a . i . eo s
pellegrini	p e l . l e . g eu . l i . n i
lundberg	l u n . d eu . b e . l i
veresaev	b e . l e . s a . ye . p eu
salten	j a l . t e n
athos	e . i . s o . s eu
shostakovich	s yo . s eu . t a . k o . b i . ch i
wodehouse	u . d eu . h a . u . s eu
jennifer	j e . n i . p eo
bowyer	b a . u . eo
tavares	t a . b a . l e . s eu
reyes	l e . i . eo . s eu
zimmermann	ch i . m eo . m a n
mayhew	m e . i . h yu
behrens	b e . l e n . s eu
chamai	ch a . m a . i
dale	d e . i l
wolcott	wo l . k o . t eu
daniel	d a . n i . e l
sudermann	j u . d eo . m a n
sauer	j a . u . eo
nunn	n eo n
praetorius	p eu . l e . t o . l i . u . s eu
lorenzen	l o . l e n . j e n
joaquin	h o . a . k i n
falkberget	p a l . k eu . b e . l eu . g e
arbuzov	a . l eu . b u . j o . p eu
melbourne	m e l . b eo . l eu n
nelson	n e l . s eu n
schultze	s yu l . ch e
prescott	p eu . l e . s eu . k eo s
freiligrath	p eu . l a . i l . l i . g eu . l a . t eu
walt	wo l . t eu
harrison	h ae . l i . s eu n
pozzo	p o . j o
gurwitsch	g eo . b i . ch i
furtado	p eo l . t a . d o
sarah	s a . l a
pompel	p o m . p e . i
lesseps	l e . s e b . s eu
tatiana	t a . t i . a . n a
perez	p e . l e . j eu
svetlana	s eu . b e . t eu l . l a . n a
winston	wi n . s eu . t eo n
susanne	j u . j a . n e
trollope	t eu . l o l . l eo b
olof	o l . l o . p eu
eakins	e . i . k i n . s eu
noir	n eu . wa . l eu
bronte	b eu . l o n . t e
walesa	b a . we n . s a
rainy	l e . i . n i
gayoom	g a . yu m
bright	b eu . l a . i . t eu
dietzgen	d i . ch eu . g e n
chahine	s ya . h i n
bruno	b eu . l u . n o
habib	h a . b i . b eu
hyderabad	h a . i . d e . l a . b a . d eu
cronin	k eu . l o . n i n
sennett	s e . n e s
knowles	n o l . j eu
bedford	b e . d eu . p eo . d eu
adonis	a . d o . n i . s eu
hollingworth	h o l . l i ng . wo . s eu
bliss	b eu l . l i . s eu
delibes	d eu l . l i . b eu
barker	b a . k eo
debussy	d eu . b wi . s i
jacksonville	j ae g . s eu n . b i l
juliana	j u l . l i . a . n a
georgetown	j o . j i . t a . u n
benavides	b e . n a . b i . d e . s eu
osborne	o . j eu . b eo n
kann	k a n
amos	a . m o . s eu
eysenck	a . i . s eo n . k eu
borges	b o . l eu . h e . s eu
eugene	yu . j i n
polanyi	p o l . l a . n i
sholokhov	s yo l . l o . h o . p eu
berne	b e . l eu n
gasser	g ae . s eo
jones	j o n . s eu
scharnhorst	s ya . l eu n . h o . l eu . s eu . t eu
duluth	d eo l . l u . s eu
dawn	d o n
volga	b o l . g a
berthold	b e . l eu . t o l . t eu
angela	a n . j e l . l a
belarus	b e l . l o . l u . s i
ungaretti	u ng . g a . l e . t i
polynesia	p o l . l i . n e . s i . a
cohen	k o . eo n
ruth	l u . s eu
scalia	s eu . k ae l . l i . a
crashaw	k eu . l ae . s yo
saavedra	s a . b e . d eu . l a
webster	we b . s eu . t eo
earle	eo l
wakefield	we . i . k eu . p i l . d eu
luke	l u g . k eu
davide	d a . b i . d e
oman	o . m a n
osler	o . s eu l . l eo
lombardy	l o m . b a . l eu . d i . a
schuster	s eu . h u . s eu . t e . l eu
bury	b eo . l i
malherbe	m a l . l e . l eu . b eu
merritt	m e . l i . t eu
adamov	a . d a . m o . p eu
rabat	l a . b a . t eu
hindemith	h i n . d e . m i . t eu
downs	d a . u n . s eu
bernoulli	b e . l eu . n u . i
silone	s i l . l o . n e
poisson	p u . a . s o ng
juliette	j wi l . l i . e . t eu
galpin	g a l . p i n
tennant	t e . n eo n . t eu
rudd	l eo . d eu
constantin	k o n . s eu . t a n . t i n
lowe	l o . we
britt	b eu . l i s
ethiopia	e . t i . o . p i . a
landry	l a ng . d eu . l i
walpole	wo l . p o l
clough	k eu l . l a . p eu
jahn	ya n
joshua	yeo . h o . s u . a
foggia	p o . j i . a
galileo	g a l . l i l . l e . o
conakry	k o . n a . k eu . l i
marinetti	m a . l i . n e . t i
judd	j eo . d eu
moreno	m o . l e . n o
gerber	g eo . b eo
dave	d e . i . b eu
lysenko	l i . s e n . k o
zak	j ae g
selznick	s e l . j eu . n i g
faith	p e . i . s eu
djibouti	j i . b u . t i
ruskin	l eo . s eu . k i n
pattani	p a . t a . n i
mander	m a n . d e . l eu
laufer	l a . u . p eo
pieter	p i . t eo
arena	a . l e . n a
behring	b e . l i ng
michaux	m i . s yo
moissan	m u . a . s a ng
hess	h e . s eu
makin	m a . k i n
patrice	p a . t eu . l i . s eu
andrew	a n . d eu . l e
anstey	ae n . s eu . t i
milos	m i l . l o . s eu
grimmelshausen	g eu . l i . m e l . s eu . h a . u . j e n
putnam	p eo . t eu . n eo m
wheatley	wi . t eu l . l i
lelewel	l e l . l e . b e l
argento	a . l eu . j e n . t o
kathy	k ae . s i
marcia	m a . l eu . s ya
cardin	k a . d i n
bowdler	b o . d eu l . l eo
serge	s e . l eu . g e
most	m o . s eu . t eu
hood	h u . d eu
schreker	s yu . l e . k eo
ethan	i . d eo n
marjorie	m a . j eo . l i
pelliot	p e l . l i . o
burma	b eo . m a
kiss	k i . s i
namur	n a . m u . l eu
iran	i . l a n
suriname	s u . l i . n a m
urban	u . l eu . b a n
clapton	k eu l . l ae b . t eu n
valla	b a l . l a
tupolev	t u . p o l . l e . p eu
chabrier	s ya . b eu . l i . e
tod	t o . d eu
ven	b e n
sarton	s a . t eo n
denmark	d e n . m a . k eu
katharine	k ae . s eo . l i n
bujumbura	b u . j u m . b u . l a
schrieffer	s yu . l i . p eo
basra	b a . s eu . l a
oppert	o . p e . l eu . t eu
loy	l o . i
hanna	h a n . n a
varenius	b a . l e . n i . u . s eu
rademacher	l a . d e . m a . h eo
stig	s eu . t i . g e
ginastera	h i . n a . s eu . t e . l a
eliezer	e l . l i . e . j e . l eu
salinger	s ae l . l i n . j eo
fern	p eo n
duarte	d u . a . l eu . t e
arad	a . l a . d eu
mubarak	m u . b a . l a . k eu
lacey	l e . i . s i
southampton	s a . u . s ae m . p eu . t eo n
marlon	m a l . l o n
powys	p o . u . i . s eu
eigen	a . i . g e n
maguire	m ae g . g wa . i . eo
hearst	h eo . s eu . t eu
balzac	b a l . j a . k eu
ayala	a . ya l . l a
germany	d o g . i l
slim	s eu l . l i m
dunlop	d eo n . l o b
concha	k o n . ch a
cecil	s e . s i l
antoine	a ng . t u . a n
durban	d eo . b a n
hasan	h a . s a n
rowling	l o l . l i ng
yangon	ya ng . g o n
kempis	k e m . p i . s eu
sydow	s i . d o
ljubljana	l yu . b eu l . l ya . n a
duval	d yu . b a l
herrington	h e . l i ng . t eo n
sinowatz	j i . n o . b a . ch eu
greenspan	g eu . l i n . s eu . p eo n
bryan	b eu . l a . i . eo n
esaias	e . s a . i . a . s eu
ekaterina	ye . k a . t e . l i . n a
previn	p eu . l e . b i n
ward	wo . d eu
venturi	b e n . t u . l i
coubertin	k u . b e . l eu . t ae ng
buckinghamshire	b eo . k i ng . eo m . s yeo
grosso	g eu . l o . s o
east	d o ng . b a ng
cicero	k i . k e . l o
baird	b e . eo . d eu
hutcheson	h eo . ch i . s eu n
bratteli	b eu . l a . t e l . l i
coignet	k o . wa . n i . e
nasser	n a . s e . l eu
iacocca	a . i . eo . k o . k a
sikorski	s i . k o . l eu . s eu . k i
connor	k o . n eo
mance	m ae n . s eu
kuropatkin	k u . l o . p a s . k i n
brecht	b eu . l e . h i . t eu
burdin	b eo . d i n
singer	s i ng . eo
ghiberti	g i . b e . l eu . t i
funke	p u ng . k e
pimentel	p i . m e n . t e l
klondike	k eu l . l o n . d a . i . k eu
winckelmann	b i ng . k e l . m a n
sibelius	s i . b e l . l i . u . s eu
carrera	k a . l e . l a
ines	i . n e . s eu
bernheim	b e . l eu n . h a . i m
wyatt	wa . i . eo s
josef	yo . s e . p eu
hugh	h yu
bainbridge	b e . i n . b eu . l i . j i
fisch	p i . s yeo
dirk	d eo . k eu
cukor	k u . k eo
inglis	i ng . g eu l . l i . s eu
heather	h e . d eo
musset	m wi . s e
lanson	l a ng . s o ng
updike	eo b . d a . i . k eu
beaverbrook	b i . b eo . b eu . l u g
pascal	p a . s eu . k a l
marlin	m a l . l i n
bill	b i l
lydia	l i . d i . a
dolores	d o l . l o . l e . s eu
goes	g u . s eu
gwen	g eu . we n
kiribati	k i . l i . b a . s i
tait	t a . i . t eu
brant	b eu . l a n . t eu
piazzi	p i . a . ch i
leon	l e . o ng
angara	a n . g a . l a
pastor	p a . s eu . t eo
scott	s eu . k o . t eu
marot	m a . l o
quackenbush	k we g . k e n . b u . s i
hamsun	h a m . s u n
negev	n e . g e . b eu
honiara	h o . n i . a . l a
tilman	t i l . m a n
nizan	n i . j a ng
elisa	e l . l i . s a
kansas	k ae n . j a . s eu
mandeville	m ae n . d eo . b i l
viktor	b i g . t o . l eu
toni	t a . n i
beaumont	b a . m o n . t eu
drucker	d eu . l eo . k eo
wilke	wi l . k eu
cardenas	k a . l eu . d e . n a . s eu
montgomery	m o ng . g o . m e . l i
sardinia	s a . l eu . d i . n i . a
gouled	g u l . l e . d eu
stanton	s eu . t ae n . t eo n
gaza	g a . j a
susanna	s u . s a n . n a
olena	o l . n e . n a
larsson	l a . l eu . s o n
butte	b yu . t eu
seles	s e l . l e . s eu
warwickshire	wo . l i g . s yeo
hulbert	h eo l . b eo . t eu
cavaignac	k a . b e . n ya . k eu
damiani	d a . m i . a . n i
schaeffer	s we . p eo
lanzhan	l a n . j a n
scranton	s eu . k eu . l ae n . t eo n
helgeland	h e l . g eo l . l eo n . d eu
rubens	l u . b e n . s eu
oskar	o . s eu . k a . l eu
pierre	p i . eo
carson	k a . s eu n
fick	p i . k eu
penzias	p e n . j i . eo . s eu
agatha	a . g a . s a
karachi	k a . l a . ch i
cox	k o g . s eu
harding	h a . d i ng
eriksson	e . l i g . s o n
gertsen	g e . l eu . ch e n
stephanie	s eu . t e . p a . n i
richard	l i . ch a . d eu
krasnodar	k eu . l a . s eu . n o . d a . l eu
christ	g u . s e . j u
joshi	j o . s i
kennelly	k e . n eo l . l i
jussieu	j wi . s i . oe
zagreb	j a . g eu . l e . b eu
jerusalem	ye . l u . s a l . l e m
pinheiro	p i . n e . i . l o
wieniawski	b i . e . n i . a . p eu . s eu . k i
silva	s i l . b a
kachalov	k a . ch a l . l o . p eu
romain	l o . m ae ng
liebmann	l i . p eu . m a n
goldschmidt	g o l . t eu . s yu . m i . t eu
agricola	a . g eu . l i . k o l . l a
hanslick	h a n . s eu l . l i . k eu
rabin	l a . b i n
hegel	h e . g e l
springer	s eu . p eu . l i ng . g eo
wali	wa . l i
meindert	m a . i n . d e . l eu . t eu
cartan	k a . l eu . t a ng
beddoes	b e . d o . s eu
cleve	k eu l . l e . b e
perkin	p eo . k i n
bash	b ae . s wi
ingenhousz	i ng . g e n . h o . u . s eu
bevan	b e . b eo n
rumsfeld	l eo m . j eu . p e l . d eu
malin	m a l . l i n
kelly	k e l . l i
reiter	l a . i . t eo
stefano	s eu . t e . p a . n o
colman	k o l . m eo n
bonnici	b o . n i . ch i
theodore	s i . eo . d o . eo
selim	s e l . l i m
pregl	p eu . l e . g eu l
bjork	b i . yo . k eu
valerie	b a l . l e . l i
phillpotts	p i l . p o . ch eu
pacher	p a . h eo
wallon	wa l . l o ng
wittig	b i . t i . h i
binder	b a . i n . d eo
cienfuegos	s i . e n . p u . e . g o . s eu
scripps	s eu . k eu . l i b . s eu
bryant	b eu . l a . i . eo n . t eu
mckenzie	m ae g . k e n . j i
gonzales	g o n . s a l . l e . s eu
osbert	o . s eu . b eo . t eu
neruda	n e . l u . d a
kevin	k e . b i n
kearsley	k i . eo . s eu l . l i
hoffmann	h o . p eu . m a n
hristov	h eu . l i . s eu . t o . p eu
lowry	l o . l i
haworth	h a . s eu
lionel	l i . o . n e l
fitch	p i . ch i
laos	l a . o . s eu
morice	m o . l i . s eu
kirby	k eo . b i
cairo	k a . i . l o
huberman	h yu . b eo . m eo n
koepp	k o . p eu
farrell	p ae . l eo l
zanzibar	j a n . j i . b a . l eu
lilli	l i l . l i
hayden	h e . i . d eu n
weiner	wa . i . n eo
rothschild	l o . s eu . ch a . i l . d eu
holzer	h o l . ch eo
anouilh	a . n u . i
antonescu	a n . t o . n e . s eu . k u
andrea	a n . d eu . l e . a
lim	l i m
zemskov	j e m . s eu . k o . p eu
aziz	a . j i . j eu
brindley	b eu . l i n . d eu l . l i
jacques	j a . k eu
holden	h o l . d eu n
verissimo	b e . l i . s i . m o
beverley	b e . b eo l . l i
mel	m e l
bethesda	b e . d e . s eu . d a
johansson	yo . h a n . s o n
languedoc	l a ng . g eu . d o . k eu
edel	e . d e l
pechstein	p e . h i . s yu . t a . i n
battista	b a . t i . s eu . t a
satish	s a . t i . s wi
poitiers	p u . a . t i . e
elzevir	e l . j e . b i . eo
decker	d e . k eo
madrid	m a . d eu . l i . d eu
rossetti	l o . s e . t i
samuelson	s a . m u . e l . s eu n
simmonds	s i . m eo n . j eu
heller	h e l . l eo
priscilla	p eu . l i . s i l . l a
vico	b i . k o
besancon	b eu . j a ng . s o ng
moltke	m o l . t eu . k e
atwood	ae . t u . d eu
nicholas	n i . k o l . l eo . s eu
august	a . u . g u . s eu . t eu
daimler	d e . i m . l eo
schneider	s yu . n a . i . d eo
remy	l e . m i
haider	h a . i . d eo
juan	h u . a n
camper	k a m . p e . l eu
ignatiev	i . g eu . n a . t i . ye . p eu
bowden	b o . u . d e n
charlottetown	s ya l . l eo s . t a . u n
fritsch	p eu . l i . ch i
menger	m e ng . g eo
sheridan	s ye . l i . d eo n
leoni	l e . o . n i
burundi	b u . l u n . d i
locke	l o g
ott	o . t eu
sem	s e m
janet	j a . n e
montoya	m o n . t o . ya
janice	j e . n i . s eu
derzhavin	d e . l eu . j a . b i n
kelsen	k e l . j e n
susan	s u . j a n
myburgh	m a . i . b eo . g eu
corradi	k o . l a . d i
uruguay	u . l u . g wa . i
guadalcanal	g wa . d a l . k a . n a l
bingham	b i ng . h ae m
livingstone	l i . b i ng . s eu . t eo n
antelami	a n . t e l . l a . m i
zadornov	j a . d o . l eu . n o . p eu
rumford	l eo m . p eo . d eu
horkheimer	h o . l eu . k eu . h a . i . m eo
greece	g eu . l i . s eu
dolph	d o l . p eu
herriot	e . l i . o
wilton	wi l . t eo n
petty	p e . t i
mobile	m o . b a . i l
sabine	s a . b i n
schongauer	s yo n . g a . u . eo
ritz	l i . ch eu
weston	we . s eu . t eo n
walters	wo l . t eo . s eu
stilwell	s eu . t i l . we l
beatrice	b e . a . t eu . l i . ch e
drexler	d eu . l e g . s eu l . l eo
meadows	m i . d o . u . s eu
sophie	s o . p i
namibia	n a . m i . b i . a
mili	m i l . l i
burns	b eo n . s eu
kuhn	k u n
rochester	l o . ch e . s eu . t eo
nika	n i . k a
boz	b o . j eu
picard	p i . k a . l eu
rachel	l a . h e l
little	l i . t eu l
grosse	g eu . l o . s e
coleman	k o l . m ae n
lockhart	l o g . h a . t eu
olsen	o l . s eu n
brassens	b eu . l a . s a ng . s eu
giauque	j i . o . k eu
neander	n e . a n . d eo
pareto	p a . l e . t o
fadeev	p a . d e . ye . p eu
june	j yu n
antonina	a n . t o . n i . n a
cowper	k u . p eo
hope	h o . p eu
parkes	p a g . s eu
imbert	i m . b e . l eu . t eu
wiltshire	wi l . t eu . s yeo
bulgakov	b u l . g a . k o . p eu
pavel	p a . b e l
schumpeter	s yu m . p e . t eo
frida	p eu . l i . d a
bale	b e . i l
bazin	b a . j ae ng
vaughan	b o n
macbeth	m ae g . b e . s eu
jon	yo n
colgate	k o l . g e . i . t eu
senior	s i . n i . eo
michell	m i . ch e l
guiana	g i . a . n a
minneapolis	m i . n i . ae . p o l . l i . s eu
merle	m eo l
humason	h yu . m e . i . s eu n
travolta	t eu . l a . b o l . t a
tom	t o m
starling	s eu . t a l . l i ng
nascimento	n a . s i . m e n . t u
waigel	b a . i . g e l
albertville	a l . b e . l eu . b i l
aretino	a . l e . t i . n o
miami	m a . i . e . m i
filipov	p i l . l i . p o . p eu
barron	b ae . l o n
hamel	h a . m e l
repin	l e . p i n
neto	n e . t o
antoni	a n . t o . n i
alessio	a l . l e . s i . o
amato	a . m a . t o
memling	m e m . l i ng
cummings	k eo . m i ng . s eu
concepcion	k o n . s e b . s i . o n
donatus	d o . n a . t u . s eu
nicole	n i . k o l
sanaa	s a . n a
alphonso	a l . p o n . s o
bertini	b eo . t i . n i
mount	m a . u n . t eu
ellery	e l . l eo . l i
haavelmo	h o . b e l . m o
endre	e n . d eu . l e
maeterlinck	m e . i . t eo . l i ng . k eu
chuvash	ch u . b a . s yu
galilei	g a l . l i l . l e . i
denise	d e . n i . j eu
scholes	s yo l . s eu
trenton	t eu . l e n . t eo n
forman	p o . l eu . m a n
harcourt	h a . k o . t eu
daumier	d o . m i . e
holliday	h o l . l i . d e . i
glendale	g eu l . l e n . d e . i l
logan	l o . g eo n
jouhaux	j u . o
holland	h o l . l a n . d eu
hort	h o l . t eu
tunisia	t wi . n i . j i
lully	l wi l . l i
odilon	o . d i l . l o ng
kerstin	k eo . s eu . t i n
bari	b a . l i
danny	d a . n i
diana	d i . a . n a
reinhardt	l a . i n . h a . l eu . t eu
teller	t e l . l eo
ferdianand	p e . l eu . d i . n a n . d eu
posse	p o . s e
bolkiah	b o l . k i . a
telford	t e l . p o . d eu
hibernia	h a . i . b eo . n i . a
breuer	b eu . l o . i . eo
bhutan	b u . t a n
rossellino	l o . s e l . l i . n o
balfour	b a l . p u . eo
bonnet	b o . n e
gerhard	g e . l eu . h a . l eu . t eu
irene	i . l e . i n
vaga	b a . g a
schleiden	s yu l . l a . i . d e n
bausch	b a . u . s yu
feuchtwanger	p o . i . h i . t eu . b a ng . g eo
staudinger	s yu . t a . u . d i ng . g eo
hazel	h e . i . j eu l
dumont	d wi . m o ng
ashkhabad	a . s yu . h a . b a . t eu
tolle	t o l . l e
peruzzi	p e . l u . ch i
gobat	g o . b a
jenner	j e . n eo
huysmans	wi . s eu . m a ng . s eu
tripolitania	t eu . l i . p o l . l i . t a . n i . a
linz	l i n . ch eu
augustine	eo . g eo . s eu . t i n
lynen	l i . n e n
irving	eo . b i ng
louise	l u . i . j eu
hay	h e . i
keynes	k e . i n . s eu
luigi	l u . i . j i
reynaud	l e . n o
ramo	l a . m o
harden	h a . d eu n
reagan	l e . i . g eo n
melba	m e l . b a
maimon	m a . i . m o n
wittfogel	b i . t eu . p o . g e l
marvell	m a . b eo l
ness	n e . s eu
carlos	k a . l eu l . l o . s eu
boult	b o . u l . t eu
chomsky	ch o m . s eu . k i
navarre	n a . b a . l eu
laud	l o . d eu
hopper	h o . p eo
deissmann	d a . i . s eu . m a n
mead	m i . d eu
kogan	k o . g a n
sinan	s i . n a n
jolivet	j o l . l i . b e
algiers	a l . j e
vito	b i . t o
pippin	p i . p i n
gauss	g a . u . s eu
vakhtangov	b a . h eu . t a ng . g o . p eu
martina	m a . l eu . t i . n a
erbakan	e . l eu . b a . k a n
emeric	i . m e . l i g
senna	s e . n a
anna	a n . n a
gierek	g i . e . l e . k eu
miller	m i l . l eo
mesopotamia	m e . s o . p o . t a . m i . a
moscow	m o . s eu . k eu . b a
kirk	k eo . k eu
naess	n e . s eu
appleton	ae . p eu l . t eo n
dines	d a . i n . s eu
coker	k o . k eo
matisse	m a . t i . s eu
pacheco	p a . ch e . k o
christian	k eu . l i . s eu . ch eo n
alfonso	a l . p o n . s o
kline	k eu l . l a . i n
hubel	h eo . b eu l
verga	b e . l eu . g a
suffolk	s eo . p eo g
libreville	l i . b eu . l eu . b i l
capuana	k a . p u . a . n a
szigeti	s i . g e . t i
mitterrand	m i . t e . l a ng
rosas	l o . s a . s eu
kuibyshev	k u . i . b i . s ye . p eu
atahualpa	a . t a . wa l . p a
cary	k ae . l i
morley	m o l . l i
desai	d e . s a . i
disney	d i . j eu . n i
patterson	p ae . t eo . s eu n
eisenstein	a . i . j e n . s yu . t a . i n
neher	n e . eo
axel	a g . s e l
ahern	eo . h eo n
watt	wa . t eu
kentucky	k e n . t eo . k i
laird	l e . eo . d eu
moldova	m o l . d o . b a
geoff	j e . p eu
moreira	m o . l e . i . l a
bast	b a . s eu . t eu
babcock	b ae b . k o g
jeremias	ye . l e . m i . a . s eu
gossen	g o . s e n
palme	p a l . m e
estrada	e . s eu . t eu . l a . d a
donovan	d o . n o . b eo n
kingston	k i ng . s eu . t eo n
bouchard	b u . s ya . l eu
hunt	h eo n . t eu
sperry	s eu . p e . l i
axelrod	ae g . s eo l . l o . d eu
maurois	m o . l eu . wa
abdus	a b . d u . s eu
mraz	m eu . l a . j eu
galvani	g a l . b a . n i
uribe	u . l i . b e
verdi	b e . l eu . d i
nelly	n e l . l i
canton	g wa ng . d u ng
adorno	a . d o . l eu . n o
despiau	d e . s eu . p i . o
gracia	g eu . l a . s i . a
osgood	o . s eu . g u s
pamela	p a . m e l . l a
hensen	h e n . j e n
lagrange	l a . g eu . l a ng . j u
angelica	a n . j e l . l i . k a
kok	k o . k eu
khartoum	h a . l eu . t u m
goa	g o . a
light	l a . i . t eu
mach	m a . h a
lomonosov	l o . m o . n o . s o . p eu
leverrier	l eu . b e . l i . e
brennan	b eu . l e . n eo n
melanie	m e l . l a . n i
holbrooke	h o l . b eu . l u g
judith	yu . d i . t eu
clement	k eu l . l e . m e n . t eu
camilla	k a . m i l . l a
uli	u l . l i
sperling	s eu . p eo l . l i ng
garris	g a . l e . s eu
basel	b a . j e l
pax	p a g . s eu
pino	p i . n o
lama	l a . m a
israel	i . s eu . l a . e l
hubert	wi . b e . l eu
thorpe	s o . p eu
rafik	l a . p i . k eu
borlaug	b o l . l o . g eu
antonov	a n . t o . n o . p eu
eddington	e . d i ng . t eo n
weller	we l . l eo
dumas	d wi . m a
richard	l i . ch eo . d eu
ruska	l u . s eu . k a
xenakis	k eu . s e . n a . k i . s eu
mckay	m ae g . k e . i
forsyth	p o . s a . i . s eu
trautmann	t eu . l o . t eu . m a n
deepak	d i . p ae g
cardano	k a . l eu . d a . n o
ammon	a . m o n
pakistan	p a . k i . s eu . t a n
ute	u . t eu
matias	m a . t i . a . s eu
alina	a l . l i . n a
augusta	o . g eo . s eu . t a
suess	j wi . s eu
ahmadabad	a . m a . d a . b a . d eu
indonesia	i n . d o . n e . s i . a
brezhnev	b eu . l e . j u . n e . p eu
aruba	a . l u . b a
virtanen	b i . l eu . t a . n e n
julianus	yu l . l i . a . n u . s eu
hartford	h a . t eu . p eo . d eu
meitner	m a . i . t eu . n eo
mackenzie	m ae . k e n . j i
quental	k we n . t a l
winifred	wi n . p eu . l e . d eu
cochrane	k o . k eu . l eo n
zeno	j e . n o n
croatia	k eu . l o . a . t i . a
fano	p a . n o
karajan	k a . l a . ya n
madison	m ae . d i . s eu n
huxley	h eo g . s eu l . l i
smit	s eu . m i . t eu
lombardo	l o m . b a . l eu . d o
wilfred	wi l . p eu . l e . d eu
dahl	d a l
maxine	m ae g . s i n
bailey	b e . i l . l i
mickey	m i . k i
bergson	b e . l eu . g eu . s o ng
puck	p eo g
lao	l a . o
pratt	p eu . l ae s
jacks	j ae g . s eu
agnelli	a . n ye l . l i
somerset	s eo . m eo . s i s
leskov	l e . s eu . k o . p eu
manet	m a . n e
ethan	i . s eo n
zambia	j a m . b i . a
cairnes	k e . eo n . s eu
arne	a . l eu . n e
stonehenge	s eu . t o n . h e n . j i
kremer	k eu . l e . m eo
haber	h a . b eo
peary	p i . eo . l i
butler	b eo . t eu l . l eo
mercier	m e . l eu . s i . e
aurelio	a . u . l e l . l i . o
petrograd	p e . t eu . l o . g eu . l a . d eu
buck	p eo l
edison	e . d i . s eu n
bloomberg	b eu l . l u m . b eo . g eu
matthews	m ae . s yu . s eu
maillol	m a . yo l
halls	h o l . s eu
capone	k a . p o . n e
alt	a l . t eu
murphy	m eo . p i
manuel	m a . n u . e l
din	d i n
stewart	s eu . t yu . eo . t eu
bucharest	b u . k a . l e . s eu . t eu
irons	a . i . eo n . s eu
sharif	s ya . l i . p eu
reinhold	l a . i n . h o l . t eu
jude	yu . d a
gordon	g o . d eu n
gustave	g u . s eu . t a . b eu
jean	j a n
ryzhkov	l i . s yu . k o . p eu
gleim	g eu l . l a . i m
heyden	h e . i . d e n
borg	b o . g eu
sutter	s u . t eo
breton	b eu . l e . t eu n
varga	b a . l eu . g a
graaf	g eu . l a . p eu
ob	o . b eu
giuliani	j u l . l i . a . n i
imre	i m . l e
sanders	s ae n . d eo . s eu
boyer	b o . i . eo
mandela	m a n . d e l . l a
lissajous	l i . s a . j u
pulci	p u l . ch i
liebermann	l i . b e . l eu . m a n
bruant	b eu . l wi . a ng
agrippina	a . g eu . l i . p i . n a
utah	yu . t a
ban	b a n
kaspar	k a . s eu . p a . eo
maspero	m a . s eu . p e . l o
wilkinson	wi l . k i n . s eu n
foch	p o . s yu
balmer	b a l . m eo
kai	k a . i
joni	j o . n i
bolt	b o l . t eu
harley	h a l . l i
gustaf	g u . s eu . t a . p eu
pedro	p e . d eu . l o
romer	l o . m eo
palade	p eo l . l e . i . d eu
weyl	b a . i l
denzel	d e n . j eo l
musil	m u . j i l
sunderland	s eo n . d eo . l ae n . d eu
voynich	b o . n i . ch i
myers	m a . i . eo . s eu
grote	g eu . l o . t eu
bevin	b e . b i n
gerhardt	g e . l eu . h a . l eu . t eu
donnie	d o . n i
minsk	m i n . s eu . k eu
sloan	s eu . l o n
luxenberg	l o g . s e m . b u . l u . k eu
bruch	b eu . l u . h eu
harvey	h a . b i
tischbein	t i . s yu . b a . i n
cameron	k ae . m eo . l eo n
jenney	j e . n i
stigler	s eu . t i . g eu l . l eo
amar	a . m a . l eu
providence	p eu . l o . b i . d eo n . s eu
harrisburg	h ae . l i . s eu . b eo . g eu
claes	k eu l . l a . s eu
kandel	k ae n . d eu l
jacob	j a . k o b
milovan	m i l . l o . b a n
evers	e . b eo . s eu
alexei	a l . l e g . s e . i
margarita	m a . g a . l i . t a
sokoloff	s o . k o l . l o . p eu
milosevic	m i l . l o . s ye . b i . ch i
pavlov	p a . b eu l . l o . p eu
blinder	b eu l . l a . i n . d eo
bud	b eo . d eu
flesch	p eu l . l e . s wi
mosca	m o . s eu . k a
kabul	k a . b u l
delaware	d e l . l a . we . eo
melissa	m e l . l i . s a
gaede	g e . d e
childe	ch a . i l . d eu
caroline	k ae . l o l . l a . i n
schlaf	s yu l . l a . p eu
peltier	p e l . t i . e
wordsworth	wo . j eu . wo . s eu
suqi	ss u . ch i
clinton	k eu l . l i n . t eo n
stockwell	s eu . t o g . we l
zhdanov	j u . d a . n o . p eu
pershing	p eo . s i ng
dopsch	d o . p eu . s yu
harman	h a . m eo n
bass	b ae . s eu
kisangani	k i . s a ng . g a . n i
emma	e . m a
elliot	e l . l i . eo . t eu
sikorsky	s i . k o . l eu . s eu . k i
bilbao	b i l . b a . o
ebbinghaus	e . b i ng . h a . u . s eu
schleiermacher	s yu l . l a . i . eo . m a . h eo
dalton	d a l . t o n
papin	p a . p ae ng
celeste	s e l . l e . s eu . t eu
besson	b e . s o ng
roxanne	l o g . s a n . n eu
koestler	k e . s eu . t eu l . l eo
cato	k a . t o
taussig	t a . u . s i . g eu
vigano	b i . g a . n o
alain	a l . l ae ng
smiles	s eu . m a . i l . s eu
atlanta	ae . t eu l . l ae n . t a
sluter	s eu l . l wi . t e . l eu
gomulka	g o . m u . u . k a
joshua	j o . s u . a
ellen	e l . l e n
buch	b u . h eu
gomez	g o . m e . j eu
brock	b eu . l o g
arago	a . l a . g o
amado	a . m a . d o
tobias	t o . b i . a . s eu
bethell	b e . d e l
ganges	g ae n . j i . s eu
rosalyn	l o . j eo l . l i n
kirpichnikov	k i . l eu . p i . ch i . n i . k o . p eu
presley	p eu . l e . s eu l . l i
capote	k eo . p o . t i
foley	p o l . l i
berlin	b e . l eu l . l i n
kovalenko	k o . b a l . l e n . k o
siegfried	j i . k eu . p eu . l i . t eu
gaultier	g o . t i . e
mbabane	eu m . b a . b a . n e
pauling	p o l . l i ng
beverly	b i . b eo . l i
salmon	s a l . m o ng
wundt	b u n . t eu
olga	o l . g a
benn	b e n
rodgers	l o . j eo . s eu
appel	a . p e l
fries	p eu . l i . s eu
martinez	m a . l eu . t i . n e . s eu
konrad	k o n . l a . t eu
millikan	m i l . l i . k eo n
nauru	n a . u . l u
paramaribo	p a . l a . m a . l i . b o
peyton	p e . i . t eu n
born	b o . l eu n
laussedat	l o . s e . d a
mendoza	m e n . d o . j a
dionysius	d i . o . n i . s i
robyn	l o . b i n
kamal	k a . m a l
masa	m a . s a
pott	p o . t eu
rudolf	l u . d o l . p eu
nieuwland	n yu . l ae n . d eu
jamaica	j a . m e . i . k a
bolzano	b o l . ch a . n o
salazar	s a l . l a . j a . l eu
bordeaux	b o . l eu . d o
camden	k ae m . d eo n
mamaloni	m a . m a l . l o . n i
vouet	b u . e
swaziland	s eu . wa . j i l . l a n . d eu
moudud	m u . d u . d eu
jaipur	j a . i . p u . l eu
geronimo	j e . l o . n i . m o
gallegos	g a l . l e . g o . s eu
martinon	m a . l eu . t i . n o ng
underwood	eo n . d eo . u . d eu
perdue	p eo . d yu
pettit	p e . t i . t eu
edi	e . d i
bishop	b i . s yo b
henkel	h e n . k e l
spaak	s eu . p a . k eu
peterson	p i . t eo . s eu n
medhurst	m e . d eu . h eo . s eu . t eu
tyndall	t i n . d eu l
surrey	s eo . l i
rohan	l o . h a n
matthias	m a . t i . a . s eu
scalapino	s eu . k a l . l a . p i . n o
hume	h yu m
babson	b ae b . s eu n
kern	k eo n
dard	d a . d eu
mongolia	m o ng . g o
carole	k ae . l o l
gladstone	g eu l . l ae . d eu . s eu . t eo n
monticelli	m o ng . t i . s e l . l i
cunningham	k eo . n i ng . eo m
kallas	k a l . l a . s eu
eric	e . l i g
kirchner	k i . l eu . h i . n eo
tiffany	t i . p a . n i
bernardo	b e . l eu . n a . l eu . d o
lemaitre	l eu . m e . t eu . l eu
wassermann	b a . s e . l eu . m a n
corsi	k o . s i
fresnel	p eu . l e . n e l
macy	m e . i . s i
smirnov	s eu . m i . l eu . n o . p eu
shane	s we . i n
annemarie	a . n e . m a . l i
muir	m yu . eo
achim	a . s i m
tennyson	t e . n i . s eu n
laplace	l a . p eu l . l a . s eu
sanger	s ae ng . eo
caputo	k a . p u . t o
rawlings	l o l . l i ng . s eu
bontempelli	b o n . t e m . p e l . l i
norrish	n o . l i . s i
lanier	l eo . n i . eo
pace	p e . i . s eu
esther	e . s eu . d eo
kiefer	k i . p eo
house	h a . u . s eu
latvia	l a . t eu . b i . a
fulbright	p u l . b eu . l a . i . t eu
charlie	ch a l . l i
kusch	k u . s i
menem	m e . n e m
boerner	b oe . l eu . n eo
washington	wo . s i ng . t eo n
filippo	p i l . l i . p o
youngstown	yeo ng . s eu . t a . u n
indus	i n . d eo . s eu
soledad	s o l . l i . d a . d eu
rubin	l u . b i n
judy	j u . d i
rossi	l o . s i
pupin	p u . p i n
gillian	j i l . l i . eo n
alameda	a l . l eo . m i . d a
behn	b e n
vogt	p o . k eu . t eu
eurasia	yu . l a . s i . a
vallejo	b a . ye . h o
augustus	a . u . g u . s eu . t u . s eu
sydenham	s i . d eu . n eo m
ernest	eo . n i . s eu . t eu
pierce	p i . eo . s eu
hein	h e . i n
wangchuck	wa ng . ch u . k eu
beuys	b o . i . s eu
lasky	l ae . s eu . k i
vega	b e . g a
kruczkowski	k eu . l u . ch i . k o . p eu . s eu . k i
holley	h o l . l i
balenciaga	b a l . l e n . s i . a . g a
kampala	k a m . p a l . l a
ford	p o . d eu
andrej	a n . d eu . l e . i
arbos	a . l eu . b o . s eu
kelvin	k e l . b i n
linton	l i n . t eo n
cassandre	k a . s a ng . d eu . l eu
montfort	m o ng . p o . l eu
lean	l i n
busby	b eo . s eu . b i
william	wi l . l i . eo m
moll	m o l
warwick	wo . l i g
drew	d eu . l yu
vignola	b i . n yo l . l a
withers	wi . d eo . s eu
abe	a . b e
messerer	m e . s e . l e . l eu
rocha	l o . k a
tam	t a m
marsha	m a . s ya
carlisle	k a l . l a . i l
frankfurt	p eu . l a ng . k eu . p u . l eu . t eu
rostand	l o . s eu . t a ng
judah	yu . d a
muzio	m u . ch i . o
bandaranaike	b a n . d a . l a . n a . i . k e
seymour	s e . i . m u . eo
granger	g eu . l e . i n . j eo
bram	b eu . l a m
haeckel	h e . k e l
enoch	e . n o g
thimphu	t i m . b u
dmowski	d eu . m o . p eu . s eu . k i
hebron	h e . b eu . l o n
polo	p o l . l o
tran	t eu . l a n
weaver	wi . b eo
darryl	d ae . l i l
elion	e l . l i . eo n
hudson	h eo . d eu . s eu n
cooper	k u . p eo
nujoma	n u . j o . m a
piazzetta	p i . a . ch e . t a
hassanal	h a . s a . n a l
lenormand	l eu . n o . l eu . m a ng
stark	s yu . t a . l eu . k eu
hilbert	h i l . b e . l eu . t eu
joachim	yo . a . k i m
stokowski	s eu . t o . k o . p eu . s eu . k i
hepworth	h e b . wo . s eu
london	l eo n . d eo n
christchurch	k eu . l a . i . s eu . t eu . ch eo . ch i
whorf	wo . p eu
lyle	l a . i l
garcia	g a . l eu . s i . a
salisbury	s o l . j eu . b e . l i
zaire	j a . i . l eu
gorbachev	g o . l eu . b a . ch o . p eu
zamboni	j a m . b o . n i
banach	b a . n a . h eu
audrey	o . d eu . l i
bellevue	b e l . l e . b yu
durand	d yu . l a n . d eu
woodward	u . d eu . wo . d eu
adams	ae . d eo m . s eu
julio	h u l . l i . o
berenger	b e . l i n . j eo
schmidt	s yu . m i . t eu
oparin	o . p a . l i n
binet	b i . n e
sommerfeld	j o . m eo . p e l . t eu
scheidemann	s ya . i . d e . m a n
sumner	s eo m . n eo
virginia	b eo . j i . n i . a
platonov	p eu l . l a . t o . n o . p eu
eliana	e l . l i . a . n a
mila	m i l . l a
harmon	h a . m eo n
molotov	m o l . l o . t o . p eu
cheddar	ch e . d eo
greuze	g eu . l oe . j eu
donato	d o . n a . t o
longman	l o ng . m ae n
hutson	h eo . t eu . s eu n
otto	o . t o
samantha	s a . m a n . d a
rosenthal	l o . j e n . t a l
macmillan	m ae g . m i l . l a n
epstein	e b . s eu . t a . i n
veen	b i n
dartmouth	d a . t eu . m eo . s eu
hubertus	h u . b e . l eu . t u . s eu
kaverin	k a . b e . l i n
kitty	k i . t i
carey	k e . l i
erasmus	e . l a . s eu . m u . s eu
mauboussin	m o . b eu . s a ng
kafka	k a . p eu . k a
dirac	d i . l ae g
barrymore	b e . l i . m o . eo
daley	d e . i l . l i
kulik	k u l . l i . k eu
long	l o ng
diogenes	d i . o . g e . n e . s eu
herzl	h e . l eu . ch eu l
sale	s a . l eu
solana	s o l . l a . n a
alvin	ae l . b i n
aleksandr	a l . l e g . s a n . d eu . l eu
ovechkin	o . b e . ch i . k i n
erickson	e . l i g . s eu n
koltsov	k o l . ch o . p eu
goebel	g oe . b e l
freemantle	p eu . l i . m ae n . t eu l
duclos	d wi . k eu l . l o
berchem	b eo . ch e m
cairns	k e . i n . j eu
fabian	p a . b i . a n
leeuwenhoek	l e . b e n . h u . k eu
hannover	h a . n o . b eo
maki	m a . k i
giono	j i . o . n o
cedric	s e . d eu . l i g
shakespeare	s ye . i g . s eu . p i . eo
france	p eu . l a ng . s eu
bales	b e . i l . j eu
tim	t i m
huygens	h o . i . g e n . s eu
henryk	h e n . l i . k eu
capri	k a . p eu . l i
botswana	b o . ch eu . wa . n a
yehudi	ye . h u . d i
samson	s a m . s o n
medici	m e . d i . ch i
moussa	m u . s a
gaillard	g a . i . ya . l eu
ingres	ae ng . g eu . l eu
gooch	g u . ch i
rankovic	l a ng . k o . b i . ch i
aphra	ae . p eu . l a
stiller	s eu . t i l . l e . l eu
maccoby	m ae . k o . b i
holl	h o l
poliziano	p o l . l i . ch i . a . n o
handler	h ae n . d eu l . l eo
amazon	a . m a . j o n
musa	m u . s a
rich	l i . ch i
marais	m a . l e
kathleen	k ae . s eo . l i n
ashraf	a . s yu . l a . p eu
omsk	o m . s eu . k eu
hering	h e . l i ng
europe	yu . l eo b
wernicke	b e . l eu . n i . k e
steele	s eu . t i l
tilghman	t i l . m eo n
trier	t eu . l i . eo
peter	b e . d eu . l o
miles	m a . i l . s eu
ulises	yu l . l i . s i . s eu
carmen	k a . l eu . m e n
taya	t a . ya
hollywood	h a l . l i . u . d eu
goethe	g oe . t e
gracchus	g eu . l a . k u . s eu
rosetta	l o . j e . t a
len	l e n
portland	p o . t eu l . l ae n . d eu
mccoy	m ae g . k o . i
jonson	j o n . s eu n
dortmund	d o . l eu . t eu . m u n . t eu
durham	d eo . l eo m
soutine	s u . t i n
kingstown	k i ng . s eu . t a . u n
piccoli	p i . k o l . l i
ludwig	l u . t eu . b i . h i
ernie	eo . n i
drury	d eu . l u . eo . l i
marin	m a . l ae ng
bjorklund	b i . yo . l eu . k eu . l u n . t eu
phoenix	p i . n i g . s eu
nono	n o . n o
trina	t eu . l i . n a
adolf	a . d o l . p eu
geoffrey	j o . p eu . l i
joost	yo . s eu . t eu
campbell	k ae m . b e l
gates	g e . i . ch eu
bakunin	b a . k u . n i n
warren	wo . l eo n
jascha	ya . s ya
antonin	a n . t o . n i n
soyinka	s o . i ng . k a
purcell	p eo . s e l
rojas	l o . h a . s eu
chesterton	ch e . s eu . t eo . t eo n
bradstreet	b eu . l ae . d eu . s eu . t eu . l i . t eu
asam	a . j a m
savannah	s eo . b ae . n eo
congo	k o ng . g o
biber	b i . b eo
jukes	j yu . k eu . s eu
bernal	b eo . n eo l
midway	m i . d eu . we . i
mal	m a l
johann	yo . h a n
santoro	s a n . t o . l o
columbus	k o l . l eo m . b eo . s eu
loewy	l o . wi
perrier	p e . l i . e
burrows	b eo . l o . u . j eu
brookings	b eu . l u . k i ng . s eu
vila	b i l . l a
leo	l e . o
lynn	l i n
marit	m a . l i . t eu
marcuse	m a . l eu . k u . j e
fo	p o
kamenev	k a . m e . n e . p eu
firestone	p a . i . eo . s eu . t o n
gaul	g o l
akron	ae . k eu . l eo n
brundage	b eu . l eo n . d i . j i
ulrich	u l . l i . h i
nadia	n a . d i . a
owen	o . we n
lincoln	l i ng . k eo n
valery	b a l . l e . l i
jessica	j e . s i . k a
zeiss	ch a . i . s eu
bek	b e g
darlington	d a l . l i ng . t eo n
steinheil	s yu . t a . i n . h a . i l
crabbe	k eu . l ae . b eu
kyrgyzstan	k i . l eu . g i n . s eu . s eu . t a n
knies	k eu . n i . s eu
lenard	l e . n a . l eu . t eu
belasco	b e l . l a . s eu . k o
lloyd	l o . i . d eu
therese	t e . l e . j eu
hannelore	h a . n e l . l o . l e
sadat	s a . d a . t eu
kolar	k o l . l a . l eu
bland	b eu l . l ae n . d eu
perec	p e . l e g
juneau	j u . n o
speke	s eu . p i . k eu
freyssinet	p eu . l e . i . s i . n e s
jaspers	ya . s eu . p eo . s eu
lasso	l a . s o
david	d e . i . b i . d eu
gras	g eu . l a . s eu
lilley	l i l . l i
robertson	l o . b eo . t eu . s eu n
beard	b i . eo . d eu
pope	p o . p eu
brooks	b eu . l u g . s eu
gonzalez	g o n . s a l . l e . s eu
herring	h e . l i ng
brian	b eu . l a . i . eo n
badajoz	b a . d a . h o . s eu
cassou	k a . s u
rosenbusch	l o . j e n . b u . s yu
akbar	a . k eu . b a . l eu
bahr	b a . l eu
dowland	d a . u l . l eo n . d eu
peano	p e . a . n o
brenan	b eu . l e . n eo n
hynninen	h a . i n . n i . n e n
whitman	h wi . t eu . m eo n
shields	s wi l . d eu
santini	s a ng . t i . n i
cousin	k u . j ae ng
isabella	i . s a . b e l . l a
wimbledon	wi m . b eu l . d eo n
lino	l i . n o
paine	p e . i n
italo	i . t a l . l o
geneva	j e . n e . b a
bosworth	b o . j eu . wo . s eu
heck	h e g
palermo	p a l . l e . l eu . m o
oliver	o l . l i . b eo
burckhardt	b u . l eu . k eu . h a . l eu . t eu
nicholas	n i . k o l . l a . s eu
thomas	t o . m eo . s eu
dragan	d eu . l a . g a n
christenson	k eu . l i . s eu . t eo n . s eu n
goddard	g o . d eo . d eu
lombard	l o m . b a . l eu . d eu
gautier	g o . t i . e
sazonov	s a . j o . n o . p eu
venezia	b e . n e . ch i . a
bournonville	b u . l eu . n o ng . b i l
palma	p a l . m a
sorel	s o . l e l
dara	d ae . l a
appert	a . p e . l eu
spinoza	s eu . p i . n o . j a
mordecai	m o . l eu . d eu . g ae
harte	h a . t eu
meissner	m a . i . s eu . n eo
craven	k eu . l e . i . b eu n
arden	a . d eu n
madeline	m ae . d eu l . l i n
bowie	b o . wi
ugarte	u . g a . l eu . t e
nicol	n i . k o l
engel	e ng . g e l
oren	o . l e n
serena	s e . l i . n a
padgett	p ae . j e s
geoffrey	j e . p eu . l i
bardem	b a . d e m
oran	o . l a ng
lamar	l a . m a
rosso	l o . s o
monmouth	m o n . m eo . s eu
guldberg	g u l . d eu . b e . l eu . g eu
korngold	k o n . g o l . d eu
volta	b o l . t a
neil	n i l
camus	k a . m wi
ribot	l i . b o
tamir	t a . m i . l eu
rivlin	l i . b eu l . l i n
rafael	l a . p a . e l
lyn	l i n
chauncey	ch e n . s i
ferrari	p e . l a . l i
rollo	l o l . l o
kepler	k e . p eu l . l eo
gilson	j i l . s o ng
chopin	s yo . p ae ng
spyri	s yu . p i . l i
tora	t o . l a
como	k o . m o
gabriele	g a . b eu . l i . e l . l e
hauff	h a . u . p eu
strafford	s eu . t eu . l ae . p eo . d eu
ungaro	u ng . g a . l o
schwartz	s yu . wo . ch eu
barone	b a . l o . n e
dichev	d i . ch e . p eu
edwards	e . d eu . wo . j eu
maciel	m a . s i . e l
gabon	g a . b o ng
oregon	o . l i . g eo n
benares	b e . n a . l e . s eu
dominic	d o . m i . n i . k eu
steffi	s yu . t e . p i
gerstner	g eo . s eu . n eo
mikhail	m i . h a . i l
priestley	p eu . l i . s eu . t eu l . l i
mazowiecki	m a . j o . b i . e . ch eu . k i
chianti	k a n . t i
mecca	m e . k a
heifetz	h a . i . p e . ch eu
holberg	h o l . b e . l eu
woolf	u l . p eu
reed	l i . d eu
amanda	a . m a n . d a
bello	b e l . l o
wedgwood	we . j i . u . d eu
luisa	l u . i . j a
brenner	b eu . l e . n eo
america	a . m e . l i . k a
brink	b eu . l i ng . k eu
caldwell	k o l . d eu . we l
krupp	k eu . l u . p eu
bocage	b o . k a . j e
abebe	a . b e . b e
bostic	b o . s eu . t i g
vischer	p i . s yeo
agostino	a . g o . s eu . t i . n o
makarenko	m a . k a . l e n . k o
darmstadt	d a . l eu m . s yu . t a . t eu
india	i n . d i . a
herbst	h eo . b eu . s eu . t eu
lyell	l a . i . e l
gozzoli	g o . ch o l . l i
prishvin	p eu . l i . s yu . b i n
wien	b i n
anatolia	a . n a . t o l . l i . a
teresa	t e . l e . s a
barnes	b a . n e . j eu
lamprecht	l a m . p eu . l e . h i . t eu
somare	s o . m a . l e
eikhenbaum	e . i . h e n . b a . u m
hassler	h a . s eu l . l eo
bettina	b e . t i . n a
camille	k a . m i . yu
domingo	d o . m i ng . g o
addams	ae . d eo m . s eu
michels	m i . h e l . s eu
payne	p e n
bray	b eu . l e . i
remnant	l e m . n eo n . t eu
roland	l o l . l a n . d eu
rosalie	l o . j a l . l i
solti	s o l . t i
worthy	wo . d i
marcello	m a . l eu . ch e l . l o
galle	g a l
lichtenberg	l i . h i . t e n . b e . l eu . k eu
salomon	s a l . l o . m o n
norma	n o . m a
oceania	o . s e . a . n i . a
freundlich	p eu . l u n . d i . ch i
gilmore	g i l . m o . eo
chisinau	ch i . s i . n a . u
gurley	g eo l . l i
bergengruen	b e . l eu . g e n . g eu . l wi n
lewin	l e . b i n
bly	b eu l . l a . i
plekhanov	p eu l . l e . h a . n o . p eu
piotrowski	p i . o . t eu . l o . p eu . s eu . k i
sakharov	s a . h a . l o . p eu
lasswell	l a . s eu . we l
jarvis	j a . b i . s eu
pickford	p i g . p eo . d eu
newton	n yu . t eo n
isaac	i . s a g
houdon	u . d o ng
brenda	b eu . l e n . d a
theo	t e . o
needham	n i . d eo m
crosby	k eu . l o . s eu . b i
pufendorf	p u . p e n . d o . l eu . p eu
cech	ch e . k eu
klemperer	k eu l . l e m . p e . l eo
luis	l u . i . s eu
patricia	p eo . t eu . l i . s ya
dreyfus	d eu . l e . p wi . s eu
belfast	b e l . p a . s eu . t eu
wit	b i . t eu
beckmann	b e . k eu . m a n
philippe	p i l . l i . p eu
trendelenburg	t eu . l e n . d e l . l e n . b u . l eu . k eu
barnaby	b a . l eu . n a . b i
bulgaria	b u l . g a . l i . a
chung	j eo ng
bertin	b e . l eu . t ae ng
dehmel	d e . m e l
pissarro	p i . s a . l o
russ	l eo . s eu
danielsson	d a . n i . e l . s o n
rosebery	l o . j eu . b eo . l i
mozart	m o . ch a . l eu . t eu
salas	s a l . l a . s eu
jacob	ya . g o b
walsingham	wo l . s i ng . eo m
gandhi	g a n . d i
royce	l o . i . s eu
oscar	o . s eu . k a
videla	b i . d e l . l a
gupta	g u b . t a
hedge	h e . j i
greenville	g eu . l i n . b i l
chandler	ch ae n . d eu l . l eo
jens	ye n . s eu
pembroke	p e m . b eu . l u g
illinois	i l . l i . n o . i
blache	b eu l . l a . s yu
bona	b o . n a
branca	b eu . l a n . k a
barton	b a . t eo n
kornfeld	k o n . p i l . d eu
lyly	l i l . l i
boole	b u l
jonathan	j o . n eo . s eo n
henley	h e n . l i
chandrasekhar	ch a n . d eu . l a . s e . k a . l eu
minot	m a . i . n eo s
skoda	s eu . k o . d a
torsten	t o l . s eu . t eo n
gros	g eu . l o
bandeira	b a n . d e . i . l a
calvino	k a l . b i . n o
abir	a . b i . l eu
davids	d a . b i . ch eu
nico	n i . k o
levant	l e . b a n . t eu
olivia	o l . l i . b i . a
verrocchio	b e . l o . k i . o
eaton	i . t eu n
doha	d o . h a
egbert	e . g eu . b eo . t eu
hogan	h o . g eo n
cavendish	k ae . b eo n . d i . s i
beatty	b i . t i
beda	b e . d a
olbrich	o l . b eu . l i . h i
devon	d e . b eo n
lorraine	l o . l e n
bloch	b eu l . l o . k eu
masters	m a . s eu . t eo . s eu
fitzpatrick	p i . ch eu . p ae . t eu . l i g
robles	l o . b eu l . l e . s eu
eystein	e . s eu . t a . i n
beiqi	b e . i . ch i
zhaozhen	j a . o . j eo n
oursler	a . wo . s eu l . l eo
abigail	ae . b i . g ae . i l
eva	e . b a
shepherd	s e . p eo . d eu
paz	p a . s eu
carla	k a l . l a
mill	m i l
bert	b e . l eu . t eu
newcomb	n yu . k eo m
voigt	p o . k eu . t eu
bohemia	b o . h e . m i . a
athanasius	a . t a . n a . s i . u . s eu
shoup	s yu . p eu
virgil	b eo . j i l
maclean	m ae g . k eu l . l ae n
reeves	l i . b eu . s eu
feininger	p a . i . n i ng . eo
albo	ae l . b o
katie	k e . i . t i
bowring	b o . u . l i ng
calfa	ch a l . p a
avellaneda	a . b e . ya . n e . d a
schmitt	s yu . m i . t eu
ansermet	a ng . s e . l eu . m e
raffles	l ae . p eu l . s eu
poul	p o . u l
kenya	k e . n ya
weber	we . b eo
skryabin	s eu . k eu . l ya . b i n
eckhart	e . k eu . h a . l eu . t eu
giles	j a . i l . s eu
gneist	g eu . n a . i . s eu . t eu
trimble	t eu . l i m . b eu l
ducommun	d wi . k o . m oe ng
maureen	m o . l i n
anita	a . n i . t a
quasimodo	k wa . s i . m o . d o
bing	b i ng
ulrike	u l . l i . k eu
hazlitt	h ae . j eu l . l i s
debye	d i . b a . i
blair	b eu l . l e . eo
ueberweg	yu . b eo . b e g
achard	a . s ya . l eu
cantor	k a n . t o . eo
isler	a . i . s eu l . l eo
don	d a n
lobe	l o . b e
cohn	k o n
nestor	n e . s eu . t o . l eu
homer	h o . m eo
carola	k a . l o l . l a
rostov	l o . s eu . t o . p eu
alexis	a l . l e g . s i
reis	l a . i . s eu
byrne	b eo n
charles	s ya . l eu l
vespucci	b e . s eu . p u . ch i
woodworth	u . d eu . wo . s eu
thurnwald	t u . l eu n . b a l . t eu
joffre	j o . p eu . l eu
tindemans	t i n . d e . m a n . s eu
turk	t eo . k i
ilse	i l . s eu
jasper	j a . s eu . p eo
prout	p eu . l a . u . t eu
kilauea	k i . l a . we . a
wheatstone	h wi . t eu . s eu . t o n
orr	o . eo
ackermann	a . k eo . m a n
wallis	wi l . l i . s eu
machel	m a . s ye l
jarre	j a . l eu
haren	h a . l e n
svensson	s eu . b e n . s o n
pea	p e . n ya
esenin	ye . s e . n i n
alan	ae l . l eo n
dodds	d o . j eu
czech	ch e . k o
hewitt	h yu . i s
auckland	o . k eu l . l ae n . d eu
armstrong	a m . s eu . t eu . l o ng
platen	p eu l . l a . t e n
valadon	b a l . l a . d o ng
eileen	a . i l . l i n
joyner	j o . i . n eo
boccioni	b o . ch o . n i
grace	g eu . l a . s eu
burroughs	b eo . l o . s eu
kitchener	k i . ch i . n eo
patty	p ae . t i
natalia	n a . t a l . l i . a
lill	l i l
fritz	p eu . l i . ch eu
rosemary	l o . j eu . m e . l i
muris	m yu . l i . s eu
eugen	o . i . g e n
amalia	a . m a l . l i . a
noyce	n o . i . s eu
renee	l eu . n e
comoros	k o . m o . l o
linden	l i n . d eu n
alvaro	a l . b a . l o
farber	p a . b eo
anne	a n . n e
cushing	k u . s i ng
mei	m e . i
magdeburg	m a . g eu . d e . b u . l eu . k eu
ogden	o . g eu . d eo n
heymans	h a . i . m a n . s eu
wrangel	b eu . l a ng . g e l
hooper	h u . p eo
worms	b o . l eu m . s eu
riddick	l i . d i g
bruni	b eu . l u . n i
stuart	s eu . t yu . eo . t eu
gunther	g eo n . s eo
rais	l a . i . s eu
konstantin	k o n . s eu . t a n . t i n
noverre	n o . b e . l eu
lindgren	l i n . d eu . g eu . l e n
roald	l o . a l
kenneth	k e . n i . s eu
quiroga	k i . l o . g a
irina	i . l i . n a
peeters	p e . t eo . s eu
bremen	b eu . l e . m e n
montes	m o n . t e . s eu
wycliffe	wi . k eu l . l i . p eu
pym	p i m
mason	m e . i . s o n
boothroyd	b u . s eu . l o . i . d eu
henne	h e . n i
vailland	b a . ya ng
jonas	yo . n a . s eu
cassini	k a . s i . n i
eames	i m . s eu
gilels	g i l . l e l . s eu
franck	p eu . l a ng . k eu
rodrigo	l o . d eu . l i . g o
jensen	ye n . s e n
natorp	n a . t o . l eu . p eu
helga	h e l . g a
salzburg	j a l . ch eu . b u . l eu . k eu
sassoon	s eo . s u n
piranesi	p i . l a . n e . s i
hyndman	h a . i n . d eu . m eo n
gerrit	h e . l i . t eu
cheshire	ch e . s yeo
chernenko	ch e . l eu . n e n . k o
cumberland	k eo m . b eo l . l ae n . d eu
burbank	b eo . b ae ng . k eu
whipple	h wi . p eu l
middleton	m i . d eu l . t eo n
bojer	b o . ye . l eu
pfeiffer	p a . i . p eo
bayonne	b a . yo n . n eu
coen	k o . e n
quaid	k we . i . d eu
stephan	s yu . t e . p a n
ferry	p e . l i
laurel	l a . u . l e l
nichols	n i . k o l . s eu
atal	a . t a l
murillo	m u . l i . yo
hunker	h a n . k a
urbain	wi . l eu . b ae ng
kohler	k o l . l eo
richer	l i . ch eo
aho	a . h o
elmer	e l . m eo
prendergast	p eu . l e n . d eo . g a . s eu . t eu
barrios	b a . l i . o . s eu
armen	a . l eu . m e n
gall	g a l
draper	d eu . l e . i . p eo
valencia	b a l . l e n . s i . a
eckert	e . k e . l eu . t eu
pasolini	p a . s o l . l i . n i
ferris	p e . l i . s eu
mata	m a . t a
suslov	s u . s eu l . l o . p eu
bela	b e l . l a
boyce	b o . i . s eu
xavier	j a . b i . e . l eu
issac	a . i . j a g
curtis	k eo . t i . s eu
blunden	b eu l . l eo n . d eo n
kuznets	k u . j eu . n e . ch eu
tamm	t a m
gramsci	g eu . l a m . s i
houssay	u . s a . i
watson	wa s . s eu n
gance	g a ng . s eu
furmanov	p u . l eu . m a . n o . p eu
wallenstein	b a l . l e n . s yu . t a . i n
rusk	l eo . s eu . k eu
peru	p e . l u
jimmy	j i . m i
stefan	s yu . t e . p a n
dian	d i . a n
sparks	s eu . p a g . s eu
freiberg	p eu . l a . i . b eo . g eu
strachey	s eu . t eu . l e . i . ch i
gamba	g a m . b a
arlington	a l . l i ng . t eo n
rembrandt	l e m . b eu . l a n . t eu
millay	m i l . l e . i
pople	p o . p eu l
medina	m e . d i . n a
reischauer	l a . i . s ya . wo
brazil	b eu . l a . j i l
gene	j i n
neverov	n e . b e . l o . p eu
binoche	b i . n o . s yu
reggie	l e . j i
list	l i . s eu . t eu
macdonald	m ae g . d o . n eo l . d eu
york	yo . k eu
peck	p e g
janine	j e . n i n
germain	j e . l eu . m ae ng
friche	p eu . l i . ch e
kanpur	k a n . p u . l eu
rosen	l o . s eu n
benton	b e n . t eo n
bajer	b a . ye . l eu
lanning	l ae . n i ng
boring	b o . l i ng
darin	d a . l i n
gertrud	g eo . t eu . l u . d eu
cole	k o l
malone	m a l . l o n
laredo	l a . l e . d o
bautista	b a . t i . s eu . t a
hall	h o l
granada	g eu . l a . n a . d a
delia	d e l . l i . a
rodenbach	l o . d e n . b a . h eu
junkers	yu ng . k eo . s eu
celia	s e l . l i . a
hank	h ae ng . k eu
anselmo	a n . s e l . m o
freud	p eu . l o . i . t eu
roux	l u
lucius	l u . ch i . u . s eu
ellis	e l . l i . s eu
bronzino	b eu . l o n . ch i . n o
serene	s e . l i n
nicolson	n i . k eo l . s eu n
sergio	s e . l eu . j o
gibb	g i b
soupault	s u . p o
south	s a . u . s eu
senefelder	j e . n e . p e l . d eo
kiesinger	k i . j i ng . g eo
gephardt	g e . p a . t eu
pritchard	p eu . l i . ch eo . d eu
angela	a ng . g e l . l a
bluff	b eu l . l eo . p eu
nicaragua	n i . k a . l a . g wa
volkov	b o l . k o . p eu
henderson	h e n . d eo . s eu n
kosygin	k o . s i . g i n
iberia	i . b e . l i . a
koirala	k o . i . l a l . l a
stevie	s eu . t i . b i
dole	d o l
mackinder	m ae . k i n . d eo
ted	t e . d eu
winnie	wi . n i
renn	l e n
elsa	e l . j a
tutu	t u . t u
patinir	p a . t i . n i . l eu
nanny	n ae . n i
porta	p o . l eu . t a
beaumarchais	b o . m a . l eu . s ye
gambier	g ae m . b i . eo
gonsalves	g o n . s a l . b e . s eu
dmitri	d eu . m i . t eu . l i
wolfowitz	u l . p o . wi . ch eu
platt	p eu l . l ae s
caucasus	k o . k a . s eo . s eu
abraham	a . b eu . l a . h a m
baumgarten	b a . u m . g a . l eu . t e n
maior	m a . i . o . l eu
gail	g e . i l
moravia	m o . l a . b i . a
maastricht	m a . s eu . t eu . l i . h i . t eu
josie	j o . s wi
cutler	k eo . t eu l . l eo
lima	l i . m a
mitropoulos	m i . t eu . l o . p o l . l o . s eu
nino	n i . n o
rashid	l a . s i . d eu
dolphin	d o l . p i n
nassau	n a . s a . u
sampson	s ae m . s eu n
pearl	p eo l
solo	s o l . l o
sucre	s u . k eu . l e
joanna	j o . a n . n a
antony	a n . t o . n i
gaetano	g a . e . t a . n o
copland	k o . p eu l . l ae n . d eu
ecuador	e . k wa . d o . l eu
glover	g eu l . l o . b eo
morais	m o . l a . i . s eu
symonds	s i . m eo n . j eu
berwick	b e . l i g
ben	b e n
carmichael	k a . m a . i . k eu l
geist	g a . i . s eu . t eu
emmanuel	e . m a . n wi . e l
nebraska	n e . b eu . l ae . s eu . k a
megan	m e . g a n
merce	m eo . s eu
anwari	a n . wa . l i
key	k e . i
cates	k e . i . ch eu
goodwin	g u s . wi n
bissau	b i . s a . u
lardner	l a . d eu . n eo
spengler	s yu . p e ng . g eu l . l eo
chekhov	ch e . h o . p eu
twardowski	t eu . wa . l eu . d o . p eu . s eu . k i
aram	a . l a m
gounod	g u . n o
dmitry	d eu . m i . t eu . l i
bongo	b o ng . g o
grossman	g eu . l o . s eu . m eo n
dowiyogo	d o . wi . yo . g o
kraft	k eu . l a . p eu . t eu
vincent	b ae ng . s a ng
marek	m a . l e g
busch	b u . s yu
gutenberg	g u . t e n . b e . l eu . k eu
petersen	p i . t eo . s eu n
palladio	p a l . l a . d i . o
couplet	k u . p eu l . l e
steen	s eu . t e n
rome	l o . m a
lassus	l a . s u . s eu
casper	k ae . s eu . p eo
santander	s a n . t a n . d e . l eu
brzezinski	b eu . l e . j i n . s eu . k i
einstein	a . i n . s yu . t a . i n
hastings	h e . i . s eu . t i ng . s eu
griffin	g eu . l i . p i n
lemarchand	l eu . m a g . s yeo ng
johnstone	j o n . s eu . t o n
paul	b a . u l
neilson	n i l . s eu n
hulse	h eo l . s eu
khrushchev	h eu . l u . s i . ch o . p eu
jurgen	j u . g e n
lamb	l ae m
tennessee	t e . n e . s i
carlson	k a l . s eu n
ava	e . b a
vivian	b i . b i . a n
philadelpia	p i l . l a . d e l . p i . a
java	j a . b a
rada	l a . d a
joinville	j u . ae ng . b i l
bradbury	b eu . l ae . d eu . b eo . l i
poussin	p u . s ae ng
smellie	s eu . m e l . l i
tripoli	t eu . l i . p o l . l i
duvalier	d wi . b a l . l i . e
vane	b e . i n
huff	h eo . p eu
montana	m o n . t ae . n a
anson	ae n . s eu n
caldecott	k o l . d eo . k eo s
alison	ae l . l i . s eu n
chan	ch ae n
cranach	k eu . l a . n a . h eu
theiler	t a . i l . l eo
nolde	n o l . d e
rene	l eu . n e
majuro	m a . j u . l o
milford	m i l . p eo . d eu
ankara	a ng . k a . l a
indra	i n . d eu . l a
roberta	l o . b eo . t a
heike	h a . i . k e
pigalle	p i . g a l
celan	ch e l . l a n
thorvaldsen	t o . l eu . b a l . s e n
broadway	b eu . l o . d eu . we . i
ferrer	p e . l eo
fischer	p i . s yeo
andersen	a n . d e . l eu . s e n
hoskins	h o . s eu . k i n . s eu
gibbon	g i . b eo n
arghezi	a . l eu . g e . j i
rameau	l a . m o
blum	b eu l . l eo m
araujo	a . l a . u . j o
casanova	k a . s a . n o . b a
bohuslav	b o . h u . s eu l . l a . p eu
rainwater	l e . i n . wo . t eo
philip	b i l . l i b
chao	ch a . o
carlton	k a l . t eu n
carnes	k a . n e . s eu
ewald	e . b a l
nick	n i g
bean	b i n
chevalier	s yu . b a l . l i . e
welhaven	b e l . h a . b e n
melville	m e l . b i l
heckscher	h e . k eu . s ye . l eu
kolarov	k o l . l a . l o . p eu
bouts	b o . ch eu
regis	l e . j i . s eu
bandiera	b a n . d i . e . l a
castigliano	k a . s eu . t i l . l i . a . n o
mira	m i . l a
clausius	k eu l . l a . u . j i . u . s eu
keith	k i . s eu
benda	b a ng . d a
singleton	s i ng . g eu l . t o n
seaga	s i . g a
kuhlau	k u l . l a . u
cigna	s i . g eu . n a
montemayor	m o n . t e . m a . yo . l eu
pisano	p i . s a . n o
rule	l a . u l
wickham	wi . k eo m
kelsey	k e l . s i
olander	o l . l ae n . d eo
birch	b eo . ch i
shelley	s ye l . l i
roberts	l o . b eo . ch eu
alfa	a l . p a
dent	t e n . t eu
suva	s u . b a
weingartner	b a . i n . g a . l eu . t eu . n eo
hinshelwood	h i n . s yeo l . u . d eu
wartburg	b a . l eu . t eu . b u . l eu . k eu
greenland	g eu . l i n . l a n . d eu
stephenson	s eu . t i . b eu n . s eu n
synge	s i ng
mercouri	m e . l eu . k u . l i
salvini	s a l . b i . n i
deschamps	d e . s ya ng
rudolph	l u . d o l . p eu
edward	e . d eu . wo . d eu
ali	a l . l i
appalachia	a . p a . l a . ch i . a
kiel	k i l
pyongyang	p yeo ng . ya ng
reichstein	l a . i . h i . s yu . t a . i n
hogarth	h o . g a . s eu
loftus	l o . p eu . t eo . s eu
aske	a . s eu . k e
lambert	l a m . b e . l eu . t eu
oud	o . d eu
vaillant	b a . ya ng
holt	h o l . t eu
brent	b eu . l e n . t eu
baden	b a . d e n
kram	k eu . l ae m
waterford	wo . t eo . p eo . d eu
raj	l a . j i
shamir	s ya . m i . l eu
edouard	e . d u . a . l eu
tosti	t o . s eu . t i
